simulation_id,team,w,d,l,gf,ga,gd,points,position
1,Sheffield Weds,28,13,5,85,31,54,97,1
1,Plymouth Argyle,28,9,9,84,53,31,93,2
1,Derby County,27,10,9,80,35,45,91,3
1,Ipswich Town,25,14,7,85,42,43,89,4
1,Wycombe,26,6,14,67,42,25,84,5
1,Barnsley,24,8,14,69,44,25,80,6
1,Bolton,22,13,11,64,35,29,79,7
1,P'borough Utd,21,8,17,71,55,16,71,8
1,Portsmouth,18,15,13,61,51,10,69,9
1,Shrewsbury,20,9,17,50,45,5,69,10
1,Charlton Ath,18,14,14,72,56,16,68,11
1,Lincoln City,15,21,10,45,42,3,66,12
1,Port Vale,17,9,20,53,64,-11,60,13
1,Fleetwood Town,14,16,16,49,47,2,58,14
1,Bristol Rovers,16,10,20,68,78,-10,58,15
1,Exeter City,14,14,18,51,59,-8,56,16
1,Cheltenham,14,7,25,36,60,-24,49,17
1,Oxford United,11,13,22,49,66,-17,46,18
1,Morecambe,11,11,24,46,78,-32,44,19
1,MK Dons,12,7,27,44,78,-34,43,20
1,Burton Albion,10,12,24,51,87,-36,42,21
1,Acc'ton Stanley,9,13,24,37,73,-36,40,22
1,Cambridge Utd,10,9,27,41,78,-37,39,23
1,FG Rovers,6,11,29,37,96,-59,29,24
2,Sheffield Weds,32,9,5,86,28,58,105,1
2,Plymouth Argyle,30,10,6,95,43,52,100,2
2,Ipswich Town,25,15,6,92,49,43,90,3
2,Barnsley,27,9,10,69,38,31,90,4
2,Wycombe,25,8,13,74,45,29,83,5
2,Bolton,21,15,10,63,37,26,78,6
2,Derby County,22,10,14,76,47,29,76,7
2,Portsmouth,20,13,13,75,57,18,73,8
2,P'borough Utd,22,6,18,74,62,12,72,9
2,Shrewsbury,20,11,15,60,52,8,71,10
2,Charlton Ath,17,14,15,67,61,6,65,11
2,Fleetwood Town,14,16,16,50,47,3,58,12
2,Lincoln City,13,19,14,45,50,-5,58,13
2,Exeter City,15,10,21,59,65,-6,55,14
2,Port Vale,15,10,21,46,67,-21,55,15
2,Bristol Rovers,13,14,19,62,81,-19,53,16
2,Oxford United,12,13,21,42,57,-15,49,17
2,Burton Albion,12,12,22,55,88,-33,48,18
2,Cheltenham,12,10,24,35,60,-25,46,19
2,Cambridge Utd,11,9,26,35,70,-35,42,20
2,Acc'ton Stanley,9,14,23,37,72,-35,41,21
2,Morecambe,8,16,22,42,73,-31,40,22
2,MK Dons,9,10,27,40,74,-34,37,23
2,FG Rovers,6,11,29,31,87,-56,29,24
3,Sheffield Weds,29,11,6,82,30,52,98,1
3,Plymouth Argyle,28,9,9,84,51,33,93,2
3,Derby County,25,11,10,72,39,33,86,3
3,Bolton,24,11,11,68,34,34,83,4
3,Ipswich Town,23,14,9,78,48,30,83,5
3,Barnsley,24,9,13,66,44,22,81,6
3,Wycombe,22,9,15,58,46,12,75,7
3,P'borough Utd,23,4,19,76,57,19,73,8
3,Portsmouth,19,16,11,72,54,18,73,9
3,Shrewsbury,21,7,18,57,54,3,70,10
3,Charlton Ath,17,14,15,63,57,6,65,11
3,Lincoln City,15,20,11,47,44,3,65,12
3,Port Vale,17,8,21,43,56,-13,59,13
3,Fleetwood Town,14,16,16,53,50,3,58,14
3,Oxford United,14,12,20,47,60,-13,54,15
3,Bristol Rovers,14,11,21,66,81,-15,53,16
3,Exeter City,13,13,20,59,68,-9,52,17
3,Burton Albion,13,10,23,55,79,-24,49,18
3,MK Dons,12,11,23,44,63,-19,47,19
3,Cheltenham,13,8,25,38,61,-23,47,20
3,Acc'ton Stanley,10,13,23,36,69,-33,43,21
3,Morecambe,9,14,23,45,72,-27,41,22
3,Cambridge Utd,11,7,28,39,84,-45,40,23
3,FG Rovers,7,12,27,41,88,-47,33,24
4,Sheffield Weds,30,12,4,83,29,54,102,1
4,Ipswich Town,26,14,6,89,44,45,92,2
4,Plymouth Argyle,25,14,7,88,55,33,89,3
4,Bolton,24,10,12,67,37,30,82,4
4,P'borough Utd,26,3,17,77,53,24,81,5
4,Derby County,21,15,10,75,43,32,78,6
4,Wycombe,23,9,14,66,44,22,78,7
4,Barnsley,22,9,15,64,45,19,75,8
4,Portsmouth,18,18,10,68,52,16,72,9
4,Shrewsbury,21,8,17,56,54,2,71,10
4,Fleetwood Town,16,15,15,54,48,6,63,11
4,Bristol Rovers,16,11,19,69,86,-17,59,12
4,Exeter City,14,16,16,61,60,1,58,13
4,Port Vale,15,10,21,48,67,-19,55,14
4,Charlton Ath,14,12,20,64,66,-2,54,15
4,Lincoln City,11,20,15,43,51,-8,53,16
4,Oxford United,13,12,21,45,57,-12,51,17
4,Burton Albion,13,12,21,54,78,-24,51,18
4,Cheltenham,14,8,24,36,62,-26,50,19
4,MK Dons,13,9,24,47,69,-22,48,20
4,Morecambe,10,14,22,44,73,-29,44,21
4,Acc'ton Stanley,10,14,22,38,68,-30,44,22
4,Cambridge Utd,9,7,30,37,81,-44,34,23
4,FG Rovers,6,12,28,32,83,-51,30,24
5,Sheffield Weds,32,10,4,91,29,62,106,1
5,Plymouth Argyle,29,12,5,100,51,49,99,2
5,Ipswich Town,27,13,6,90,42,48,94,3
5,Barnsley,26,8,12,71,42,29,86,4
5,Portsmouth,23,13,10,68,47,21,82,5
5,Wycombe,23,11,12,64,38,26,80,6
5,Derby County,22,12,12,71,45,26,78,7
5,Bolton,22,12,12,66,40,26,78,8
5,P'borough Utd,24,6,16,73,56,17,78,9
5,Shrewsbury,17,9,20,53,55,-2,60,10
5,Exeter City,15,13,18,62,59,3,58,11
5,Charlton Ath,15,13,18,68,67,1,58,12
5,Lincoln City,11,24,11,42,51,-9,57,13
5,Fleetwood Town,13,15,18,49,52,-3,54,14
5,Bristol Rovers,14,10,22,65,94,-29,52,15
5,Port Vale,13,12,21,43,62,-19,51,16
5,Oxford United,13,11,22,45,56,-11,50,17
5,Cheltenham,13,10,23,36,59,-23,49,18
5,Acc'ton Stanley,10,15,21,40,67,-27,45,19
5,MK Dons,11,11,24,43,69,-26,44,20
5,Burton Albion,10,13,23,50,84,-34,43,21
5,Morecambe,10,12,24,45,74,-29,42,22
5,Cambridge Utd,10,8,28,36,77,-41,38,23
5,FG Rovers,8,9,29,35,90,-55,33,24
6,Plymouth Argyle,31,10,5,85,48,37,103,1
6,Sheffield Weds,30,9,7,87,35,52,99,2
6,Ipswich Town,24,15,7,89,43,46,87,3
6,Barnsley,26,8,12,75,46,29,86,4
6,Derby County,24,9,13,71,43,28,81,5
6,Bolton,22,11,13,63,43,20,77,6
6,P'borough Utd,24,5,17,79,60,19,77,7
6,Portsmouth,21,14,11,68,52,16,77,8
6,Wycombe,21,8,17,62,53,9,71,9
6,Shrewsbury,18,7,21,51,55,-4,61,10
6,Fleetwood Town,13,18,15,53,49,4,57,11
6,Charlton Ath,14,15,17,66,65,1,57,12
6,Exeter City,14,13,19,57,57,0,55,13
6,Lincoln City,11,22,13,39,45,-6,55,14
6,Port Vale,15,10,21,50,69,-19,55,15
6,Bristol Rovers,15,9,22,65,81,-16,54,16
6,Burton Albion,14,12,20,60,82,-22,54,17
6,Oxford United,13,13,20,53,64,-11,52,18
6,MK Dons,14,9,23,49,66,-17,51,19
6,Acc'ton Stanley,12,13,21,38,71,-33,49,20
6,Morecambe,12,11,23,49,74,-25,47,21
6,Cheltenham,11,10,25,33,62,-29,43,22
6,FG Rovers,8,13,25,36,76,-40,37,23
6,Cambridge Utd,9,8,29,37,76,-39,35,24
7,Sheffield Weds,30,11,5,88,29,59,101,1
7,Plymouth Argyle,27,12,7,77,46,31,93,2
7,Derby County,25,13,8,77,37,40,88,3
7,Ipswich Town,23,17,6,87,43,44,86,4
7,Wycombe,24,11,11,69,44,25,83,5
7,Bolton,23,12,11,70,38,32,81,6
7,Barnsley,23,12,11,70,43,27,81,7
7,P'borough Utd,24,5,17,75,54,21,77,8
7,Shrewsbury,20,12,14,60,47,13,72,9
7,Portsmouth,17,17,12,62,50,12,68,10
7,Port Vale,16,10,20,47,62,-15,58,11
7,Charlton Ath,14,15,17,59,62,-3,57,12
7,Fleetwood Town,12,20,14,49,48,1,56,13
7,Exeter City,14,11,21,60,63,-3,53,14
7,Lincoln City,10,20,16,41,51,-10,50,15
7,Oxford United,12,13,21,48,62,-14,49,16
7,Bristol Rovers,13,10,23,58,87,-29,49,17
7,Acc'ton Stanley,13,10,23,41,71,-30,49,18
7,Cheltenham,13,9,24,38,68,-30,48,19
7,Morecambe,11,13,22,52,78,-26,46,20
7,Burton Albion,12,10,24,55,88,-33,46,21
7,MK Dons,12,9,25,46,76,-30,45,22
7,Cambridge Utd,11,10,25,40,69,-29,43,23
7,FG Rovers,7,10,29,31,84,-53,31,24
8,Sheffield Weds,28,13,5,83,33,50,97,1
8,Plymouth Argyle,28,12,6,96,53,43,96,2
8,Ipswich Town,25,15,6,88,45,43,90,3
8,Barnsley,25,12,9,73,40,33,87,4
8,Bolton,25,10,11,68,37,31,85,5
8,Derby County,23,11,12,73,48,25,80,6
8,P'borough Utd,23,4,19,81,58,23,73,7
8,Portsmouth,19,16,11,69,49,20,73,8
8,Wycombe,21,10,15,60,45,15,73,9
8,Exeter City,17,15,14,58,56,2,66,10
8,Charlton Ath,17,14,15,71,64,7,65,11
8,Shrewsbury,18,11,17,60,54,6,65,12
8,Lincoln City,13,21,12,47,50,-3,60,13
8,Fleetwood Town,15,14,17,50,50,0,59,14
8,Port Vale,13,15,18,48,64,-16,54,15
8,Bristol Rovers,13,11,22,66,90,-24,50,16
8,Burton Albion,13,10,23,56,88,-32,49,17
8,Oxford United,12,12,22,44,62,-18,48,18
8,Cheltenham,13,7,26,39,64,-25,46,19
8,MK Dons,11,10,25,39,66,-27,43,20
8,Cambridge Utd,12,6,28,41,75,-34,42,21
8,Morecambe,9,13,24,41,70,-29,40,22
8,FG Rovers,8,12,26,40,83,-43,36,23
8,Acc'ton Stanley,8,12,26,38,85,-47,36,24
9,Sheffield Weds,31,11,4,78,27,51,104,1
9,Plymouth Argyle,30,10,6,100,51,49,100,2
9,Barnsley,27,10,9,74,35,39,91,3
9,Bolton,26,11,9,71,36,35,89,4
9,Ipswich Town,24,15,7,78,41,37,87,5
9,P'borough Utd,26,5,15,87,58,29,83,6
9,Derby County,22,12,12,71,41,30,78,7
9,Portsmouth,19,16,11,63,50,13,73,8
9,Wycombe,21,9,16,59,43,16,72,9
9,Charlton Ath,18,12,16,76,66,10,66,10
9,Lincoln City,15,19,12,47,44,3,64,11
9,Shrewsbury,18,9,19,59,57,2,63,12
9,Fleetwood Town,16,14,16,60,47,13,62,13
9,Bristol Rovers,16,9,21,63,73,-10,57,14
9,Exeter City,13,13,20,54,67,-13,52,15
9,Port Vale,14,8,24,41,72,-31,50,16
9,MK Dons,13,8,25,43,68,-25,47,17
9,Burton Albion,12,11,23,64,92,-28,47,18
9,Oxford United,12,10,24,43,64,-21,46,19
9,Cheltenham,12,9,25,32,62,-30,45,20
9,Acc'ton Stanley,10,13,23,36,72,-36,43,21
9,Morecambe,10,12,24,45,77,-32,42,22
9,Cambridge Utd,10,7,29,33,73,-40,37,23
9,FG Rovers,5,11,30,32,93,-61,26,24
10,Plymouth Argyle,30,9,7,89,51,38,99,1
10,Sheffield Weds,27,14,5,80,33,47,95,2
10,Derby County,25,13,8,77,38,39,88,3
10,Barnsley,26,9,11,73,38,35,87,4
10,Wycombe,27,6,13,69,40,29,87,5
10,Ipswich Town,22,15,9,78,42,36,81,6
10,P'borough Utd,25,4,17,76,56,20,79,7
10,Bolton,22,12,12,66,39,27,78,8
10,Charlton Ath,21,12,13,75,56,19,75,9
10,Portsmouth,17,18,11,63,53,10,69,10
10,Fleetwood Town,16,16,14,55,43,12,64,11
10,Shrewsbury,18,7,21,50,55,-5,61,12
10,Exeter City,13,15,18,58,61,-3,54,13
10,Burton Albion,14,10,22,63,79,-16,52,14
10,Port Vale,14,10,22,45,68,-23,52,15
10,Lincoln City,10,21,15,40,49,-9,51,16
10,Cheltenham,14,8,24,41,65,-24,50,17
10,Bristol Rovers,13,11,22,68,93,-25,50,18
10,Acc'ton Stanley,12,13,21,34,63,-29,49,19
10,Morecambe,12,11,23,46,71,-25,47,20
10,Oxford United,11,13,22,46,66,-20,46,21
10,MK Dons,12,8,26,41,71,-30,44,22
10,Cambridge Utd,9,8,29,33,73,-40,35,23
10,FG Rovers,6,9,31,29,92,-63,27,24
11,Sheffield Weds,32,9,5,86,30,56,105,1
11,Plymouth Argyle,31,9,6,96,49,47,102,2
11,Ipswich Town,24,15,7,79,44,35,87,3
11,Bolton,25,10,11,76,33,43,85,4
11,Barnsley,25,9,12,73,43,30,84,5
11,Derby County,24,11,11,72,44,28,83,6
11,Portsmouth,22,14,10,72,49,23,80,7
11,Wycombe,23,9,14,67,42,25,78,8
11,P'borough Utd,21,8,17,75,59,16,71,9
11,Lincoln City,15,21,10,44,45,-1,66,10
11,Shrewsbury,19,7,20,52,53,-1,64,11
11,Exeter City,17,12,17,61,56,5,63,12
11,Port Vale,18,9,19,52,62,-10,63,13
11,Charlton Ath,16,13,17,67,60,7,61,14
11,Fleetwood Town,14,17,15,45,46,-1,59,15
11,Bristol Rovers,15,10,21,62,76,-14,55,16
11,Cheltenham,13,8,25,35,64,-29,47,17
11,Acc'ton Stanley,10,13,23,40,79,-39,43,18
11,Oxford United,11,9,26,45,69,-24,42,19
11,Cambridge Utd,9,14,23,40,70,-30,41,20
11,Morecambe,10,11,25,43,80,-37,41,21
11,Burton Albion,10,9,27,55,96,-41,39,22
11,MK Dons,10,8,28,43,76,-33,38,23
11,FG Rovers,6,9,31,32,87,-55,27,24
12,Sheffield Weds,30,13,3,94,34,60,103,1
12,Plymouth Argyle,30,11,5,94,49,45,101,2
12,Barnsley,27,10,9,74,40,34,91,3
12,Bolton,26,10,10,71,35,36,88,4
12,Derby County,23,13,10,72,42,30,82,5
12,Ipswich Town,21,16,9,81,47,34,79,6
12,Portsmouth,19,17,10,63,49,14,74,7
12,Wycombe,22,7,17,64,47,17,73,8
12,P'borough Utd,21,7,18,69,61,8,70,9
12,Fleetwood Town,16,16,14,56,47,9,64,10
12,Charlton Ath,15,16,15,64,58,6,61,11
12,Shrewsbury,17,10,19,48,51,-3,61,12
12,Lincoln City,10,25,11,43,46,-3,55,13
12,Exeter City,14,12,20,58,65,-7,54,14
12,Oxford United,13,15,18,48,56,-8,54,15
12,Bristol Rovers,14,11,21,62,78,-16,53,16
12,Port Vale,13,12,21,48,65,-17,51,17
12,Burton Albion,13,12,21,58,78,-20,51,18
12,Cheltenham,13,10,23,39,60,-21,49,19
12,Acc'ton Stanley,10,13,23,37,74,-37,43,20
12,Morecambe,9,14,23,42,71,-29,41,21
12,Cambridge Utd,10,10,26,37,74,-37,40,22
12,MK Dons,9,11,26,42,79,-37,38,23
12,FG Rovers,5,13,28,34,92,-58,28,24
13,Sheffield Weds,31,10,5,90,30,60,103,1
13,Plymouth Argyle,28,10,8,83,49,34,94,2
13,Derby County,26,10,10,84,48,36,88,3
13,Barnsley,26,9,11,73,42,31,87,4
13,Ipswich Town,23,16,7,90,44,46,85,5
13,Bolton,22,9,15,59,39,20,75,6
13,P'borough Utd,23,6,17,69,54,15,75,7
13,Wycombe,20,10,16,61,45,16,70,8
13,Portsmouth,19,13,14,66,57,9,70,9
13,Shrewsbury,18,12,16,54,52,2,66,10
13,Fleetwood Town,16,16,14,52,46,6,64,11
13,Lincoln City,13,22,11,47,45,2,61,12
13,Charlton Ath,13,16,17,61,67,-6,55,13
13,Exeter City,14,13,19,58,65,-7,55,14
13,Bristol Rovers,14,11,21,61,77,-16,53,15
13,Oxford United,13,12,21,50,59,-9,51,16
13,Burton Albion,14,9,23,53,85,-32,51,17
13,Port Vale,12,13,21,43,63,-20,49,18
13,Cambridge Utd,12,12,22,42,67,-25,48,19
13,Morecambe,10,16,20,52,73,-21,46,20
13,Acc'ton Stanley,10,16,20,38,67,-29,46,21
13,Cheltenham,12,9,25,33,63,-30,45,22
13,MK Dons,10,11,25,47,73,-26,41,23
13,FG Rovers,6,13,27,37,93,-56,31,24
14,Sheffield Weds,30,12,4,82,29,53,102,1
14,Ipswich Town,26,13,7,88,44,44,91,2
14,Plymouth Argyle,27,10,9,86,52,34,91,3
14,Barnsley,27,7,12,69,41,28,88,4
14,Bolton,23,12,11,70,37,33,81,5
14,Wycombe,24,8,14,62,39,23,80,6
14,P'borough Utd,25,4,17,76,48,28,79,7
14,Derby County,21,12,13,70,49,21,75,8
14,Portsmouth,19,14,13,66,54,12,71,9
14,Shrewsbury,20,9,17,57,51,6,69,10
14,Charlton Ath,18,12,16,66,60,6,66,11
14,Exeter City,16,11,19,63,64,-1,59,12
14,Lincoln City,12,22,12,43,48,-5,58,13
14,Fleetwood Town,13,17,16,46,49,-3,56,14
14,Oxford United,13,14,19,49,52,-3,53,15
14,Bristol Rovers,14,9,23,61,78,-17,51,16
14,Port Vale,14,8,24,46,67,-21,50,17
14,MK Dons,14,7,25,46,71,-25,49,18
14,Acc'ton Stanley,12,12,22,41,75,-34,48,19
14,Cheltenham,12,9,25,34,62,-28,45,20
14,Morecambe,11,12,23,48,79,-31,45,21
14,Burton Albion,11,11,24,50,83,-33,44,22
14,Cambridge Utd,10,10,26,31,67,-36,40,23
14,FG Rovers,7,11,28,34,85,-51,32,24
15,Sheffield Weds,29,11,6,80,30,50,98,1
15,Plymouth Argyle,29,8,9,90,51,39,95,2
15,Barnsley,26,9,11,76,41,35,87,3
15,Ipswich Town,23,16,7,80,46,34,85,4
15,Derby County,23,12,11,73,44,29,81,5
15,Bolton,23,9,14,63,41,22,78,6
15,Wycombe,23,9,14,62,42,20,78,7
15,Portsmouth,20,14,12,68,56,12,74,8
15,P'borough Utd,22,7,17,77,56,21,73,9
15,Shrewsbury,20,10,16,55,49,6,70,10
15,Fleetwood Town,17,17,12,54,41,13,68,11
15,Charlton Ath,17,11,18,72,60,12,62,12
15,Lincoln City,12,23,11,39,45,-6,59,13
15,Exeter City,16,9,21,63,67,-4,57,14
15,Port Vale,15,10,21,48,62,-14,55,15
15,Bristol Rovers,14,11,21,66,83,-17,53,16
15,Cheltenham,13,10,23,36,59,-23,49,17
15,Morecambe,12,13,21,50,75,-25,49,18
15,Burton Albion,12,13,21,55,88,-33,49,19
15,Oxford United,11,13,22,44,59,-15,46,20
15,Acc'ton Stanley,9,16,21,38,67,-29,43,21
15,Cambridge Utd,10,10,26,37,72,-35,40,22
15,MK Dons,9,10,27,37,71,-34,37,23
15,FG Rovers,6,11,29,32,90,-58,29,24
16,Plymouth Argyle,32,9,5,84,41,43,105,1
16,Sheffield Weds,30,10,6,89,33,56,100,2
16,Barnsley,27,7,12,72,42,30,88,3
16,Ipswich Town,23,16,7,79,41,38,85,4
16,Derby County,22,15,9,72,41,31,81,5
16,P'borough Utd,25,6,15,78,52,26,81,6
16,Bolton,23,10,13,66,39,27,79,7
16,Wycombe,24,7,15,67,42,25,79,8
16,Portsmouth,18,14,14,65,63,2,68,9
16,Fleetwood Town,16,17,13,51,44,7,65,10
16,Bristol Rovers,18,9,19,70,78,-8,63,11
16,Shrewsbury,17,10,19,51,51,0,61,12
16,Exeter City,16,12,18,55,54,1,60,13
16,Port Vale,17,8,21,50,61,-11,59,14
16,Lincoln City,13,19,14,46,51,-5,58,15
16,Morecambe,14,14,18,55,66,-11,56,16
16,Charlton Ath,14,12,20,62,68,-6,54,17
16,Cheltenham,13,8,25,36,66,-30,47,18
16,Oxford United,11,11,24,45,63,-18,44,19
16,MK Dons,12,8,26,41,69,-28,44,20
16,Acc'ton Stanley,10,13,23,42,72,-30,43,21
16,Burton Albion,11,9,26,49,90,-41,42,22
16,Cambridge Utd,11,7,28,38,73,-35,40,23
16,FG Rovers,5,9,32,30,93,-63,24,24
17,Sheffield Weds,31,11,4,85,33,52,104,1
17,Plymouth Argyle,29,9,8,91,47,44,96,2
17,Ipswich Town,26,16,4,90,36,54,94,3
17,Derby County,24,12,10,70,40,30,84,4
17,Barnsley,25,7,14,74,45,29,82,5
17,Bolton,22,14,10,62,35,27,80,6
17,Portsmouth,19,17,10,76,55,21,74,7
17,Wycombe,21,10,15,69,53,16,73,8
17,P'borough Utd,21,5,20,67,58,9,68,9
17,Shrewsbury,17,13,16,50,46,4,64,10
17,Fleetwood Town,15,18,13,48,42,6,63,11
17,Exeter City,16,13,17,59,58,1,61,12
17,Charlton Ath,14,17,15,66,57,9,59,13
17,Bristol Rovers,16,10,20,64,76,-12,58,14
17,Port Vale,16,9,21,43,61,-18,57,15
17,Lincoln City,11,23,12,45,49,-4,56,16
17,Oxford United,14,10,22,53,61,-8,52,17
17,Acc'ton Stanley,11,14,21,44,68,-24,47,18
17,Burton Albion,12,11,23,51,91,-40,47,19
17,Morecambe,10,16,20,44,73,-29,46,20
17,Cambridge Utd,12,7,27,40,72,-32,43,21
17,MK Dons,10,10,26,40,78,-38,40,22
17,Cheltenham,10,8,28,29,65,-36,38,23
17,FG Rovers,5,10,31,33,94,-61,25,24
18,Sheffield Weds,30,10,6,84,34,50,100,1
18,Barnsley,29,8,9,78,37,41,95,2
18,Plymouth Argyle,27,11,8,86,49,37,92,3
18,Ipswich Town,23,15,8,80,45,35,84,4
18,P'borough Utd,25,7,14,84,54,30,82,5
18,Wycombe,24,10,12,64,40,24,82,6
18,Derby County,23,12,11,78,51,27,81,7
18,Bolton,23,11,12,69,37,32,80,8
18,Shrewsbury,21,8,17,59,52,7,71,9
18,Charlton Ath,18,14,14,62,54,8,68,10
18,Fleetwood Town,17,15,14,51,44,7,66,11
18,Portsmouth,16,16,14,58,52,6,64,12
18,Exeter City,15,12,19,61,63,-2,57,13
18,Port Vale,14,13,19,47,61,-14,55,14
18,Bristol Rovers,13,11,22,60,85,-25,50,15
18,Cheltenham,13,10,23,37,64,-27,49,16
18,Oxford United,11,15,20,48,56,-8,48,17
18,Lincoln City,9,21,16,38,52,-14,48,18
18,Morecambe,10,15,21,41,73,-32,45,19
18,Burton Albion,10,13,23,57,90,-33,43,20
18,MK Dons,11,8,27,43,70,-27,41,21
18,Acc'ton Stanley,9,13,24,36,76,-40,40,22
18,Cambridge Utd,9,11,26,35,70,-35,38,23
18,FG Rovers,7,11,28,33,80,-47,32,24
19,Sheffield Weds,30,10,6,82,32,50,100,1
19,Barnsley,29,7,10,84,37,47,94,2
19,Ipswich Town,23,17,6,87,43,44,86,3
19,Plymouth Argyle,24,14,8,78,52,26,86,4
19,Bolton,25,10,11,71,36,35,85,5
19,Derby County,23,13,10,73,45,28,82,6
19,Wycombe,23,10,13,63,37,26,79,7
19,P'borough Utd,25,4,17,72,55,17,79,8
19,Portsmouth,17,17,12,57,52,5,68,9
19,Charlton Ath,18,13,15,74,61,13,67,10
19,Fleetwood Town,17,15,14,53,45,8,66,11
19,Lincoln City,15,20,11,44,43,1,65,12
19,Shrewsbury,18,10,18,49,50,-1,64,13
19,Exeter City,14,14,18,64,58,6,56,14
19,Port Vale,15,10,21,45,65,-20,55,15
19,Bristol Rovers,15,9,22,60,73,-13,54,16
19,Cheltenham,14,8,24,37,64,-27,50,17
19,Oxford United,11,12,23,44,58,-14,45,18
19,Burton Albion,12,9,25,52,94,-42,45,19
19,Morecambe,9,15,22,42,70,-28,42,20
19,MK Dons,11,9,26,44,76,-32,42,21
19,Acc'ton Stanley,9,13,24,34,71,-37,40,22
19,FG Rovers,9,9,28,39,82,-43,36,23
19,Cambridge Utd,8,8,30,35,84,-49,32,24
20,Barnsley,28,9,9,72,43,29,93,1
20,Sheffield Weds,26,12,8,76,38,38,90,2
20,Plymouth Argyle,25,13,8,78,49,29,88,3
20,Derby County,24,15,7,82,36,46,87,4
20,Ipswich Town,24,14,8,84,47,37,86,5
20,Bolton,25,10,11,68,36,32,85,6
20,Wycombe,26,6,14,63,35,28,84,7
20,Portsmouth,21,12,13,70,57,13,75,8
20,Shrewsbury,20,11,15,58,47,11,71,9
20,Fleetwood Town,17,16,13,55,44,11,67,10
20,P'borough Utd,20,7,19,68,63,5,67,11
20,Charlton Ath,17,13,16,67,64,3,64,12
20,Lincoln City,12,23,11,42,42,0,59,13
20,Bristol Rovers,15,12,19,64,78,-14,57,14
20,Exeter City,13,15,18,57,57,0,54,15
20,Oxford United,14,11,21,52,60,-8,53,16
20,Port Vale,14,10,22,45,70,-25,52,17
20,Burton Albion,13,10,23,52,82,-30,49,18
20,Morecambe,11,12,23,51,75,-24,45,19
20,Acc'ton Stanley,10,11,25,44,73,-29,41,20
20,Cheltenham,11,8,27,32,64,-32,41,21
20,Cambridge Utd,11,7,28,37,76,-39,40,22
20,MK Dons,9,8,29,41,76,-35,35,23
20,FG Rovers,8,11,27,38,84,-46,35,24
21,Sheffield Weds,29,10,7,85,32,53,97,1
21,Plymouth Argyle,28,10,8,95,53,42,94,2
21,Bolton,25,11,10,71,36,35,86,3
21,Barnsley,25,8,13,71,44,27,83,4
21,Derby County,24,10,12,72,49,23,82,5
21,Wycombe,23,9,14,68,42,26,78,6
21,Ipswich Town,19,19,8,76,47,29,76,7
21,P'borough Utd,22,6,18,75,57,18,72,8
21,Portsmouth,18,18,10,62,48,14,72,9
21,Fleetwood Town,17,15,14,54,46,8,66,10
21,Exeter City,17,12,17,62,57,5,63,11
21,Shrewsbury,18,9,19,53,54,-1,63,12
21,Charlton Ath,15,15,16,71,61,10,60,13
21,Lincoln City,13,18,15,52,58,-6,57,14
21,Bristol Rovers,16,9,21,63,84,-21,57,15
21,Port Vale,15,10,21,41,65,-24,55,16
21,Oxford United,14,12,20,51,55,-4,54,17
21,Cheltenham,14,10,22,40,61,-21,52,18
21,Burton Albion,13,11,22,56,87,-31,50,19
21,MK Dons,12,10,24,46,68,-22,46,20
21,Acc'ton Stanley,11,12,23,37,70,-33,45,21
21,Cambridge Utd,11,9,26,36,71,-35,42,22
21,Morecambe,8,13,25,44,83,-39,37,23
21,FG Rovers,6,12,28,35,88,-53,30,24
22,Sheffield Weds,29,12,5,79,31,48,99,1
22,Plymouth Argyle,28,12,6,87,50,37,96,2
22,Ipswich Town,26,15,5,86,41,45,93,3
22,Barnsley,25,10,11,80,45,35,85,4
22,Derby County,23,14,9,78,46,32,83,5
22,Bolton,23,12,11,65,38,27,81,6
22,Wycombe,23,8,15,59,42,17,77,7
22,Shrewsbury,20,10,16,63,54,9,70,8
22,P'borough Utd,21,6,19,72,59,13,69,9
22,Fleetwood Town,18,14,14,55,43,12,68,10
22,Portsmouth,15,20,11,65,52,13,65,11
22,Charlton Ath,15,14,17,61,58,3,59,12
22,Exeter City,16,10,20,57,63,-6,58,13
22,Lincoln City,11,22,13,42,48,-6,55,14
22,Port Vale,14,10,22,45,65,-20,52,15
22,Bristol Rovers,13,12,21,59,79,-20,51,16
22,Cheltenham,13,12,21,36,56,-20,51,17
22,Burton Albion,13,10,23,58,85,-27,49,18
22,Oxford United,11,14,21,42,55,-13,47,19
22,Acc'ton Stanley,10,13,23,37,73,-36,43,20
22,Cambridge Utd,11,8,27,38,77,-39,41,21
22,Morecambe,9,13,24,41,70,-29,40,22
22,FG Rovers,9,13,24,35,75,-40,40,23
22,MK Dons,9,10,27,43,78,-35,37,24
23,Sheffield Weds,31,10,5,89,33,56,103,1
23,Plymouth Argyle,27,9,10,81,50,31,90,2
23,Wycombe,27,6,13,67,38,29,87,3
23,Derby County,25,11,10,82,48,34,86,4
23,Barnsley,25,9,12,72,45,27,84,5
23,Ipswich Town,23,13,10,82,45,37,82,6
23,Bolton,24,10,12,69,38,31,82,7
23,P'borough Utd,25,4,17,80,57,23,79,8
23,Portsmouth,19,16,11,73,58,15,73,9
23,Shrewsbury,20,8,18,53,54,-1,68,10
23,Charlton Ath,16,13,17,63,57,6,61,11
23,Lincoln City,13,20,13,39,45,-6,59,12
23,Bristol Rovers,17,8,21,74,88,-14,59,13
23,Fleetwood Town,14,15,17,49,51,-2,57,14
23,Oxford United,13,14,19,50,55,-5,53,15
23,Port Vale,12,13,21,49,68,-19,49,16
23,Exeter City,12,12,22,60,71,-11,48,17
23,Cheltenham,12,12,22,34,56,-22,48,18
23,Morecambe,11,14,21,45,70,-25,47,19
23,Burton Albion,13,8,25,54,95,-41,47,20
23,MK Dons,12,10,24,41,66,-25,46,21
23,Cambridge Utd,12,9,25,41,70,-29,45,22
23,Acc'ton Stanley,10,13,23,42,75,-33,43,23
23,FG Rovers,6,9,31,33,89,-56,27,24
24,Plymouth Argyle,32,8,6,90,47,43,104,1
24,Sheffield Weds,30,12,4,88,28,60,102,2
24,Ipswich Town,25,13,8,81,44,37,88,3
24,Barnsley,26,9,11,71,43,28,87,4
24,Derby County,23,13,10,69,40,29,82,5
24,Bolton,24,9,13,64,37,27,81,6
24,Wycombe,22,10,14,61,44,17,76,7
24,Shrewsbury,21,8,17,57,51,6,71,8
24,Portsmouth,18,15,13,62,54,8,69,9
24,P'borough Utd,20,6,20,70,63,7,66,10
24,Port Vale,18,8,20,52,62,-10,62,11
24,Fleetwood Town,15,16,15,51,42,9,61,12
24,Lincoln City,14,19,13,48,44,4,61,13
24,Charlton Ath,15,12,19,61,61,0,57,14
24,Oxford United,15,12,19,50,53,-3,57,15
24,Exeter City,14,12,20,55,63,-8,54,16
24,Acc'ton Stanley,13,13,20,40,66,-26,52,17
24,Bristol Rovers,14,9,23,61,76,-15,51,18
24,Morecambe,11,14,21,45,65,-20,47,19
24,MK Dons,11,10,25,39,68,-29,43,20
24,Burton Albion,10,11,25,46,80,-34,41,21
24,Cheltenham,11,8,27,33,70,-37,41,22
24,Cambridge Utd,11,7,28,33,75,-42,40,23
24,FG Rovers,6,12,28,33,84,-51,30,24
25,Plymouth Argyle,30,9,7,88,50,38,99,1
25,Sheffield Weds,26,14,6,81,34,47,92,2
25,Ipswich Town,24,17,5,81,41,40,89,3
25,Derby County,25,12,9,73,35,38,87,4
25,Bolton,25,11,10,72,38,34,86,5
25,Barnsley,25,8,13,75,52,23,83,6
25,Wycombe,24,8,14,65,41,24,80,7
25,Portsmouth,20,15,11,66,47,19,75,8
25,P'borough Utd,21,8,17,76,59,17,71,9
25,Shrewsbury,19,9,18,61,52,9,66,10
25,Port Vale,19,9,18,52,60,-8,66,11
25,Fleetwood Town,15,15,16,52,51,1,60,12
25,Cheltenham,16,11,19,39,51,-12,59,13
25,Lincoln City,12,20,14,44,48,-4,56,14
25,Exeter City,15,11,20,58,69,-11,56,15
25,Charlton Ath,13,15,18,58,62,-4,54,16
25,Oxford United,14,9,23,53,66,-13,51,17
25,Bristol Rovers,13,10,23,61,83,-22,49,18
25,Burton Albion,12,11,23,61,84,-23,47,19
25,Acc'ton Stanley,11,10,25,38,76,-38,43,20
25,Morecambe,9,15,22,46,79,-33,42,21
25,Cambridge Utd,10,9,27,37,76,-39,39,22
25,FG Rovers,9,10,27,39,79,-40,37,23
25,MK Dons,8,8,30,36,79,-43,32,24
26,Plymouth Argyle,28,11,7,89,50,39,95,1
26,Sheffield Weds,25,14,7,74,40,34,89,2
26,Ipswich Town,24,16,6,87,46,41,88,3
26,Barnsley,26,9,11,70,40,30,87,4
26,Bolton,24,12,10,75,38,37,84,5
26,Wycombe,25,7,14,68,43,25,82,6
26,Derby County,22,14,10,74,40,34,80,7
26,P'borough Utd,23,5,18,76,53,23,74,8
26,Portsmouth,20,14,12,68,52,16,74,9
26,Shrewsbury,18,9,19,54,50,4,63,10
26,Fleetwood Town,14,19,13,55,46,9,61,11
26,Exeter City,16,11,19,58,62,-4,59,12
26,Lincoln City,12,22,12,43,46,-3,58,13
26,Charlton Ath,14,15,17,67,67,0,57,14
26,Port Vale,15,12,19,53,65,-12,57,15
26,Oxford United,13,13,20,45,58,-13,52,16
26,Bristol Rovers,12,14,20,60,80,-20,50,17
26,MK Dons,13,9,24,44,69,-25,48,18
26,Cheltenham,12,9,25,33,56,-23,45,19
26,Cambridge Utd,12,9,25,38,75,-37,45,20
26,Acc'ton Stanley,10,13,23,38,79,-41,43,21
26,Morecambe,9,15,22,49,77,-28,42,22
26,Burton Albion,11,9,26,54,93,-39,42,23
26,FG Rovers,8,11,27,37,84,-47,35,24
27,Sheffield Weds,29,12,5,81,31,50,99,1
27,Ipswich Town,25,14,7,81,40,41,89,2
27,Plymouth Argyle,26,11,9,83,48,35,89,3
27,Derby County,25,11,10,74,44,30,86,4
27,Barnsley,23,11,12,64,45,19,80,5
27,Bolton,23,10,13,66,39,27,79,6
27,Wycombe,23,8,15,71,46,25,77,7
27,P'borough Utd,22,9,15,73,53,20,75,8
27,Portsmouth,20,13,13,65,52,13,73,9
27,Lincoln City,17,20,9,49,42,7,71,10
27,Charlton Ath,19,13,14,71,57,14,70,11
27,Shrewsbury,18,11,17,52,47,5,65,12
27,Fleetwood Town,16,15,15,51,42,9,63,13
27,Exeter City,17,12,17,61,57,4,63,14
27,Acc'ton Stanley,14,11,21,37,64,-27,53,15
27,Oxford United,13,12,21,47,57,-10,51,16
27,Port Vale,13,9,24,44,67,-23,48,17
27,Bristol Rovers,12,12,22,61,85,-24,48,18
27,Cheltenham,13,9,24,36,64,-28,48,19
27,MK Dons,13,7,26,43,66,-23,46,20
27,Burton Albion,10,10,26,53,90,-37,40,21
27,Morecambe,8,14,24,43,78,-35,38,22
27,Cambridge Utd,10,8,28,34,76,-42,38,23
27,FG Rovers,6,12,28,38,88,-50,30,24
28,Sheffield Weds,33,9,4,95,31,64,108,1
28,Plymouth Argyle,28,12,6,87,51,36,96,2
28,Ipswich Town,27,13,6,85,38,47,94,3
28,Derby County,26,12,8,81,39,42,90,4
28,Barnsley,25,8,13,73,47,26,83,5
28,Bolton,24,9,13,68,36,32,81,6
28,Wycombe,24,8,14,65,45,20,80,7
28,Portsmouth,19,13,14,63,55,8,70,8
28,P'borough Utd,22,3,21,76,60,16,69,9
28,Charlton Ath,16,13,17,63,57,6,61,10
28,Lincoln City,13,22,11,44,48,-4,61,11
28,Fleetwood Town,14,17,15,48,49,-1,59,12
28,Shrewsbury,16,8,22,51,55,-4,56,13
28,Acc'ton Stanley,14,14,18,44,67,-23,56,14
28,Exeter City,14,13,19,59,66,-7,55,15
28,Bristol Rovers,15,10,21,60,84,-24,55,16
28,Oxford United,12,15,19,42,51,-9,51,17
28,Port Vale,13,8,25,41,65,-24,47,18
28,MK Dons,12,10,24,42,61,-19,46,19
28,Burton Albion,12,10,24,53,87,-34,46,20
28,Morecambe,11,12,23,46,75,-29,45,21
28,Cambridge Utd,11,9,26,38,74,-36,42,22
28,Cheltenham,10,10,26,29,62,-33,40,23
28,FG Rovers,5,14,27,31,81,-50,29,24
29,Plymouth Argyle,28,10,8,85,55,30,94,1
29,Sheffield Weds,26,14,6,76,34,42,92,2
29,Ipswich Town,25,14,7,85,43,42,89,3
29,Derby County,26,11,9,82,40,42,89,4
29,Barnsley,25,8,13,75,45,30,83,5
29,Wycombe,25,8,13,70,43,27,83,6
29,Bolton,21,13,12,58,35,23,76,7
29,Portsmouth,18,18,10,56,46,10,72,8
29,P'borough Utd,21,8,17,70,56,14,71,9
29,Shrewsbury,19,10,17,49,47,2,67,10
29,Exeter City,17,12,17,58,60,-2,63,11
29,Charlton Ath,15,14,17,62,58,4,59,12
29,Lincoln City,13,20,13,44,47,-3,59,13
29,Oxford United,15,12,19,51,54,-3,57,14
29,Fleetwood Town,13,16,17,47,46,1,55,15
29,Port Vale,14,13,19,46,58,-12,55,16
29,Bristol Rovers,12,12,22,57,76,-19,48,17
29,MK Dons,13,9,24,45,71,-26,48,18
29,Cheltenham,12,11,23,36,59,-23,47,19
29,Cambridge Utd,12,10,24,42,72,-30,46,20
29,Burton Albion,11,11,24,47,81,-34,44,21
29,Acc'ton Stanley,9,16,21,38,67,-29,43,22
29,Morecambe,9,15,22,40,69,-29,42,23
29,FG Rovers,6,9,31,31,88,-57,27,24
30,Sheffield Weds,31,11,4,78,28,50,104,1
30,Plymouth Argyle,31,8,7,87,51,36,101,2
30,Barnsley,27,6,13,70,41,29,87,3
30,Derby County,25,11,10,70,41,29,86,4
30,Bolton,23,12,11,67,36,31,81,5
30,Wycombe,24,8,14,62,42,20,80,6
30,P'borough Utd,23,7,16,76,52,24,76,7
30,Ipswich Town,20,15,11,75,48,27,75,8
30,Shrewsbury,21,8,17,59,47,12,71,9
30,Charlton Ath,18,12,16,67,55,12,66,10
30,Fleetwood Town,17,15,14,53,44,9,66,11
30,Portsmouth,16,15,15,61,60,1,63,12
30,Exeter City,16,11,19,55,56,-1,59,13
30,Burton Albion,15,11,20,57,74,-17,56,14
30,Oxford United,14,12,20,45,54,-9,54,15
30,Bristol Rovers,15,8,23,58,82,-24,53,16
30,Lincoln City,11,19,16,40,49,-9,52,17
30,Port Vale,14,10,22,43,61,-18,52,18
30,Cheltenham,13,9,24,35,59,-24,48,19
30,MK Dons,12,9,25,45,71,-26,45,20
30,Morecambe,9,14,23,50,77,-27,41,21
30,Cambridge Utd,10,11,25,37,70,-33,41,22
30,Acc'ton Stanley,9,11,26,35,78,-43,38,23
30,FG Rovers,6,11,29,33,82,-49,29,24
31,Sheffield Weds,29,11,6,80,32,48,98,1
31,Plymouth Argyle,28,11,7,88,51,37,95,2
31,Ipswich Town,23,17,6,82,46,36,86,3
31,Barnsley,24,11,11,70,44,26,83,4
31,Derby County,23,13,10,73,42,31,82,5
31,Bolton,23,12,11,67,38,29,81,6
31,Wycombe,24,7,15,67,45,22,79,7
31,P'borough Utd,24,6,16,83,60,23,78,8
31,Portsmouth,20,12,14,71,56,15,72,9
31,Shrewsbury,18,10,18,50,49,1,64,10
31,Bristol Rovers,17,12,17,74,78,-4,63,11
31,Fleetwood Town,15,17,14,50,42,8,62,12
31,Charlton Ath,14,15,17,63,62,1,57,13
31,Exeter City,14,15,17,56,58,-2,57,14
31,Burton Albion,15,10,21,61,83,-22,55,15
31,Port Vale,14,11,21,55,73,-18,53,16
31,Lincoln City,9,25,12,42,47,-5,52,17
31,Cambridge Utd,14,8,24,42,74,-32,50,18
31,Oxford United,12,13,21,43,59,-16,49,19
31,Acc'ton Stanley,11,13,22,42,73,-31,46,20
31,Cheltenham,12,9,25,37,64,-27,45,21
31,MK Dons,11,9,26,45,74,-29,42,22
31,Morecambe,8,12,26,45,82,-37,36,23
31,FG Rovers,5,11,30,34,88,-54,26,24
32,Sheffield Weds,29,14,3,92,34,58,101,1
32,Plymouth Argyle,30,10,6,91,48,43,100,2
32,Bolton,26,11,9,75,33,42,89,3
32,Ipswich Town,24,16,6,82,44,38,88,4
32,Derby County,24,11,11,75,43,32,83,5
32,Barnsley,24,9,13,71,45,26,81,6
32,Wycombe,22,11,13,67,49,18,77,7
32,P'borough Utd,23,6,17,77,56,21,75,8
32,Portsmouth,18,15,13,63,56,7,69,9
32,Shrewsbury,19,11,16,59,46,13,68,10
32,Fleetwood Town,16,15,15,50,45,5,63,11
32,Charlton Ath,14,16,16,62,60,2,58,12
32,Lincoln City,11,22,13,41,53,-12,55,13
32,Port Vale,15,9,22,46,68,-22,54,14
32,Oxford United,13,13,20,50,58,-8,52,15
32,Exeter City,13,13,20,54,64,-10,52,16
32,Cambridge Utd,14,7,25,38,70,-32,49,17
32,Cheltenham,13,9,24,36,61,-25,48,18
32,Bristol Rovers,12,11,23,63,91,-28,47,19
32,MK Dons,11,11,24,47,67,-20,44,20
32,Burton Albion,10,13,23,51,88,-37,43,21
32,Morecambe,9,14,23,40,67,-27,41,22
32,Acc'ton Stanley,9,14,23,35,70,-35,41,23
32,FG Rovers,6,13,27,40,89,-49,31,24
33,Sheffield Weds,31,10,5,91,29,62,103,1
33,Plymouth Argyle,29,10,7,85,46,39,97,2
33,Ipswich Town,26,13,7,94,47,47,91,3
33,Derby County,27,9,10,91,47,44,90,4
33,Barnsley,27,7,12,77,45,32,88,5
33,Bolton,22,13,11,67,37,30,79,6
33,Shrewsbury,23,7,16,57,47,10,76,7
33,Wycombe,22,8,16,63,46,17,74,8
33,P'borough Utd,23,4,19,76,55,21,73,9
33,Portsmouth,19,15,12,64,54,10,72,10
33,Fleetwood Town,18,14,14,58,47,11,68,11
33,Charlton Ath,17,14,15,68,55,13,65,12
33,Exeter City,14,14,18,57,62,-5,56,13
33,Port Vale,16,8,22,50,63,-13,56,14
33,Lincoln City,10,23,13,38,44,-6,53,15
33,Cheltenham,13,11,22,40,58,-18,50,16
33,Bristol Rovers,13,10,23,55,84,-29,49,17
33,Morecambe,11,15,20,47,71,-24,48,18
33,Oxford United,11,14,21,44,59,-15,47,19
33,Acc'ton Stanley,10,12,24,36,76,-40,42,20
33,Burton Albion,10,10,26,50,103,-53,40,21
33,Cambridge Utd,11,6,29,40,83,-43,39,22
33,MK Dons,9,10,27,37,71,-34,37,23
33,FG Rovers,7,9,30,32,88,-56,30,24
34,Plymouth Argyle,30,10,6,79,41,38,100,1
34,Sheffield Weds,30,9,7,84,38,46,99,2
34,Bolton,28,9,9,76,35,41,93,3
34,Derby County,27,10,9,76,39,37,91,4
34,Ipswich Town,24,14,8,90,46,44,86,5
34,Barnsley,26,8,12,75,44,31,86,6
34,P'borough Utd,24,6,16,79,58,21,78,7
34,Wycombe,23,6,17,62,47,15,75,8
34,Fleetwood Town,19,13,14,54,42,12,70,9
34,Shrewsbury,21,7,18,57,52,5,70,10
34,Portsmouth,18,15,13,64,51,13,69,11
34,Charlton Ath,15,16,15,68,64,4,61,12
34,Lincoln City,14,19,13,45,47,-2,61,13
34,Port Vale,15,12,19,48,63,-15,57,14
34,Exeter City,14,11,21,58,62,-4,53,15
34,Acc'ton Stanley,12,13,21,40,62,-22,49,16
34,Oxford United,12,11,23,46,62,-16,47,17
34,Bristol Rovers,12,11,23,58,83,-25,47,18
34,Burton Albion,12,10,24,54,88,-34,46,19
34,Cheltenham,11,11,24,36,69,-33,44,20
34,Cambridge Utd,12,5,29,36,71,-35,41,21
34,Morecambe,9,13,24,45,76,-31,40,22
34,MK Dons,9,8,29,37,75,-38,35,23
34,FG Rovers,7,9,30,33,85,-52,30,24
35,Sheffield Weds,30,12,4,81,27,54,102,1
35,Plymouth Argyle,29,11,6,88,44,44,98,2
35,Ipswich Town,26,13,7,81,40,41,91,3
35,Wycombe,25,7,14,66,43,23,82,4
35,P'borough Utd,24,5,17,79,53,26,77,5
35,Shrewsbury,22,9,15,56,43,13,75,6
35,Bolton,21,11,14,62,38,24,74,7
35,Barnsley,21,11,14,61,44,17,74,8
35,Portsmouth,19,16,11,69,51,18,73,9
35,Derby County,20,12,14,64,48,16,72,10
35,Fleetwood Town,19,13,14,60,43,17,70,11
35,Charlton Ath,17,14,15,66,59,7,65,12
35,Lincoln City,12,20,14,44,49,-5,56,13
35,Exeter City,14,12,20,53,62,-9,54,14
35,Port Vale,15,9,22,48,71,-23,54,15
35,Oxford United,14,11,21,47,59,-12,53,16
35,Bristol Rovers,13,14,19,58,74,-16,53,17
35,Burton Albion,12,12,22,52,85,-33,48,18
35,Acc'ton Stanley,11,14,21,46,72,-26,47,19
35,Cheltenham,12,9,25,33,58,-25,45,20
35,MK Dons,11,8,27,42,71,-29,41,21
35,Morecambe,9,13,24,44,80,-36,40,22
35,Cambridge Utd,11,6,29,38,78,-40,39,23
35,FG Rovers,9,10,27,38,84,-46,37,24
36,Sheffield Weds,31,11,4,90,34,56,104,1
36,Plymouth Argyle,29,10,7,84,50,34,97,2
36,Ipswich Town,25,15,6,90,46,44,90,3
36,Derby County,25,12,9,76,37,39,87,4
36,Barnsley,26,8,12,75,45,30,86,5
36,Wycombe,24,9,13,67,39,28,81,6
36,Bolton,23,11,12,67,37,30,80,7
36,P'borough Utd,24,6,16,83,58,25,78,8
36,Portsmouth,18,13,15,60,60,0,67,9
36,Shrewsbury,20,6,20,53,53,0,66,10
36,Charlton Ath,17,13,16,72,61,11,64,11
36,Fleetwood Town,14,16,16,46,52,-6,58,12
36,Exeter City,14,15,17,62,63,-1,57,13
36,Lincoln City,12,21,13,39,47,-8,57,14
36,Oxford United,13,12,21,51,63,-12,51,15
36,MK Dons,14,8,24,52,68,-16,50,16
36,Port Vale,13,10,23,45,69,-24,49,17
36,Bristol Rovers,12,12,22,57,80,-23,48,18
36,Cambridge Utd,13,8,25,43,70,-27,47,19
36,Burton Albion,11,12,23,56,85,-29,45,20
36,Acc'ton Stanley,11,12,23,38,71,-33,45,21
36,Cheltenham,11,10,25,33,64,-31,43,22
36,Morecambe,10,12,24,48,80,-32,42,23
36,FG Rovers,5,12,29,34,89,-55,27,24
37,Sheffield Weds,31,12,3,82,31,51,105,1
37,Plymouth Argyle,27,12,7,89,47,42,93,2
37,Ipswich Town,23,15,8,80,45,35,84,3
37,Bolton,24,12,10,65,35,30,84,4
37,Derby County,22,14,10,75,42,33,80,5
37,Barnsley,23,11,12,67,45,22,80,6
37,P'borough Utd,23,6,17,79,55,24,75,7
37,Portsmouth,19,15,12,72,51,21,72,8
37,Wycombe,21,9,16,60,45,15,72,9
37,Fleetwood Town,15,16,15,42,39,3,61,10
37,Lincoln City,14,19,13,43,47,-4,61,11
37,Bristol Rovers,16,13,17,62,72,-10,61,12
37,Burton Albion,17,9,20,61,82,-21,60,13
37,Charlton Ath,15,14,17,59,61,-2,59,14
37,Shrewsbury,15,13,18,54,56,-2,58,15
37,Port Vale,16,8,22,48,63,-15,56,16
37,Acc'ton Stanley,13,14,19,41,68,-27,53,17
37,Exeter City,12,15,19,53,60,-7,51,18
37,Cheltenham,13,10,23,36,57,-21,49,19
37,Oxford United,11,13,22,44,59,-15,46,20
37,MK Dons,12,8,26,45,72,-27,44,21
37,Morecambe,9,13,24,45,75,-30,40,22
37,Cambridge Utd,11,7,28,39,74,-35,40,23
37,FG Rovers,6,10,30,32,92,-60,28,24
38,Sheffield Weds,30,12,4,84,30,54,102,1
38,Plymouth Argyle,29,10,7,91,51,40,97,2
38,Ipswich Town,24,16,6,84,43,41,88,3
38,Derby County,24,12,10,73,37,36,84,4
38,Bolton,25,9,12,72,39,33,84,5
38,Barnsley,24,11,11,71,42,29,83,6
38,Wycombe,24,8,14,69,44,25,80,7
38,Shrewsbury,22,10,14,60,45,15,76,8
38,Portsmouth,20,14,12,64,48,16,74,9
38,P'borough Utd,22,7,17,73,61,12,73,10
38,Charlton Ath,15,15,16,62,61,1,60,11
38,Exeter City,16,12,18,65,67,-2,60,12
38,Fleetwood Town,14,16,16,48,47,1,58,13
38,Port Vale,14,11,21,47,69,-22,53,14
38,Oxford United,14,10,22,49,61,-12,52,15
38,Cheltenham,15,6,25,36,58,-22,51,16
38,Burton Albion,13,11,22,56,81,-25,50,17
38,Bristol Rovers,12,12,22,62,86,-24,48,18
38,Acc'ton Stanley,12,12,22,41,68,-27,48,19
38,Lincoln City,9,20,17,37,57,-20,47,20
38,MK Dons,11,8,27,41,68,-27,41,21
38,Morecambe,9,12,25,46,79,-33,39,22
38,Cambridge Utd,10,9,27,41,77,-36,39,23
38,FG Rovers,7,11,28,35,88,-53,32,24
39,Plymouth Argyle,29,10,7,90,51,39,97,1
39,Barnsley,29,8,9,86,42,44,95,2
39,Sheffield Weds,27,13,6,79,32,47,94,3
39,Ipswich Town,23,16,7,93,49,44,85,4
39,Bolton,25,10,11,66,35,31,85,5
39,Wycombe,24,9,13,69,44,25,81,6
39,Derby County,21,15,10,75,46,29,78,7
39,P'borough Utd,23,6,17,72,54,18,75,8
39,Portsmouth,19,16,11,66,52,14,73,9
39,Shrewsbury,18,10,18,49,51,-2,64,10
39,Fleetwood Town,14,18,14,52,48,4,60,11
39,Exeter City,16,12,18,59,62,-3,60,12
39,Lincoln City,13,21,12,37,44,-7,60,13
39,Charlton Ath,15,14,17,63,61,2,59,14
39,Port Vale,16,8,22,52,63,-11,56,15
39,Cheltenham,14,11,21,35,57,-22,53,16
39,Bristol Rovers,13,11,22,61,82,-21,50,17
39,Acc'ton Stanley,11,15,20,39,67,-28,48,18
39,Oxford United,11,14,21,41,55,-14,47,19
39,Burton Albion,11,9,26,54,91,-37,42,20
39,Morecambe,9,14,23,46,75,-29,41,21
39,MK Dons,11,8,27,40,73,-33,41,22
39,Cambridge Utd,11,6,29,34,71,-37,39,23
39,FG Rovers,7,10,29,31,84,-53,31,24
40,Sheffield Weds,31,11,4,88,32,56,104,1
40,Plymouth Argyle,29,9,8,89,52,37,96,2
40,Ipswich Town,24,15,7,82,42,40,87,3
40,Bolton,24,12,10,64,36,28,84,4
40,Barnsley,25,9,12,72,46,26,84,5
40,Derby County,24,10,12,72,44,28,82,6
40,Wycombe,23,8,15,66,49,17,77,7
40,Portsmouth,19,16,11,73,55,18,73,8
40,P'borough Utd,21,8,17,66,50,16,71,9
40,Fleetwood Town,18,14,14,55,46,9,68,10
40,Shrewsbury,19,11,16,54,50,4,68,11
40,Charlton Ath,16,15,15,60,62,-2,63,12
40,Exeter City,15,13,18,59,58,1,58,13
40,Lincoln City,12,18,16,46,52,-6,54,14
40,Burton Albion,13,12,21,61,78,-17,51,15
40,Port Vale,13,11,22,46,66,-20,50,16
40,Oxford United,12,13,21,45,57,-12,49,17
40,Bristol Rovers,12,12,22,64,84,-20,48,18
40,Cheltenham,14,6,26,40,69,-29,48,19
40,MK Dons,12,10,24,45,68,-23,46,20
40,Morecambe,11,13,22,46,70,-24,46,21
40,Acc'ton Stanley,10,13,23,35,70,-35,43,22
40,Cambridge Utd,10,9,27,39,79,-40,39,23
40,FG Rovers,6,10,30,36,88,-52,28,24
41,Sheffield Weds,30,12,4,83,31,52,102,1
41,Plymouth Argyle,30,10,6,90,47,43,100,2
41,Ipswich Town,27,12,7,86,40,46,93,3
41,Derby County,27,10,9,76,40,36,91,4
41,Barnsley,26,8,12,73,42,31,86,5
41,Wycombe,25,8,13,68,38,30,83,6
41,P'borough Utd,22,8,16,74,53,21,74,7
41,Bolton,21,11,14,64,44,20,74,8
41,Portsmouth,18,17,11,61,50,11,71,9
41,Charlton Ath,18,15,13,69,58,11,69,10
41,Shrewsbury,17,10,19,56,55,1,61,11
41,Exeter City,15,13,18,59,57,2,58,12
41,Bristol Rovers,16,9,21,61,85,-24,57,13
41,Fleetwood Town,13,16,17,46,46,0,55,14
41,Port Vale,15,8,23,46,64,-18,53,15
41,Oxford United,13,12,21,45,56,-11,51,16
41,Lincoln City,11,18,17,40,53,-13,51,17
41,Cheltenham,12,9,25,35,63,-28,45,18
41,Cambridge Utd,12,9,25,43,72,-29,45,19
41,Burton Albion,11,12,23,54,88,-34,45,20
41,Acc'ton Stanley,11,12,23,36,71,-35,45,21
41,Morecambe,9,16,21,46,73,-27,43,22
41,MK Dons,10,7,29,42,77,-35,37,23
41,FG Rovers,7,10,29,34,84,-50,31,24
42,Plymouth Argyle,32,8,6,96,50,46,104,1
42,Sheffield Weds,28,13,5,78,31,47,97,2
42,Ipswich Town,25,13,8,85,47,38,88,3
42,Derby County,25,10,11,78,44,34,85,4
42,Bolton,24,11,11,69,40,29,83,5
42,Barnsley,24,11,11,62,39,23,83,6
42,Wycombe,22,11,13,63,41,22,77,7
42,P'borough Utd,23,8,15,73,52,21,77,8
42,Portsmouth,18,16,12,62,53,9,70,9
42,Shrewsbury,19,10,17,49,44,5,67,10
42,Fleetwood Town,15,16,15,51,47,4,61,11
42,Charlton Ath,15,13,18,69,68,1,58,12
42,Lincoln City,11,24,11,46,47,-1,57,13
42,Oxford United,14,11,21,49,53,-4,53,14
42,Bristol Rovers,13,13,20,65,81,-16,52,15
42,Port Vale,15,7,24,51,73,-22,52,16
42,Exeter City,13,11,22,52,64,-12,50,17
42,Burton Albion,12,11,23,60,91,-31,47,18
42,Acc'ton Stanley,11,13,22,37,67,-30,46,19
42,MK Dons,11,11,24,42,65,-23,44,20
42,Cambridge Utd,11,10,25,37,69,-32,43,21
42,Cheltenham,10,11,25,32,61,-29,41,22
42,Morecambe,9,13,24,43,81,-38,40,23
42,FG Rovers,9,11,26,35,76,-41,38,24
43,Sheffield Weds,31,9,6,81,30,51,102,1
43,Barnsley,29,7,10,82,44,38,94,2
43,Plymouth Argyle,28,10,8,83,50,33,94,3
43,Bolton,26,10,10,74,36,38,88,4
43,Ipswich Town,24,15,7,78,41,37,87,5
43,Derby County,24,11,11,74,40,34,83,6
43,Portsmouth,20,15,11,66,47,19,75,7
43,Wycombe,23,6,17,62,49,13,75,8
43,P'borough Utd,21,7,18,74,59,15,70,9
43,Charlton Ath,17,14,15,63,52,11,65,10
43,Fleetwood Town,16,17,13,53,46,7,65,11
43,Shrewsbury,19,7,20,54,50,4,64,12
43,Exeter City,16,12,18,57,57,0,60,13
43,Port Vale,16,12,18,51,61,-10,60,14
43,Bristol Rovers,16,11,19,63,73,-10,59,15
43,Oxford United,13,11,22,43,57,-14,50,16
43,Burton Albion,12,13,21,55,82,-27,49,17
43,Lincoln City,9,20,17,40,54,-14,47,18
43,Cheltenham,11,11,24,37,64,-27,44,19
43,Acc'ton Stanley,9,15,22,34,72,-38,42,20
43,MK Dons,10,10,26,41,72,-31,40,21
43,Morecambe,9,12,25,38,74,-36,39,22
43,Cambridge Utd,10,7,29,34,78,-44,37,23
43,FG Rovers,7,10,29,33,82,-49,31,24
44,Sheffield Weds,28,15,3,83,35,48,99,1
44,Plymouth Argyle,29,11,6,95,48,47,98,2
44,Derby County,24,13,9,77,42,35,85,3
44,Barnsley,25,9,12,72,41,31,84,4
44,Ipswich Town,22,17,7,77,45,32,83,5
44,Wycombe,25,8,13,67,40,27,83,6
44,Bolton,23,12,11,65,38,27,81,7
44,P'borough Utd,23,5,18,77,56,21,74,8
44,Portsmouth,18,17,11,66,57,9,71,9
44,Fleetwood Town,18,14,14,59,42,17,68,10
44,Shrewsbury,19,9,18,60,52,8,66,11
44,Charlton Ath,18,11,17,63,61,2,65,12
44,Exeter City,16,14,16,60,56,4,62,13
44,Burton Albion,15,12,19,62,75,-13,57,14
44,Oxford United,15,11,20,50,56,-6,56,15
44,Port Vale,15,9,22,44,63,-19,54,16
44,Lincoln City,10,20,16,35,50,-15,50,17
44,Bristol Rovers,14,8,24,64,90,-26,50,18
44,MK Dons,12,8,26,40,70,-30,44,19
44,Cheltenham,10,13,23,34,64,-30,43,20
44,Morecambe,9,15,22,43,71,-28,42,21
44,Cambridge Utd,10,8,28,36,71,-35,38,22
44,Acc'ton Stanley,8,11,27,31,83,-52,35,23
44,FG Rovers,6,10,30,35,89,-54,28,24
45,Sheffield Weds,32,9,5,79,28,51,105,1
45,Ipswich Town,25,14,7,84,41,43,89,2
45,Plymouth Argyle,25,13,8,82,50,32,88,3
45,Barnsley,24,11,11,74,41,33,83,4
45,Bolton,24,9,13,65,39,26,81,5
45,Derby County,22,12,12,70,42,28,78,6
45,P'borough Utd,23,4,19,75,63,12,73,7
45,Portsmouth,19,15,12,63,51,12,72,8
45,Wycombe,21,8,17,61,45,16,71,9
45,Shrewsbury,20,8,18,52,49,3,68,10
45,Fleetwood Town,17,16,13,57,45,12,67,11
45,Charlton Ath,18,12,16,62,54,8,66,12
45,Exeter City,16,11,19,59,58,1,59,13
45,Lincoln City,13,20,13,41,48,-7,59,14
45,Bristol Rovers,14,11,21,58,74,-16,53,15
45,Port Vale,14,11,21,43,61,-18,53,16
45,Cheltenham,14,10,22,42,60,-18,52,17
45,Oxford United,13,11,22,43,55,-12,50,18
45,Burton Albion,12,11,23,60,89,-29,47,19
45,MK Dons,12,10,24,46,67,-21,46,20
45,Morecambe,11,12,23,46,78,-32,45,21
45,Cambridge Utd,13,6,27,38,75,-37,45,22
45,Acc'ton Stanley,9,13,24,33,70,-37,40,23
45,FG Rovers,7,11,28,37,87,-50,32,24
46,Sheffield Weds,29,13,4,87,34,53,100,1
46,Plymouth Argyle,26,12,8,86,54,32,90,2
46,Ipswich Town,22,20,4,80,42,38,86,3
46,Barnsley,26,7,13,70,43,27,85,4
46,Derby County,24,12,10,80,43,37,84,5
46,Wycombe,26,5,15,72,43,29,83,6
46,Bolton,24,10,12,75,42,33,82,7
46,Shrewsbury,22,9,15,59,48,11,75,8
46,P'borough Utd,20,7,19,68,59,9,67,9
46,Portsmouth,17,14,15,65,58,7,65,10
46,Fleetwood Town,16,16,14,53,44,9,64,11
46,Lincoln City,14,20,12,45,49,-4,62,12
46,Oxford United,16,10,20,54,53,1,58,13
46,Exeter City,15,12,19,53,60,-7,57,14
46,Charlton Ath,13,17,16,64,63,1,56,15
46,Morecambe,13,14,19,51,69,-18,53,16
46,Bristol Rovers,14,11,21,64,85,-21,53,17
46,Port Vale,13,10,23,42,66,-24,49,18
46,Acc'ton Stanley,12,13,21,38,69,-31,49,19
46,Burton Albion,11,13,22,59,88,-29,46,20
46,Cambridge Utd,12,9,25,44,71,-27,45,21
46,Cheltenham,11,8,27,36,69,-33,41,22
46,MK Dons,8,10,28,38,78,-40,34,23
46,FG Rovers,7,10,29,34,87,-53,31,24
47,Sheffield Weds,32,9,5,93,30,63,105,1
47,Barnsley,27,9,10,82,46,36,90,2
47,Plymouth Argyle,27,9,10,84,52,32,90,3
47,Derby County,25,10,11,72,40,32,85,4
47,Wycombe,25,10,11,64,39,25,85,5
47,Ipswich Town,23,15,8,79,48,31,84,6
47,Bolton,24,10,12,68,36,32,82,7
47,P'borough Utd,24,3,19,88,65,23,75,8
47,Shrewsbury,22,9,15,63,52,11,75,9
47,Portsmouth,18,14,14,67,53,14,68,10
47,Charlton Ath,17,13,16,67,57,10,64,11
47,Fleetwood Town,15,17,14,49,42,7,62,12
47,Exeter City,17,11,18,61,61,0,62,13
47,Port Vale,15,10,21,45,67,-22,55,14
47,Lincoln City,10,21,15,41,49,-8,51,15
47,Bristol Rovers,14,8,24,65,90,-25,50,16
47,Oxford United,12,13,21,46,63,-17,49,17
47,Morecambe,12,11,23,48,73,-25,47,18
47,Burton Albion,11,13,22,55,82,-27,46,19
47,Cambridge Utd,13,7,26,37,70,-33,46,20
47,Cheltenham,10,13,23,31,60,-29,43,21
47,MK Dons,10,9,27,38,72,-34,39,22
47,Acc'ton Stanley,9,11,26,36,80,-44,38,23
47,FG Rovers,6,13,27,35,87,-52,31,24
48,Sheffield Weds,29,10,7,88,35,53,97,1
48,Plymouth Argyle,28,12,6,84,46,38,96,2
48,Bolton,28,9,9,73,34,39,93,3
48,Ipswich Town,24,16,6,86,43,43,88,4
48,Derby County,24,15,7,76,41,35,87,5
48,Barnsley,26,9,11,72,42,30,87,6
48,Wycombe,24,8,14,65,45,20,80,7
48,Portsmouth,19,18,9,73,48,25,75,8
48,P'borough Utd,23,5,18,80,60,20,74,9
48,Shrewsbury,20,8,18,60,59,1,68,10
48,Charlton Ath,15,15,16,66,63,3,60,11
48,Fleetwood Town,14,16,16,50,50,0,58,12
48,Lincoln City,12,22,12,44,47,-3,58,13
48,Exeter City,15,11,20,61,61,0,56,14
48,Port Vale,15,9,22,46,72,-26,54,15
48,Oxford United,12,15,19,50,58,-8,51,16
48,Morecambe,11,13,22,51,77,-26,46,17
48,Cheltenham,12,10,24,35,63,-28,46,18
48,Burton Albion,12,9,25,51,91,-40,45,19
48,Bristol Rovers,11,11,24,63,88,-25,44,20
48,Acc'ton Stanley,10,13,23,36,66,-30,43,21
48,Cambridge Utd,10,8,28,32,72,-40,38,22
48,MK Dons,9,10,27,41,74,-33,37,23
48,FG Rovers,7,12,27,40,88,-48,33,24
49,Sheffield Weds,30,12,4,81,30,51,102,1
49,Barnsley,26,10,10,70,37,33,88,2
49,Ipswich Town,24,15,7,82,40,42,87,3
49,Bolton,26,9,11,72,38,34,87,4
49,Plymouth Argyle,25,12,9,83,54,29,87,5
49,Wycombe,25,6,15,67,45,22,81,6
49,Portsmouth,21,15,10,63,42,21,78,7
49,Derby County,22,11,13,67,46,21,77,8
49,P'borough Utd,23,5,18,73,56,17,74,9
49,Charlton Ath,18,13,15,64,56,8,67,10
49,Shrewsbury,19,10,17,56,48,8,67,11
49,Fleetwood Town,15,15,16,48,47,1,60,12
49,Bristol Rovers,16,11,19,65,80,-15,59,13
49,Lincoln City,11,22,13,48,52,-4,55,14
49,Port Vale,14,11,21,46,64,-18,53,15
49,Exeter City,13,13,20,55,62,-7,52,16
49,Oxford United,12,14,20,45,54,-9,50,17
49,Cheltenham,12,12,22,33,57,-24,48,18
49,Acc'ton Stanley,11,12,23,44,74,-30,45,19
49,Cambridge Utd,11,12,23,36,66,-30,45,20
49,Burton Albion,12,9,25,53,88,-35,45,21
49,MK Dons,10,8,28,36,67,-31,38,22
49,Morecambe,7,16,23,40,76,-36,37,23
49,FG Rovers,6,13,27,32,80,-48,31,24
50,Sheffield Weds,30,11,5,93,32,61,101,1
50,Ipswich Town,26,14,6,83,40,43,92,2
50,Plymouth Argyle,26,12,8,88,54,34,90,3
50,Bolton,26,10,10,71,34,37,88,4
50,Derby County,24,13,9,80,43,37,85,5
50,Barnsley,25,9,12,72,44,28,84,6
50,Wycombe,26,6,14,62,38,24,84,7
50,P'borough Utd,23,5,18,78,55,23,74,8
50,Portsmouth,19,16,11,63,53,10,73,9
50,Shrewsbury,19,11,16,58,55,3,68,10
50,Fleetwood Town,16,14,16,52,42,10,62,11
50,Charlton Ath,16,13,17,65,62,3,61,12
50,Port Vale,16,12,18,51,57,-6,60,13
50,Lincoln City,12,20,14,44,55,-11,56,14
50,Acc'ton Stanley,14,14,18,51,69,-18,56,15
50,Exeter City,14,11,21,59,66,-7,53,16
50,Bristol Rovers,14,10,22,63,85,-22,52,17
50,Oxford United,13,11,22,53,64,-11,50,18
50,Morecambe,12,12,22,48,71,-23,48,19
50,Cheltenham,11,10,25,29,65,-36,43,20
50,Burton Albion,11,10,25,54,95,-41,43,21
50,MK Dons,9,11,26,42,73,-31,38,22
50,Cambridge Utd,9,8,29,32,77,-45,35,23
50,FG Rovers,5,9,32,29,91,-62,24,24
51,Plymouth Argyle,30,11,5,93,46,47,101,1
51,Sheffield Weds,28,12,6,75,28,47,96,2
51,Ipswich Town,26,14,6,87,42,45,92,3
51,Barnsley,26,10,10,75,42,33,88,4
51,Bolton,24,12,10,67,36,31,84,5
51,Derby County,21,15,10,73,39,34,78,6
51,P'borough Utd,24,5,17,76,53,23,77,7
51,Shrewsbury,19,10,17,57,50,7,67,8
51,Wycombe,19,10,17,57,51,6,67,9
51,Portsmouth,17,16,13,60,55,5,67,10
51,Fleetwood Town,15,15,16,53,50,3,60,11
51,Lincoln City,13,19,14,42,50,-8,58,12
51,Charlton Ath,14,14,18,59,58,1,56,13
51,Oxford United,15,11,20,53,57,-4,56,14
51,Port Vale,15,11,20,47,63,-16,56,15
51,Exeter City,14,12,20,60,64,-4,54,16
51,Bristol Rovers,14,11,21,56,72,-16,53,17
51,Burton Albion,14,10,22,55,80,-25,52,18
51,Cheltenham,12,9,25,36,68,-32,45,19
51,MK Dons,11,11,24,48,70,-22,44,20
51,Morecambe,10,14,22,40,70,-30,44,21
51,Acc'ton Stanley,10,14,22,40,75,-35,44,22
51,Cambridge Utd,11,9,26,37,73,-36,42,23
51,FG Rovers,7,11,28,37,91,-54,32,24
52,Sheffield Weds,29,12,5,83,28,55,99,1
52,Barnsley,29,7,10,83,39,44,94,2
52,Plymouth Argyle,28,8,10,78,57,21,92,3
52,Bolton,26,8,12,74,37,37,86,4
52,Ipswich Town,23,13,10,87,48,39,82,5
52,Derby County,24,10,12,78,43,35,82,6
52,Wycombe,24,6,16,66,43,23,78,7
52,Shrewsbury,23,8,15,62,42,20,77,8
52,P'borough Utd,21,8,17,69,57,12,71,9
52,Portsmouth,19,14,13,63,53,10,71,10
52,Fleetwood Town,19,14,13,51,43,8,71,11
52,Exeter City,16,12,18,62,65,-3,60,12
52,Lincoln City,12,23,11,44,41,3,59,13
52,Charlton Ath,14,14,18,66,67,-1,56,14
52,Oxford United,14,13,19,50,60,-10,55,15
52,Port Vale,15,10,21,48,65,-17,55,16
52,Bristol Rovers,14,11,21,60,80,-20,53,17
52,Cheltenham,13,10,23,33,60,-27,49,18
52,Cambridge Utd,12,8,26,38,75,-37,44,19
52,MK Dons,11,10,25,46,69,-23,43,20
52,Acc'ton Stanley,9,14,23,37,69,-32,41,21
52,Burton Albion,10,11,25,49,90,-41,41,22
52,Morecambe,8,10,28,42,87,-45,34,23
52,FG Rovers,6,12,28,30,81,-51,30,24
53,Sheffield Weds,30,11,5,83,33,50,101,1
53,Plymouth Argyle,28,10,8,82,52,30,94,2
53,Ipswich Town,24,16,6,85,44,41,88,3
53,Barnsley,27,7,12,74,45,29,88,4
53,Derby County,25,12,9,79,42,37,87,5
53,Wycombe,25,8,13,67,40,27,83,6
53,Bolton,24,10,12,68,35,33,82,7
53,P'borough Utd,22,6,18,76,57,19,72,8
53,Portsmouth,19,15,12,65,51,14,72,9
53,Shrewsbury,20,11,15,57,47,10,71,10
53,Fleetwood Town,16,15,15,57,48,9,63,11
53,Port Vale,16,10,20,47,70,-23,58,12
53,Lincoln City,12,20,14,47,51,-4,56,13
53,Burton Albion,15,10,21,63,78,-15,55,14
53,Bristol Rovers,15,10,21,60,78,-18,55,15
53,Charlton Ath,13,13,20,61,66,-5,52,16
53,Exeter City,14,10,22,57,70,-13,52,17
53,Oxford United,11,13,22,48,61,-13,46,18
53,Cheltenham,12,9,25,36,69,-33,45,19
53,Cambridge Utd,13,5,28,36,73,-37,44,20
53,Morecambe,9,15,22,46,73,-27,42,21
53,Acc'ton Stanley,8,17,21,39,69,-30,41,22
53,MK Dons,11,8,27,40,72,-32,41,23
53,FG Rovers,8,9,29,32,81,-49,33,24
54,Sheffield Weds,30,11,5,91,28,63,101,1
54,Plymouth Argyle,29,10,7,84,45,39,97,2
54,Barnsley,29,6,11,82,39,43,93,3
54,Ipswich Town,25,16,5,84,40,44,91,4
54,Derby County,25,12,9,77,38,39,87,5
54,Bolton,25,11,10,64,30,34,86,6
54,P'borough Utd,24,5,17,79,59,20,77,7
54,Wycombe,22,10,14,57,40,17,76,8
54,Portsmouth,19,17,10,62,47,15,74,9
54,Shrewsbury,18,9,19,53,49,4,63,10
54,Lincoln City,13,21,12,41,48,-7,60,11
54,Charlton Ath,15,14,17,58,58,0,59,12
54,Exeter City,16,11,19,58,60,-2,59,13
54,Bristol Rovers,16,11,19,59,73,-14,59,14
54,Fleetwood Town,14,15,17,43,44,-1,57,15
54,MK Dons,14,9,23,42,65,-23,51,16
54,Oxford United,12,13,21,47,62,-15,49,17
54,Port Vale,13,9,24,45,75,-30,48,18
54,Burton Albion,12,8,26,52,87,-35,44,19
54,Acc'ton Stanley,9,15,22,34,65,-31,42,20
54,Morecambe,8,15,23,39,69,-30,39,21
54,Cheltenham,10,9,27,33,67,-34,39,22
54,Cambridge Utd,9,10,27,35,74,-39,37,23
54,FG Rovers,5,13,28,27,84,-57,28,24
55,Sheffield Weds,30,12,4,79,32,47,102,1
55,Ipswich Town,25,15,6,84,43,41,90,2
55,Plymouth Argyle,26,12,8,86,50,36,90,3
55,Barnsley,25,9,12,70,44,26,84,4
55,Bolton,23,12,11,66,37,29,81,5
55,Wycombe,23,11,12,66,41,25,80,6
55,Derby County,23,10,13,73,44,29,79,7
55,Shrewsbury,22,9,15,63,51,12,75,8
55,Portsmouth,20,12,14,69,51,18,72,9
55,P'borough Utd,20,7,19,75,65,10,67,10
55,Charlton Ath,18,13,15,65,58,7,67,11
55,Exeter City,18,11,17,63,56,7,65,12
55,Oxford United,16,12,18,54,56,-2,60,13
55,Fleetwood Town,14,17,15,51,49,2,59,14
55,Bristol Rovers,15,11,20,58,74,-16,56,15
55,Lincoln City,10,21,15,45,53,-8,51,16
55,MK Dons,14,7,25,42,63,-21,49,17
55,Burton Albion,13,10,23,56,81,-25,49,18
55,Port Vale,12,12,22,41,67,-26,48,19
55,Morecambe,10,11,25,44,74,-30,41,20
55,Acc'ton Stanley,9,14,23,38,74,-36,41,21
55,Cheltenham,10,9,27,34,68,-34,39,22
55,FG Rovers,9,11,26,37,82,-45,38,23
55,Cambridge Utd,9,8,29,35,81,-46,35,24
56,Sheffield Weds,28,13,5,81,34,47,97,1
56,Plymouth Argyle,28,11,7,88,52,36,95,2
56,Ipswich Town,26,13,7,90,41,49,91,3
56,Barnsley,26,11,9,74,39,35,89,4
56,Derby County,25,12,9,77,40,37,87,5
56,Bolton,26,9,11,66,35,31,87,6
56,Portsmouth,23,14,9,71,44,27,83,7
56,Wycombe,25,7,14,66,41,25,82,8
56,P'borough Utd,22,5,19,74,58,16,71,9
56,Lincoln City,14,20,12,50,49,1,62,10
56,Shrewsbury,17,9,20,48,54,-6,60,11
56,Fleetwood Town,14,17,15,50,47,3,59,12
56,Exeter City,16,10,20,62,60,2,58,13
56,Charlton Ath,14,16,16,58,57,1,58,14
56,Oxford United,14,11,21,46,56,-10,53,15
56,Bristol Rovers,13,13,20,57,70,-13,52,16
56,Port Vale,14,10,22,45,71,-26,52,17
56,Acc'ton Stanley,10,15,21,36,66,-30,45,18
56,Burton Albion,12,9,25,53,92,-39,45,19
56,Cheltenham,11,10,25,33,63,-30,43,20
56,MK Dons,11,8,27,47,73,-26,41,21
56,Morecambe,9,12,25,43,74,-31,39,22
56,Cambridge Utd,10,7,29,38,84,-46,37,23
56,FG Rovers,6,14,26,33,86,-53,32,24
57,Sheffield Weds,30,12,4,81,25,56,102,1
57,Plymouth Argyle,29,10,7,95,53,42,97,2
57,Derby County,27,11,8,72,36,36,92,3
57,Barnsley,26,8,12,71,43,28,86,4
57,Wycombe,26,8,12,70,42,28,86,5
57,Bolton,23,12,11,67,37,30,81,6
57,P'borough Utd,24,8,14,79,52,27,80,7
57,Ipswich Town,20,18,8,74,43,31,78,8
57,Portsmouth,20,14,12,68,49,19,74,9
57,Fleetwood Town,16,16,14,49,43,6,64,10
57,Lincoln City,13,22,11,44,45,-1,61,11
57,Shrewsbury,17,9,20,53,53,0,60,12
57,Bristol Rovers,16,9,21,63,81,-18,57,13
57,Charlton Ath,13,14,19,66,69,-3,53,14
57,Exeter City,13,14,19,56,64,-8,53,15
57,Port Vale,14,11,21,48,67,-19,53,16
57,Cheltenham,13,10,23,37,57,-20,49,17
57,Cambridge Utd,13,9,24,43,73,-30,48,18
57,Oxford United,11,14,21,44,57,-13,47,19
57,Burton Albion,10,13,23,51,82,-31,43,20
57,Acc'ton Stanley,9,15,22,43,82,-39,42,21
57,Morecambe,9,14,23,41,75,-34,41,22
57,MK Dons,10,8,28,42,68,-26,38,23
57,FG Rovers,5,11,30,29,90,-61,26,24
58,Sheffield Weds,31,10,5,85,36,49,103,1
58,Plymouth Argyle,28,10,8,95,56,39,94,2
58,Ipswich Town,27,12,7,89,44,45,93,3
58,Derby County,26,11,9,74,37,37,89,4
58,Wycombe,24,9,13,68,44,24,81,5
58,Portsmouth,22,14,10,68,47,21,80,6
58,Bolton,23,10,13,65,39,26,79,7
58,Barnsley,23,10,13,77,52,25,79,8
58,P'borough Utd,23,5,18,75,58,17,74,9
58,Fleetwood Town,17,15,14,57,43,14,66,10
58,Shrewsbury,18,12,16,57,55,2,66,11
58,Charlton Ath,16,13,17,67,67,0,61,12
58,Port Vale,16,10,20,47,60,-13,58,13
58,Exeter City,15,11,20,58,65,-7,56,14
58,Lincoln City,11,22,13,45,51,-6,55,15
58,Bristol Rovers,13,11,22,60,80,-20,50,16
58,Oxford United,12,13,21,47,59,-12,49,17
58,Burton Albion,13,10,23,61,86,-25,49,18
58,Cheltenham,12,11,23,36,66,-30,47,19
58,Morecambe,10,12,24,46,73,-27,42,20
58,Cambridge Utd,11,8,27,39,76,-37,41,21
58,MK Dons,9,10,27,38,74,-36,37,22
58,Acc'ton Stanley,8,13,25,34,76,-42,37,23
58,FG Rovers,7,12,27,38,82,-44,33,24
59,Plymouth Argyle,31,9,6,97,47,50,102,1
59,Sheffield Weds,30,10,6,76,29,47,100,2
59,Ipswich Town,25,16,5,85,44,41,91,3
59,Bolton,25,11,10,75,37,38,86,4
59,Barnsley,26,8,12,69,41,28,86,5
59,Derby County,24,13,9,77,44,33,85,6
59,Wycombe,25,8,13,68,42,26,83,7
59,P'borough Utd,23,9,14,75,50,25,78,8
59,Portsmouth,18,17,11,63,49,14,71,9
59,Shrewsbury,18,10,18,55,55,0,64,10
59,Port Vale,17,10,19,51,63,-12,61,11
59,Fleetwood Town,15,15,16,52,52,0,60,12
59,Bristol Rovers,16,12,18,64,75,-11,60,13
59,Lincoln City,12,22,12,37,44,-7,58,14
59,Charlton Ath,14,15,17,54,54,0,57,15
59,Exeter City,16,9,21,61,63,-2,57,16
59,Oxford United,13,14,19,50,61,-11,53,17
59,Acc'ton Stanley,12,10,24,34,64,-30,46,18
59,Cheltenham,12,8,26,34,69,-35,44,19
59,Burton Albion,9,14,23,45,78,-33,41,20
59,MK Dons,10,9,27,42,71,-29,39,21
59,Morecambe,8,11,27,42,75,-33,35,22
59,Cambridge Utd,8,9,29,31,75,-44,33,23
59,FG Rovers,6,9,31,34,89,-55,27,24
60,Sheffield Weds,30,11,5,83,26,57,101,1
60,Plymouth Argyle,29,10,7,82,48,34,97,2
60,Barnsley,29,6,11,78,41,37,93,3
60,Ipswich Town,24,14,8,81,50,31,86,4
60,Derby County,24,11,11,71,38,33,83,5
60,Bolton,23,12,11,68,35,33,81,6
60,Wycombe,24,8,14,61,39,22,80,7
60,P'borough Utd,24,5,17,80,56,24,77,8
60,Portsmouth,17,18,11,59,50,9,69,9
60,Shrewsbury,20,7,19,58,58,0,67,10
60,Fleetwood Town,16,16,14,53,49,4,64,11
60,Lincoln City,14,17,15,49,49,0,59,12
60,Charlton Ath,14,16,16,57,61,-4,58,13
60,Exeter City,16,10,20,59,64,-5,58,14
60,Port Vale,16,10,20,48,62,-14,58,15
60,Bristol Rovers,14,11,21,62,83,-21,53,16
60,Burton Albion,13,9,24,54,81,-27,48,17
60,Cheltenham,12,9,25,36,67,-31,45,18
60,Morecambe,11,11,24,47,76,-29,44,19
60,Oxford United,11,10,25,43,62,-19,43,20
60,MK Dons,10,11,25,42,68,-26,41,21
60,Cambridge Utd,11,8,27,43,75,-32,41,22
60,Acc'ton Stanley,8,17,21,35,67,-32,41,23
60,FG Rovers,8,11,27,38,82,-44,35,24
61,Sheffield Weds,30,10,6,91,35,56,100,1
61,Plymouth Argyle,26,10,10,81,55,26,88,2
61,Ipswich Town,24,15,7,86,41,45,87,3
61,Derby County,25,11,10,79,42,37,86,4
61,Barnsley,24,11,11,76,49,27,83,5
61,Bolton,23,12,11,63,35,28,81,6
61,P'borough Utd,23,8,15,78,49,29,77,7
61,Wycombe,22,10,14,60,42,18,76,8
61,Charlton Ath,19,12,15,68,61,7,69,9
61,Shrewsbury,19,11,16,59,48,11,68,10
61,Portsmouth,18,14,14,66,58,8,68,11
61,Exeter City,15,14,17,58,54,4,59,12
61,Port Vale,16,10,20,49,67,-18,58,13
61,Lincoln City,11,24,11,42,46,-4,57,14
61,Oxford United,14,13,19,50,56,-6,55,15
61,Bristol Rovers,15,9,22,63,80,-17,54,16
61,Cheltenham,14,12,20,37,55,-18,54,17
61,Fleetwood Town,12,17,17,50,45,5,53,18
61,MK Dons,13,8,25,42,71,-29,47,19
61,Burton Albion,12,10,24,48,89,-41,46,20
61,Acc'ton Stanley,10,12,24,42,79,-37,42,21
61,Cambridge Utd,11,7,28,36,75,-39,40,22
61,Morecambe,8,14,24,39,74,-35,38,23
61,FG Rovers,6,10,30,38,95,-57,28,24
62,Sheffield Weds,30,12,4,82,30,52,102,1
62,Plymouth Argyle,27,9,10,79,50,29,90,2
62,Barnsley,26,9,11,72,43,29,87,3
62,Ipswich Town,24,13,9,76,41,35,85,4
62,Bolton,23,14,9,64,32,32,83,5
62,Derby County,22,13,11,75,41,34,79,6
62,Wycombe,22,9,15,67,46,21,75,7
62,Charlton Ath,19,13,14,73,60,13,70,8
62,Shrewsbury,20,10,16,50,42,8,70,9
62,P'borough Utd,21,6,19,72,58,14,69,10
62,Portsmouth,18,15,13,65,54,11,69,11
62,Bristol Rovers,17,11,18,69,72,-3,62,12
62,Fleetwood Town,13,18,15,45,49,-4,57,13
62,Exeter City,14,14,18,56,58,-2,56,14
62,Lincoln City,12,20,14,45,52,-7,56,15
62,Port Vale,15,11,20,47,61,-14,56,16
62,Oxford United,14,12,20,55,59,-4,54,17
62,Burton Albion,12,13,21,54,80,-26,49,18
62,Morecambe,11,13,22,46,74,-28,46,19
62,Acc'ton Stanley,8,18,20,34,67,-33,42,20
62,Cheltenham,10,12,24,32,67,-35,42,21
62,Cambridge Utd,10,11,25,38,75,-37,41,22
62,MK Dons,9,12,25,39,68,-29,39,23
62,FG Rovers,6,10,30,34,90,-56,28,24
63,Sheffield Weds,29,12,5,84,32,52,99,1
63,Plymouth Argyle,28,11,7,86,45,41,95,2
63,Ipswich Town,26,14,6,87,41,46,92,3
63,Wycombe,27,7,12,70,40,30,88,4
63,Barnsley,26,9,11,79,45,34,87,5
63,Bolton,26,9,11,68,35,33,87,6
63,Derby County,22,11,13,71,47,24,77,7
63,P'borough Utd,24,5,17,82,60,22,77,8
63,Portsmouth,18,16,12,67,52,15,70,9
63,Lincoln City,16,20,10,48,44,4,68,10
63,Fleetwood Town,16,15,15,46,41,5,63,11
63,Shrewsbury,18,9,19,55,53,2,63,12
63,Charlton Ath,15,14,17,64,63,1,59,13
63,Bristol Rovers,15,9,22,62,82,-20,54,14
63,Port Vale,14,10,22,43,62,-19,52,15
63,Burton Albion,13,11,22,62,90,-28,50,16
63,Cheltenham,13,9,24,33,58,-25,48,17
63,Oxford United,12,11,23,48,65,-17,47,18
63,Exeter City,11,12,23,49,66,-17,45,19
63,Cambridge Utd,12,8,26,38,72,-34,44,20
63,MK Dons,11,10,25,46,71,-25,43,21
63,Acc'ton Stanley,9,16,21,39,73,-34,43,22
63,FG Rovers,8,12,26,35,81,-46,36,23
63,Morecambe,7,12,27,39,83,-44,33,24
64,Sheffield Weds,32,9,5,85,30,55,105,1
64,Barnsley,28,8,10,70,35,35,92,2
64,Ipswich Town,25,14,7,84,43,41,89,3
64,Wycombe,26,9,11,73,38,35,87,4
64,Plymouth Argyle,26,9,11,79,55,24,87,5
64,Bolton,23,11,12,66,38,28,80,6
64,Derby County,22,14,10,72,45,27,80,7
64,P'borough Utd,24,5,17,81,55,26,77,8
64,Shrewsbury,20,8,18,55,50,5,68,9
64,Portsmouth,18,13,15,61,54,7,67,10
64,Fleetwood Town,15,18,13,50,39,11,63,11
64,Charlton Ath,16,15,15,66,59,7,63,12
64,Port Vale,17,11,18,52,62,-10,62,13
64,Exeter City,15,12,19,54,58,-4,57,14
64,Lincoln City,12,21,13,41,52,-11,57,15
64,Bristol Rovers,16,9,21,65,78,-13,57,16
64,Acc'ton Stanley,12,13,21,42,69,-27,49,17
64,Burton Albion,13,9,24,56,84,-28,48,18
64,Morecambe,11,14,21,49,73,-24,47,19
64,Oxford United,11,11,24,44,64,-20,44,20
64,Cheltenham,11,9,26,33,66,-33,42,21
64,MK Dons,9,10,27,41,72,-31,37,22
64,Cambridge Utd,8,8,30,38,82,-44,32,23
64,FG Rovers,7,10,29,31,87,-56,31,24
65,Sheffield Weds,29,10,7,80,33,47,97,1
65,Plymouth Argyle,28,12,6,91,48,43,96,2
65,Barnsley,26,9,11,66,38,28,87,3
65,Derby County,24,12,10,76,38,38,84,4
65,Ipswich Town,23,15,8,80,46,34,84,5
65,Wycombe,24,10,12,64,37,27,82,6
65,Bolton,23,10,13,64,38,26,79,7
65,P'borough Utd,24,4,18,73,52,21,76,8
65,Portsmouth,19,15,12,62,49,13,72,9
65,Shrewsbury,20,8,18,56,50,6,68,10
65,Bristol Rovers,18,9,19,65,77,-12,63,11
65,Lincoln City,13,21,12,42,41,1,60,12
65,Fleetwood Town,14,17,15,48,49,-1,59,13
65,Charlton Ath,15,13,18,64,62,2,58,14
65,Exeter City,14,15,17,56,56,0,57,15
65,Port Vale,16,9,21,45,64,-19,57,16
65,MK Dons,14,8,24,46,63,-17,50,17
65,Oxford United,12,13,21,47,56,-9,49,18
65,Burton Albion,12,12,22,54,86,-32,48,19
65,Morecambe,12,11,23,50,76,-26,47,20
65,Cheltenham,11,10,25,32,64,-32,43,21
65,Cambridge Utd,9,9,28,36,75,-39,36,22
65,Acc'ton Stanley,7,13,26,35,78,-43,34,23
65,FG Rovers,8,9,29,39,95,-56,33,24
66,Sheffield Weds,28,13,5,82,30,52,97,1
66,Ipswich Town,25,15,6,83,40,43,90,2
66,Barnsley,27,9,10,74,35,39,90,3
66,Plymouth Argyle,27,9,10,89,55,34,90,4
66,Derby County,25,12,9,71,38,33,87,5
66,Wycombe,26,6,14,73,47,26,84,6
66,Bolton,23,12,11,72,39,33,81,7
66,Portsmouth,19,16,11,65,46,19,73,8
66,P'borough Utd,21,8,17,70,55,15,71,9
66,Lincoln City,14,23,9,43,39,4,65,10
66,Shrewsbury,17,12,17,49,50,-1,63,11
66,Fleetwood Town,15,16,15,47,47,0,61,12
66,Charlton Ath,14,17,15,63,57,6,59,13
66,Exeter City,15,14,17,57,61,-4,59,14
66,Oxford United,14,11,21,49,55,-6,53,15
66,Port Vale,14,9,23,43,73,-30,51,16
66,Burton Albion,12,12,22,59,85,-26,48,17
66,Bristol Rovers,13,9,24,61,88,-27,48,18
66,Cambridge Utd,11,11,24,39,70,-31,44,19
66,Acc'ton Stanley,9,16,21,38,69,-31,43,20
66,MK Dons,11,8,27,47,76,-29,41,21
66,Morecambe,8,16,22,44,72,-28,40,22
66,Cheltenham,10,10,26,32,65,-33,40,23
66,FG Rovers,7,10,29,34,92,-58,31,24
67,Plymouth Argyle,31,10,5,94,44,50,103,1
67,Sheffield Weds,29,12,5,85,31,54,99,2
67,Ipswich Town,24,16,6,86,42,44,88,3
67,Derby County,25,11,10,75,38,37,86,4
67,Barnsley,26,8,12,69,40,29,86,5
67,Wycombe,23,10,13,67,42,25,79,6
67,Bolton,21,14,11,67,40,27,77,7
67,P'borough Utd,21,6,19,79,62,17,69,8
67,Shrewsbury,20,8,18,56,49,7,68,9
67,Portsmouth,17,16,13,57,49,8,67,10
67,Lincoln City,13,22,11,48,42,6,61,11
67,Fleetwood Town,15,15,16,49,47,2,60,12
67,Charlton Ath,14,15,17,62,64,-2,57,13
67,Oxford United,15,12,19,51,59,-8,57,14
67,Bristol Rovers,15,11,20,62,75,-13,56,15
67,Cheltenham,13,11,22,36,62,-26,50,16
67,Exeter City,13,10,23,51,64,-13,49,17
67,Burton Albion,12,12,22,58,91,-33,48,18
67,Port Vale,12,11,23,49,75,-26,47,19
67,Morecambe,11,13,22,43,71,-28,46,20
67,Acc'ton Stanley,11,13,22,36,73,-37,46,21
67,MK Dons,12,9,25,40,66,-26,45,22
67,Cambridge Utd,9,9,28,39,85,-46,36,23
67,FG Rovers,7,12,27,31,79,-48,33,24
68,Sheffield Weds,28,14,4,78,33,45,98,1
68,Plymouth Argyle,28,10,8,81,51,30,94,2
68,Derby County,26,10,10,81,36,45,88,3
68,Ipswich Town,25,13,8,80,39,41,88,4
68,Barnsley,25,8,13,77,44,33,83,5
68,Bolton,23,12,11,60,34,26,81,6
68,P'borough Utd,25,4,17,71,51,20,79,7
68,Wycombe,21,11,14,62,44,18,74,8
68,Portsmouth,19,14,13,63,56,7,71,9
68,Shrewsbury,18,9,19,52,51,1,63,10
68,Fleetwood Town,15,17,14,51,44,7,62,11
68,Exeter City,16,14,16,61,57,4,62,12
68,Lincoln City,13,23,10,49,46,3,62,13
68,Charlton Ath,16,13,17,64,62,2,61,14
68,Bristol Rovers,16,12,18,64,73,-9,60,15
68,Port Vale,14,9,23,46,67,-21,51,16
68,Burton Albion,13,9,24,56,80,-24,48,17
68,Acc'ton Stanley,11,14,21,45,69,-24,47,18
68,Cheltenham,11,12,23,40,68,-28,45,19
68,Oxford United,10,13,23,42,62,-20,43,20
68,Morecambe,10,13,23,47,77,-30,43,21
68,MK Dons,11,9,26,43,75,-32,42,22
68,Cambridge Utd,10,6,30,34,80,-46,36,23
68,FG Rovers,8,11,27,39,87,-48,35,24
69,Sheffield Weds,33,10,3,97,29,68,109,1
69,Plymouth Argyle,30,11,5,94,49,45,101,2
69,Ipswich Town,24,17,5,89,42,47,89,3
69,Wycombe,26,8,12,65,38,27,86,4
69,Derby County,24,13,9,78,46,32,85,5
69,Barnsley,23,13,10,70,46,24,82,6
69,Bolton,23,12,11,70,38,32,81,7
69,P'borough Utd,21,8,17,75,57,18,71,8
69,Charlton Ath,18,15,13,68,56,12,69,9
69,Portsmouth,16,17,13,60,50,10,65,10
69,Shrewsbury,17,11,18,51,54,-3,62,11
69,Fleetwood Town,14,15,17,46,47,-1,57,12
69,Exeter City,14,13,19,57,66,-9,55,13
69,Lincoln City,9,24,13,39,50,-11,51,14
69,Oxford United,12,15,19,46,58,-12,51,15
69,Port Vale,13,11,22,42,63,-21,50,16
69,Burton Albion,12,12,22,55,90,-35,48,17
69,Bristol Rovers,12,11,23,60,85,-25,47,18
69,MK Dons,11,12,23,45,65,-20,45,19
69,Cheltenham,11,10,25,34,66,-32,43,20
69,Morecambe,8,17,21,49,76,-27,41,21
69,Acc'ton Stanley,9,14,23,34,69,-35,41,22
69,FG Rovers,9,10,27,37,76,-39,37,23
69,Cambridge Utd,9,9,28,32,77,-45,36,24
70,Plymouth Argyle,30,9,7,91,53,38,99,1
70,Sheffield Weds,27,11,8,87,39,48,92,2
70,Derby County,25,12,9,83,44,39,87,3
70,Barnsley,26,8,12,83,45,38,86,4
70,Ipswich Town,22,18,6,81,45,36,84,5
70,Bolton,24,11,11,65,35,30,83,6
70,Wycombe,23,6,17,62,47,15,75,7
70,Shrewsbury,21,9,16,57,48,9,72,8
70,Portsmouth,18,15,13,66,56,10,69,9
70,Fleetwood Town,17,16,13,52,41,11,67,10
70,P'borough Utd,20,7,19,70,64,6,67,11
70,Exeter City,18,12,16,61,57,4,66,12
70,Charlton Ath,15,13,18,66,66,0,58,13
70,Lincoln City,11,25,10,40,51,-11,58,14
70,Bristol Rovers,15,12,19,60,73,-13,57,15
70,Port Vale,14,8,24,51,73,-22,50,16
70,Acc'ton Stanley,12,13,21,40,71,-31,49,17
70,Oxford United,12,12,22,48,65,-17,48,18
70,Cheltenham,12,12,22,33,53,-20,48,19
70,Burton Albion,10,15,21,55,83,-28,45,20
70,Morecambe,11,11,24,49,72,-23,44,21
70,MK Dons,11,9,26,43,70,-27,42,22
70,Cambridge Utd,9,8,29,34,76,-42,35,23
70,FG Rovers,7,12,27,35,85,-50,33,24
71,Sheffield Weds,28,13,5,75,29,46,97,1
71,Plymouth Argyle,28,11,7,89,52,37,95,2
71,Bolton,25,11,10,72,35,37,86,3
71,P'borough Utd,26,7,13,86,57,29,85,4
71,Wycombe,24,10,12,69,39,30,82,5
71,Barnsley,24,9,13,74,48,26,81,6
71,Portsmouth,22,14,10,67,50,17,80,7
71,Derby County,22,13,11,73,46,27,79,8
71,Ipswich Town,20,18,8,78,48,30,78,9
71,Shrewsbury,18,10,18,62,51,11,64,10
71,Fleetwood Town,16,16,14,51,45,6,64,11
71,Exeter City,15,14,17,65,64,1,59,12
71,Charlton Ath,14,16,16,61,56,5,58,13
71,Port Vale,16,9,21,43,60,-17,57,14
71,Lincoln City,11,22,13,46,50,-4,55,15
71,Burton Albion,14,9,23,57,85,-28,51,16
71,Oxford United,12,13,21,47,55,-8,49,17
71,Cheltenham,13,10,23,39,64,-25,49,18
71,Bristol Rovers,12,10,24,58,86,-28,46,19
71,Cambridge Utd,11,11,24,40,73,-33,44,20
71,Morecambe,10,13,23,42,76,-34,43,21
71,Acc'ton Stanley,9,14,23,36,69,-33,41,22
71,MK Dons,9,9,28,40,77,-37,36,23
71,FG Rovers,6,12,28,34,89,-55,30,24
72,Sheffield Weds,30,11,5,84,37,47,101,1
72,Plymouth Argyle,30,10,6,88,47,41,100,2
72,Bolton,26,9,11,72,41,31,87,3
72,P'borough Utd,26,6,14,76,53,23,84,4
72,Ipswich Town,22,16,8,84,45,39,82,5
72,Derby County,23,12,11,73,47,26,81,6
72,Barnsley,23,11,12,74,40,34,80,7
72,Wycombe,23,7,16,59,47,12,76,8
72,Shrewsbury,20,11,15,59,44,15,71,9
72,Portsmouth,19,13,14,64,58,6,70,10
72,Charlton Ath,17,14,15,68,58,10,65,11
72,Fleetwood Town,16,15,15,50,44,6,63,12
72,Exeter City,17,12,17,59,55,4,63,13
72,Lincoln City,11,20,15,39,48,-9,53,14
72,Bristol Rovers,14,11,21,66,85,-19,53,15
72,Port Vale,14,10,22,47,66,-19,52,16
72,Oxford United,12,12,22,47,60,-13,48,17
72,MK Dons,13,8,25,42,64,-22,47,18
72,Cheltenham,12,11,23,35,59,-24,47,19
72,Morecambe,11,13,22,46,77,-31,46,20
72,Acc'ton Stanley,11,12,23,48,76,-28,45,21
72,Burton Albion,10,12,24,52,85,-33,42,22
72,Cambridge Utd,9,8,29,37,78,-41,35,23
72,FG Rovers,6,10,30,32,87,-55,28,24
73,Sheffield Weds,30,10,6,85,35,50,100,1
73,Ipswich Town,27,13,6,96,44,52,94,2
73,Plymouth Argyle,25,15,6,82,52,30,90,3
73,Bolton,25,9,12,74,42,32,84,4
73,Barnsley,25,8,13,72,44,28,83,5
73,Derby County,23,11,12,72,43,29,80,6
73,Wycombe,22,10,14,66,48,18,76,7
73,Portsmouth,20,16,10,68,51,17,76,8
73,P'borough Utd,22,9,15,78,55,23,75,9
73,Charlton Ath,17,13,16,64,59,5,64,10
73,Shrewsbury,17,12,17,50,53,-3,63,11
73,Exeter City,17,10,19,66,60,6,61,12
73,Fleetwood Town,14,18,14,53,52,1,60,13
73,Oxford United,16,11,19,55,57,-2,59,14
73,Lincoln City,12,22,12,43,49,-6,58,15
73,Bristol Rovers,14,13,19,62,74,-12,55,16
73,Port Vale,13,9,24,49,75,-26,48,17
73,Cambridge Utd,13,9,24,39,74,-35,48,18
73,Cheltenham,12,10,24,35,60,-25,46,19
73,MK Dons,12,9,25,47,70,-23,45,20
73,Burton Albion,11,11,24,59,90,-31,44,21
73,Morecambe,10,13,23,50,76,-26,43,22
73,Acc'ton Stanley,9,12,25,40,79,-39,39,23
73,FG Rovers,5,9,32,32,95,-63,24,24
74,Plymouth Argyle,31,9,6,88,48,40,102,1
74,Sheffield Weds,30,10,6,87,33,54,100,2
74,Derby County,27,11,8,82,44,38,92,3
74,Barnsley,25,10,11,69,42,27,85,4
74,Ipswich Town,22,18,6,80,43,37,84,5
74,Bolton,23,11,12,71,38,33,80,6
74,Wycombe,23,8,15,64,42,22,77,7
74,Portsmouth,18,17,11,67,55,12,71,8
74,P'borough Utd,20,8,18,70,58,12,68,9
74,Shrewsbury,19,11,16,54,47,7,68,10
74,Charlton Ath,15,14,17,60,62,-2,59,11
74,Fleetwood Town,14,15,17,51,52,-1,57,12
74,Bristol Rovers,14,14,18,68,77,-9,56,13
74,Lincoln City,10,24,12,39,42,-3,54,14
74,Exeter City,14,12,20,59,72,-13,54,15
74,MK Dons,15,8,23,49,63,-14,53,16
74,Oxford United,13,13,20,50,57,-7,52,17
74,Burton Albion,13,11,22,57,78,-21,50,18
74,Port Vale,12,12,22,45,73,-28,48,19
74,Cheltenham,11,12,23,31,58,-27,45,20
74,Acc'ton Stanley,10,13,23,43,76,-33,43,21
74,Cambridge Utd,12,7,27,35,70,-35,43,22
74,Morecambe,9,14,23,44,78,-34,41,23
74,FG Rovers,6,10,30,30,85,-55,28,24
75,Sheffield Weds,30,12,4,80,28,52,102,1
75,Plymouth Argyle,29,10,7,83,47,36,97,2
75,Ipswich Town,24,15,7,82,46,36,87,3
75,Bolton,24,10,12,69,38,31,82,4
75,Barnsley,24,9,13,64,43,21,81,5
75,Wycombe,23,10,13,64,42,22,79,6
75,Portsmouth,21,14,11,71,51,20,77,7
75,P'borough Utd,22,9,15,77,57,20,75,8
75,Derby County,21,9,16,67,47,20,72,9
75,Charlton Ath,18,14,14,67,60,7,68,10
75,Fleetwood Town,17,14,15,55,47,8,65,11
75,Shrewsbury,19,7,20,55,57,-2,64,12
75,Exeter City,16,12,18,56,57,-1,60,13
75,Port Vale,16,11,19,52,64,-12,59,14
75,Lincoln City,10,25,11,39,42,-3,55,15
75,Oxford United,14,13,19,48,52,-4,55,16
75,Bristol Rovers,14,10,22,65,83,-18,52,17
75,Burton Albion,12,11,23,61,87,-26,47,18
75,Cambridge Utd,13,8,25,41,71,-30,47,19
75,Morecambe,11,12,23,47,76,-29,45,20
75,Cheltenham,11,11,24,35,66,-31,44,21
75,Acc'ton Stanley,9,13,24,40,71,-31,40,22
75,MK Dons,9,10,27,44,73,-29,37,23
75,FG Rovers,6,9,31,33,90,-57,27,24
76,Plymouth Argyle,30,10,6,96,47,49,100,1
76,Sheffield Weds,29,11,6,82,31,51,98,2
76,Barnsley,28,7,11,75,40,35,91,3
76,Ipswich Town,25,14,7,90,49,41,89,4
76,Derby County,24,13,9,75,43,32,85,5
76,Wycombe,24,9,13,66,41,25,81,6
76,Bolton,21,12,13,66,47,19,75,7
76,P'borough Utd,23,6,17,74,62,12,75,8
76,Charlton Ath,19,12,15,69,56,13,69,9
76,Shrewsbury,19,12,15,58,50,8,69,10
76,Fleetwood Town,17,15,14,53,42,11,66,11
76,Portsmouth,15,20,11,64,59,5,65,12
76,Lincoln City,12,20,14,39,49,-10,56,13
76,Port Vale,15,11,20,48,71,-23,56,14
76,Exeter City,15,10,21,58,64,-6,55,15
76,Oxford United,13,13,20,46,55,-9,52,16
76,Acc'ton Stanley,13,13,20,44,62,-18,52,17
76,Bristol Rovers,13,10,23,62,86,-24,49,18
76,Burton Albion,12,10,24,55,82,-27,46,19
76,Cheltenham,11,12,23,34,59,-25,45,20
76,MK Dons,11,9,26,40,72,-32,42,21
76,Morecambe,9,13,24,44,73,-29,40,22
76,Cambridge Utd,9,8,29,36,78,-42,35,23
76,FG Rovers,5,10,31,34,90,-56,25,24
77,Sheffield Weds,33,10,3,95,34,61,109,1
77,Plymouth Argyle,28,11,7,90,55,35,95,2
77,Barnsley,26,9,11,77,43,34,87,3
77,Ipswich Town,22,17,7,82,44,38,83,4
77,Derby County,24,11,11,73,43,30,83,5
77,Wycombe,25,8,13,64,40,24,83,6
77,Bolton,23,11,12,70,35,35,80,7
77,P'borough Utd,25,5,16,82,55,27,80,8
77,Portsmouth,20,15,11,66,50,16,75,9
77,Charlton Ath,19,13,14,66,54,12,70,10
77,Fleetwood Town,15,15,16,49,48,1,60,11
77,Shrewsbury,17,9,20,52,57,-5,60,12
77,Lincoln City,12,22,12,43,48,-5,58,13
77,Port Vale,15,9,22,53,66,-13,54,14
77,Exeter City,13,12,21,58,69,-11,51,15
77,Bristol Rovers,13,11,22,66,82,-16,50,16
77,Acc'ton Stanley,12,13,21,39,74,-35,49,17
77,Cheltenham,12,10,24,37,66,-29,46,18
77,Oxford United,11,11,24,52,69,-17,44,19
77,MK Dons,12,8,26,46,73,-27,44,20
77,Burton Albion,10,14,22,57,92,-35,44,21
77,Morecambe,9,15,22,46,75,-29,42,22
77,Cambridge Utd,11,8,27,36,69,-33,41,23
77,FG Rovers,7,9,30,34,92,-58,30,24
78,Sheffield Weds,29,11,6,85,34,51,98,1
78,Plymouth Argyle,28,11,7,89,45,44,95,2
78,Barnsley,26,11,9,78,40,38,89,3
78,Derby County,24,13,9,77,41,36,85,4
78,Ipswich Town,22,17,7,79,43,36,83,5
78,Wycombe,23,10,13,56,41,15,79,6
78,Bolton,22,10,14,59,39,20,76,7
78,Portsmouth,18,16,12,67,50,17,70,8
78,Shrewsbury,20,10,16,52,48,4,70,9
78,P'borough Utd,21,6,19,78,57,21,69,10
78,Charlton Ath,17,15,14,67,56,11,66,11
78,Lincoln City,12,26,8,40,39,1,62,12
78,Exeter City,17,10,19,62,57,5,61,13
78,Port Vale,16,11,19,50,64,-14,59,14
78,Bristol Rovers,15,11,20,63,77,-14,56,15
78,Fleetwood Town,12,18,16,44,45,-1,54,16
78,Burton Albion,13,10,23,56,91,-35,49,17
78,Oxford United,12,12,22,47,61,-14,48,18
78,Cambridge Utd,13,8,25,40,70,-30,47,19
78,Cheltenham,11,9,26,31,65,-34,42,20
78,MK Dons,10,10,26,44,72,-28,40,21
78,Morecambe,8,14,24,37,70,-33,38,22
78,FG Rovers,9,10,27,37,89,-52,37,23
78,Acc'ton Stanley,7,15,24,36,80,-44,36,24
79,Plymouth Argyle,28,12,6,83,44,39,96,1
79,Sheffield Weds,28,11,7,78,31,47,95,2
79,Ipswich Town,25,14,7,93,48,45,89,3
79,Barnsley,27,8,11,67,35,32,89,4
79,Bolton,26,9,11,74,39,35,87,5
79,Derby County,23,14,9,74,39,35,83,6
79,Wycombe,24,6,16,71,45,26,78,7
79,Shrewsbury,21,9,16,55,46,9,72,8
79,P'borough Utd,22,5,19,82,62,20,71,9
79,Portsmouth,18,14,14,59,52,7,68,10
79,Charlton Ath,18,13,15,69,60,9,67,11
79,Port Vale,18,9,19,57,66,-9,63,12
79,Lincoln City,13,22,11,49,51,-2,61,13
79,Fleetwood Town,13,19,14,49,47,2,58,14
79,Bristol Rovers,16,10,20,65,73,-8,58,15
79,Exeter City,15,11,20,59,68,-9,56,16
79,Burton Albion,13,10,23,67,94,-27,49,17
79,Oxford United,12,11,23,50,66,-16,47,18
79,Morecambe,11,12,23,45,73,-28,45,19
79,Cheltenham,11,9,26,32,60,-28,42,20
79,MK Dons,11,8,27,41,73,-32,41,21
79,Acc'ton Stanley,9,12,25,36,81,-45,39,22
79,Cambridge Utd,10,6,30,36,85,-49,36,23
79,FG Rovers,9,8,29,34,87,-53,35,24
80,Sheffield Weds,29,13,4,77,29,48,100,1
80,Plymouth Argyle,28,12,6,84,47,37,96,2
80,Ipswich Town,25,16,5,83,41,42,91,3
80,Derby County,25,11,10,81,39,42,86,4
80,Bolton,21,15,10,61,36,25,78,5
80,Barnsley,22,10,14,61,42,19,76,6
80,P'borough Utd,23,5,18,75,55,20,74,7
80,Wycombe,22,8,16,57,43,14,74,8
80,Portsmouth,18,18,10,63,45,18,72,9
80,Fleetwood Town,17,17,12,53,40,13,68,10
80,Shrewsbury,18,11,17,56,52,4,65,11
80,Charlton Ath,16,12,18,60,63,-3,60,12
80,Bristol Rovers,16,9,21,60,79,-19,57,13
80,Lincoln City,10,25,11,41,43,-2,55,14
80,Exeter City,14,13,19,56,60,-4,55,15
80,Port Vale,14,11,21,47,67,-20,53,16
80,Oxford United,12,15,19,56,62,-6,51,17
80,Burton Albion,13,11,22,57,81,-24,50,18
80,MK Dons,12,10,24,47,70,-23,46,19
80,Cheltenham,12,10,24,37,65,-28,46,20
80,Cambridge Utd,12,10,24,44,73,-29,46,21
80,Acc'ton Stanley,9,13,24,39,73,-34,40,22
80,Morecambe,8,12,26,43,81,-38,36,23
80,FG Rovers,7,11,28,36,88,-52,32,24
81,Sheffield Weds,33,8,5,87,28,59,107,1
81,Plymouth Argyle,29,8,9,88,53,35,95,2
81,Derby County,26,11,9,77,40,37,89,3
81,Barnsley,26,10,10,73,34,39,88,4
81,Ipswich Town,24,14,8,87,47,40,86,5
81,Bolton,23,12,11,67,34,33,81,6
81,Portsmouth,21,15,10,74,53,21,78,7
81,Wycombe,23,9,14,67,50,17,78,8
81,Shrewsbury,20,11,15,54,54,0,71,9
81,P'borough Utd,21,6,19,76,64,12,69,10
81,Fleetwood Town,16,14,16,56,46,10,62,11
81,Charlton Ath,16,14,16,65,60,5,62,12
81,Exeter City,16,10,20,57,61,-4,58,13
81,Cheltenham,17,7,22,40,55,-15,58,14
81,Lincoln City,12,19,15,40,46,-6,55,15
81,Morecambe,11,17,18,53,69,-16,50,16
81,Port Vale,13,10,23,42,68,-26,49,17
81,Bristol Rovers,13,10,23,58,85,-27,49,18
81,Oxford United,11,13,22,48,64,-16,46,19
81,Burton Albion,12,10,24,56,85,-29,46,20
81,Acc'ton Stanley,10,11,25,32,71,-39,41,21
81,Cambridge Utd,11,7,28,38,81,-43,40,22
81,MK Dons,10,8,28,38,69,-31,38,23
81,FG Rovers,6,10,30,31,87,-56,28,24
82,Sheffield Weds,31,11,4,85,28,57,104,1
82,Plymouth Argyle,28,11,7,86,49,37,95,2
82,Bolton,24,12,10,73,36,37,84,3
82,Derby County,24,11,11,77,45,32,83,4
82,Wycombe,24,7,15,70,41,29,79,5
82,Ipswich Town,21,15,10,83,47,36,78,6
82,Barnsley,23,8,15,70,48,22,77,7
82,P'borough Utd,22,7,17,71,58,13,73,8
82,Shrewsbury,20,10,16,53,47,6,70,9
82,Fleetwood Town,17,16,13,54,47,7,67,10
82,Charlton Ath,17,14,15,65,56,9,65,11
82,Portsmouth,15,17,14,59,56,3,62,12
82,Bristol Rovers,16,11,19,61,74,-13,59,13
82,Exeter City,15,13,18,59,65,-6,58,14
82,Port Vale,15,12,19,52,65,-13,57,15
82,Lincoln City,11,20,15,43,55,-12,53,16
82,Cheltenham,14,9,23,41,61,-20,51,17
82,Burton Albion,13,11,22,61,92,-31,50,18
82,Oxford United,12,13,21,48,55,-7,49,19
82,Acc'ton Stanley,11,14,21,34,68,-34,47,20
82,MK Dons,12,8,26,42,66,-24,44,21
82,Morecambe,9,15,22,40,74,-34,42,22
82,Cambridge Utd,10,8,28,32,71,-39,38,23
82,FG Rovers,6,11,29,30,85,-55,29,24
83,Sheffield Weds,29,11,6,80,31,49,98,1
83,Barnsley,29,6,11,79,42,37,93,2
83,Ipswich Town,24,17,5,87,39,48,89,3
83,Plymouth Argyle,26,11,9,83,53,30,89,4
83,Bolton,23,11,12,64,37,27,80,5
83,Derby County,22,11,13,71,45,26,77,6
83,P'borough Utd,23,5,18,75,60,15,74,7
83,Wycombe,22,8,16,60,45,15,74,8
83,Shrewsbury,21,7,18,62,55,7,70,9
83,Portsmouth,16,18,12,59,53,6,66,10
83,Exeter City,17,11,18,65,65,0,62,11
83,Bristol Rovers,17,10,19,67,76,-9,61,12
83,Lincoln City,13,20,13,45,47,-2,59,13
83,Oxford United,14,15,17,50,50,0,57,14
83,Fleetwood Town,14,14,18,47,55,-8,56,15
83,Charlton Ath,13,15,18,59,65,-6,54,16
83,Port Vale,13,11,22,52,74,-22,50,17
83,Morecambe,12,14,20,44,68,-24,50,18
83,Burton Albion,13,11,22,55,83,-28,50,19
83,Cambridge Utd,13,7,26,40,68,-28,46,20
83,Cheltenham,12,9,25,39,62,-23,45,21
83,Acc'ton Stanley,10,15,21,36,67,-31,45,22
83,MK Dons,12,8,26,42,67,-25,44,23
83,FG Rovers,6,11,29,32,86,-54,29,24
84,Sheffield Weds,30,10,6,86,31,55,100,1
84,Plymouth Argyle,28,13,5,92,47,45,97,2
84,Ipswich Town,25,16,5,84,41,43,91,3
84,Barnsley,25,12,9,76,44,32,87,4
84,Bolton,25,10,11,68,34,34,85,5
84,Derby County,22,12,12,70,51,19,78,6
84,P'borough Utd,23,7,16,77,53,24,76,7
84,Wycombe,21,10,15,60,44,16,73,8
84,Fleetwood Town,18,15,13,57,45,12,69,9
84,Portsmouth,17,16,13,61,53,8,67,10
84,Shrewsbury,18,8,20,53,58,-5,62,11
84,Lincoln City,13,21,12,43,49,-6,60,12
84,Charlton Ath,15,14,17,67,62,5,59,13
84,Exeter City,15,13,18,56,61,-5,58,14
84,Port Vale,15,9,22,42,60,-18,54,15
84,Oxford United,13,13,20,48,58,-10,52,16
84,Bristol Rovers,13,11,22,64,82,-18,50,17
84,Cheltenham,13,11,22,36,57,-21,50,18
84,Morecambe,12,12,22,47,72,-25,48,19
84,Cambridge Utd,13,7,26,37,69,-32,46,20
84,Acc'ton Stanley,9,17,20,37,65,-28,44,21
84,Burton Albion,11,9,26,54,99,-45,42,22
84,MK Dons,11,8,27,40,68,-28,41,23
84,FG Rovers,5,10,31,32,84,-52,25,24
85,Sheffield Weds,32,9,5,90,33,57,105,1
85,Plymouth Argyle,30,10,6,91,46,45,100,2
85,Derby County,25,13,8,83,38,45,88,3
85,Barnsley,25,9,12,73,44,29,84,4
85,Ipswich Town,22,16,8,81,47,34,82,5
85,Bolton,24,10,12,67,42,25,82,6
85,Wycombe,24,9,13,75,49,26,81,7
85,P'borough Utd,24,6,16,79,55,24,78,8
85,Portsmouth,20,14,12,71,52,19,74,9
85,Shrewsbury,20,8,18,54,54,0,68,10
85,Charlton Ath,16,12,18,67,63,4,60,11
85,Lincoln City,13,21,12,40,44,-4,60,12
85,Fleetwood Town,14,15,17,45,45,0,57,13
85,Exeter City,14,13,19,54,62,-8,55,14
85,Port Vale,15,8,23,48,70,-22,53,15
85,Burton Albion,14,11,21,61,86,-25,53,16
85,Morecambe,13,12,21,48,69,-21,51,17
85,Bristol Rovers,13,11,22,67,92,-25,50,18
85,MK Dons,13,6,27,41,73,-32,45,19
85,Oxford United,11,11,24,47,66,-19,44,20
85,Acc'ton Stanley,10,13,23,41,72,-31,43,21
85,Cheltenham,11,9,26,34,63,-29,42,22
85,Cambridge Utd,11,7,28,33,73,-40,40,23
85,FG Rovers,6,11,29,34,86,-52,29,24
86,Sheffield Weds,30,11,5,78,30,48,101,1
86,Barnsley,30,8,8,94,43,51,98,2
86,Plymouth Argyle,28,11,7,84,56,28,95,3
86,Ipswich Town,25,15,6,84,46,38,90,4
86,Derby County,24,11,11,71,40,31,83,5
86,Bolton,23,14,9,68,39,29,83,6
86,Portsmouth,20,15,11,66,46,20,75,7
86,Wycombe,20,12,14,62,44,18,72,8
86,P'borough Utd,22,6,18,75,61,14,72,9
86,Charlton Ath,18,14,14,75,57,18,68,10
86,Fleetwood Town,16,16,14,52,47,5,64,11
86,Shrewsbury,16,10,20,54,55,-1,58,12
86,Lincoln City,11,22,13,41,48,-7,55,13
86,Exeter City,15,10,21,56,67,-11,55,14
86,Port Vale,15,10,21,46,63,-17,55,15
86,Burton Albion,13,10,23,58,85,-27,49,16
86,Oxford United,11,14,21,44,60,-16,47,17
86,Bristol Rovers,12,10,24,60,82,-22,46,18
86,MK Dons,11,11,24,39,65,-26,44,19
86,Acc'ton Stanley,9,17,20,36,64,-28,44,20
86,Cambridge Utd,11,11,24,37,68,-31,44,21
86,Morecambe,10,13,23,40,70,-30,43,22
86,Cheltenham,10,12,24,30,57,-27,42,23
86,FG Rovers,6,9,31,33,90,-57,27,24
87,Sheffield Weds,31,9,6,80,30,50,102,1
87,Plymouth Argyle,28,10,8,86,49,37,94,2
87,Ipswich Town,25,14,7,86,45,41,89,3
87,Bolton,26,11,9,72,33,39,89,4
87,Barnsley,25,9,12,69,41,28,84,5
87,Derby County,22,12,12,73,46,27,78,6
87,Portsmouth,18,17,11,66,51,15,71,7
87,P'borough Utd,21,8,17,76,65,11,71,8
87,Wycombe,19,11,16,57,45,12,68,9
87,Shrewsbury,18,11,17,57,51,6,65,10
87,Bristol Rovers,17,10,19,68,75,-7,61,11
87,Lincoln City,14,17,15,43,50,-7,59,12
87,Charlton Ath,14,16,16,60,58,2,58,13
87,Burton Albion,16,10,20,64,80,-16,58,14
87,Fleetwood Town,13,18,15,42,41,1,57,15
87,Exeter City,13,16,17,59,62,-3,55,16
87,Oxford United,13,14,19,48,53,-5,53,17
87,Port Vale,14,8,24,44,72,-28,50,18
87,Morecambe,12,13,21,47,73,-26,49,19
87,MK Dons,13,8,25,48,69,-21,47,20
87,Acc'ton Stanley,10,14,22,37,68,-31,44,21
87,Cheltenham,11,10,25,30,63,-33,43,22
87,Cambridge Utd,11,7,28,32,73,-41,40,23
87,FG Rovers,5,13,28,34,85,-51,28,24
88,Plymouth Argyle,32,8,6,100,45,55,104,1
88,Sheffield Weds,31,11,4,87,32,55,104,2
88,Ipswich Town,27,12,7,95,42,53,93,3
88,Barnsley,26,10,10,71,38,33,88,4
88,Bolton,25,10,11,66,34,32,85,5
88,Wycombe,26,7,13,67,41,26,85,6
88,Derby County,23,11,12,71,44,27,80,7
88,P'borough Utd,21,6,19,72,62,10,69,8
88,Portsmouth,17,16,13,63,52,11,67,9
88,Fleetwood Town,17,16,13,58,47,11,67,10
88,Shrewsbury,17,10,19,58,58,0,61,11
88,Exeter City,15,13,18,52,59,-7,58,12
88,Bristol Rovers,15,12,19,63,72,-9,57,13
88,Lincoln City,9,26,11,39,46,-7,53,14
88,Charlton Ath,12,16,18,58,67,-9,52,15
88,Port Vale,14,10,22,42,69,-27,52,16
88,Cheltenham,13,11,22,35,55,-20,50,17
88,Burton Albion,12,13,21,50,80,-30,49,18
88,Oxford United,11,13,22,46,63,-17,46,19
88,MK Dons,11,11,24,44,67,-23,44,20
88,Acc'ton Stanley,9,16,21,41,72,-31,43,21
88,Morecambe,10,12,24,43,73,-30,42,22
88,Cambridge Utd,11,6,29,39,77,-38,39,23
88,FG Rovers,5,10,31,31,96,-65,25,24
89,Sheffield Weds,33,9,4,88,28,60,108,1
89,Ipswich Town,27,13,6,85,39,46,94,2
89,Plymouth Argyle,28,10,8,83,49,34,94,3
89,Derby County,25,12,9,78,39,39,87,4
89,Bolton,26,9,11,70,38,32,87,5
89,Wycombe,24,7,15,63,43,20,79,6
89,P'borough Utd,22,8,16,71,56,15,74,7
89,Barnsley,21,8,17,61,45,16,71,8
89,Shrewsbury,20,10,16,58,47,11,70,9
89,Portsmouth,19,12,15,72,55,17,69,10
89,Lincoln City,16,19,11,53,44,9,67,11
89,Charlton Ath,15,14,17,64,61,3,59,12
89,Fleetwood Town,14,16,16,53,53,0,58,13
89,Port Vale,15,10,21,50,71,-21,55,14
89,Exeter City,13,15,18,57,65,-8,54,15
89,Oxford United,14,10,22,52,61,-9,52,16
89,Bristol Rovers,13,12,21,60,77,-17,51,17
89,Burton Albion,14,9,23,49,84,-35,51,18
89,MK Dons,13,8,25,49,68,-19,47,19
89,Cheltenham,11,10,25,31,60,-29,43,20
89,Acc'ton Stanley,10,13,23,43,82,-39,43,21
89,Morecambe,9,13,24,42,77,-35,40,22
89,Cambridge Utd,10,10,26,38,73,-35,40,23
89,FG Rovers,6,11,29,33,88,-55,29,24
90,Sheffield Weds,31,10,5,92,33,59,103,1
90,Plymouth Argyle,28,11,7,84,45,39,95,2
90,Ipswich Town,25,16,5,90,38,52,91,3
90,Bolton,25,11,10,65,34,31,86,4
90,Derby County,23,13,10,77,43,34,82,5
90,Barnsley,24,9,13,71,50,21,81,6
90,Wycombe,23,9,14,69,51,18,78,7
90,P'borough Utd,23,6,17,78,64,14,75,8
90,Portsmouth,20,14,12,72,49,23,74,9
90,Fleetwood Town,17,16,13,49,40,9,67,10
90,Charlton Ath,18,12,16,72,60,12,66,11
90,Lincoln City,15,20,11,47,42,5,65,12
90,Shrewsbury,18,10,18,48,48,0,64,13
90,Exeter City,14,14,18,55,53,2,56,14
90,Port Vale,13,12,21,45,66,-21,51,15
90,Bristol Rovers,13,9,24,61,83,-22,48,16
90,Burton Albion,13,9,24,57,95,-38,48,17
90,Acc'ton Stanley,11,14,21,41,70,-29,47,18
90,Cheltenham,13,8,25,41,71,-30,47,19
90,Morecambe,10,14,22,45,77,-32,44,20
90,Oxford United,10,13,23,42,58,-16,43,21
90,MK Dons,10,10,26,46,77,-31,40,22
90,Cambridge Utd,9,7,30,31,79,-48,34,23
90,FG Rovers,8,9,29,38,90,-52,33,24
91,Plymouth Argyle,28,13,5,86,49,37,97,1
91,Sheffield Weds,27,11,8,71,28,43,92,2
91,Ipswich Town,25,16,5,83,42,41,91,3
91,Barnsley,26,10,10,77,40,37,88,4
91,Derby County,24,13,9,76,37,39,85,5
91,Wycombe,24,10,12,69,44,25,82,6
91,P'borough Utd,25,6,15,84,50,34,81,7
91,Bolton,22,13,11,66,39,27,79,8
91,Portsmouth,20,13,13,69,53,16,73,9
91,Shrewsbury,20,8,18,58,49,9,68,10
91,Charlton Ath,16,12,18,58,58,0,60,11
91,Port Vale,16,9,21,46,63,-17,57,12
91,Oxford United,14,12,20,49,61,-12,54,13
91,Fleetwood Town,11,19,16,44,46,-2,52,14
91,Morecambe,13,13,20,51,69,-18,52,15
91,Exeter City,13,12,21,55,64,-9,51,16
91,Lincoln City,10,21,15,45,54,-9,51,17
91,Bristol Rovers,13,12,21,59,76,-17,51,18
91,Cheltenham,13,9,24,34,59,-25,48,19
91,Acc'ton Stanley,11,13,22,39,69,-30,46,20
91,Burton Albion,11,12,23,54,95,-41,45,21
91,MK Dons,12,8,26,41,73,-32,44,22
91,Cambridge Utd,9,8,29,39,79,-40,35,23
91,FG Rovers,8,9,29,33,89,-56,33,24
92,Ipswich Town,27,15,4,92,40,52,96,1
92,Plymouth Argyle,28,12,6,83,49,34,96,2
92,Sheffield Weds,27,14,5,82,35,47,95,3
92,Bolton,24,11,11,65,34,31,83,4
92,Derby County,22,16,8,74,38,36,82,5
92,Barnsley,24,9,13,74,47,27,81,6
92,Wycombe,24,8,14,66,46,20,80,7
92,Portsmouth,20,15,11,61,46,15,75,8
92,Shrewsbury,19,13,14,54,44,10,70,9
92,P'borough Utd,19,11,16,71,54,17,68,10
92,Exeter City,15,15,16,64,60,4,60,11
92,Lincoln City,13,19,14,51,53,-2,58,12
92,Port Vale,16,9,21,46,63,-17,57,13
92,Fleetwood Town,14,14,18,49,47,2,56,14
92,Cheltenham,15,10,21,39,59,-20,55,15
92,Burton Albion,14,13,19,60,87,-27,55,16
92,Charlton Ath,13,15,18,58,61,-3,54,17
92,Bristol Rovers,14,10,22,63,80,-17,52,18
92,Oxford United,13,10,23,48,61,-13,49,19
92,Cambridge Utd,13,8,25,40,69,-29,47,20
92,Morecambe,10,14,22,42,73,-31,44,21
92,MK Dons,10,8,28,39,72,-33,38,22
92,Acc'ton Stanley,9,11,26,34,74,-40,38,23
92,FG Rovers,5,8,33,28,91,-63,23,24
93,Sheffield Weds,32,10,4,88,32,56,106,1
93,Plymouth Argyle,29,10,7,91,51,40,97,2
93,Barnsley,25,10,11,75,46,29,85,3
93,Derby County,24,12,10,71,42,29,84,4
93,Bolton,23,13,10,62,32,30,82,5
93,Ipswich Town,21,17,8,77,43,34,80,6
93,Wycombe,24,8,14,66,45,21,80,7
93,P'borough Utd,22,6,18,78,59,19,72,8
93,Portsmouth,19,14,13,63,51,12,71,9
93,Lincoln City,15,20,11,47,49,-2,65,10
93,Charlton Ath,16,14,16,68,61,7,62,11
93,Fleetwood Town,15,16,15,47,43,4,61,12
93,Shrewsbury,17,9,20,53,52,1,60,13
93,Bristol Rovers,15,11,20,65,82,-17,56,14
93,Oxford United,13,13,20,48,55,-7,52,15
93,Exeter City,13,11,22,53,69,-16,50,16
93,Port Vale,13,10,23,42,68,-26,49,17
93,MK Dons,13,8,25,42,64,-22,47,18
93,Acc'ton Stanley,11,14,21,44,71,-27,47,19
93,Morecambe,10,16,20,49,71,-22,46,20
93,Cambridge Utd,13,6,27,38,68,-30,45,21
93,Cheltenham,11,12,23,34,65,-31,45,22
93,Burton Albion,10,13,23,53,82,-29,43,23
93,FG Rovers,6,11,29,36,89,-53,29,24
94,Sheffield Weds,29,12,5,87,37,50,99,1
94,Plymouth Argyle,28,10,8,80,52,28,94,2
94,Derby County,24,13,9,81,39,42,85,3
94,Ipswich Town,22,18,6,78,41,37,84,4
94,Bolton,23,11,12,65,37,28,80,5
94,Wycombe,23,11,12,64,41,23,80,6
94,Barnsley,24,8,14,65,44,21,80,7
94,Portsmouth,20,14,12,68,46,22,74,8
94,P'borough Utd,22,6,18,72,55,17,72,9
94,Port Vale,21,9,16,56,56,0,72,10
94,Shrewsbury,18,11,17,56,49,7,65,11
94,Fleetwood Town,16,16,14,53,43,10,64,12
94,Exeter City,16,14,16,60,55,5,62,13
94,Charlton Ath,15,15,16,62,64,-2,60,14
94,Lincoln City,10,22,14,42,53,-11,52,15
94,Oxford United,14,10,22,43,60,-17,52,16
94,Burton Albion,13,11,22,56,78,-22,50,17
94,MK Dons,13,9,24,44,67,-23,48,18
94,Bristol Rovers,12,11,23,62,88,-26,47,19
94,Cheltenham,10,14,22,34,59,-25,44,20
94,Morecambe,10,14,22,43,69,-26,44,21
94,Acc'ton Stanley,9,12,25,37,75,-38,39,22
94,Cambridge Utd,9,7,30,34,82,-48,34,23
94,FG Rovers,8,8,30,34,86,-52,32,24
95,Sheffield Weds,34,8,4,96,30,66,110,1
95,Barnsley,28,8,10,72,36,36,92,2
95,Plymouth Argyle,27,10,9,81,47,34,91,3
95,Ipswich Town,24,16,6,86,42,44,88,4
95,Derby County,24,12,10,78,45,33,84,5
95,Bolton,23,10,13,66,39,27,79,6
95,P'borough Utd,22,7,17,75,57,18,73,7
95,Wycombe,18,15,13,59,47,12,69,8
95,Portsmouth,17,17,12,63,51,12,68,9
95,Shrewsbury,18,12,16,55,50,5,66,10
95,Charlton Ath,17,14,15,64,56,8,65,11
95,Fleetwood Town,15,16,15,54,48,6,61,12
95,Oxford United,15,11,20,53,62,-9,56,13
95,Lincoln City,11,22,13,46,52,-6,55,14
95,Port Vale,14,12,20,49,65,-16,54,15
95,Bristol Rovers,13,14,19,66,81,-15,53,16
95,Exeter City,13,13,20,58,68,-10,52,17
95,Acc'ton Stanley,11,15,20,43,75,-32,48,18
95,Burton Albion,11,14,21,53,89,-36,47,19
95,Cheltenham,11,12,23,37,64,-27,45,20
95,MK Dons,10,12,24,42,66,-24,42,21
95,Morecambe,9,14,23,47,81,-34,41,22
95,Cambridge Utd,9,10,27,42,79,-37,37,23
95,FG Rovers,5,12,29,39,94,-55,27,24
96,Sheffield Weds,30,13,3,89,33,56,103,1
96,Plymouth Argyle,28,11,7,82,49,33,95,2
96,Barnsley,29,7,10,72,36,36,94,3
96,Wycombe,26,8,12,65,36,29,86,4
96,Ipswich Town,23,15,8,79,44,35,84,5
96,Portsmouth,22,13,11,65,46,19,79,6
96,Bolton,22,12,12,62,33,29,78,7
96,P'borough Utd,23,6,17,70,49,21,75,8
96,Derby County,20,13,13,69,49,20,73,9
96,Shrewsbury,19,8,19,50,46,4,65,10
96,Lincoln City,14,20,12,41,47,-6,62,11
96,Charlton Ath,14,16,16,58,55,3,58,12
96,Port Vale,15,11,20,51,63,-12,56,13
96,Exeter City,14,12,20,52,61,-9,54,14
96,Bristol Rovers,15,9,22,60,83,-23,54,15
96,Fleetwood Town,13,14,19,46,50,-4,53,16
96,Oxford United,12,13,21,48,55,-7,49,17
96,Cheltenham,13,10,23,38,63,-25,49,18
96,Cambridge Utd,13,8,25,43,71,-28,47,19
96,Burton Albion,12,10,24,55,86,-31,46,20
96,Acc'ton Stanley,10,13,23,38,69,-31,43,21
96,MK Dons,10,12,24,44,72,-28,42,22
96,Morecambe,8,15,23,40,68,-28,39,23
96,FG Rovers,8,9,29,34,87,-53,33,24
97,Plymouth Argyle,28,11,7,91,54,37,95,1
97,Sheffield Weds,27,13,6,80,37,43,94,2
97,Barnsley,29,6,11,77,40,37,93,3
97,Ipswich Town,23,16,7,84,50,34,85,4
97,Wycombe,26,7,13,70,40,30,85,5
97,Bolton,24,12,10,70,38,32,84,6
97,Derby County,24,11,11,72,44,28,83,7
97,P'borough Utd,26,4,16,81,57,24,82,8
97,Portsmouth,17,15,14,62,55,7,66,9
97,Fleetwood Town,17,13,16,51,45,6,64,10
97,Charlton Ath,16,15,15,64,59,5,63,11
97,Shrewsbury,17,12,17,55,52,3,63,12
97,Exeter City,16,10,20,60,61,-1,58,13
97,Lincoln City,11,22,13,39,45,-6,55,14
97,Port Vale,14,12,20,47,62,-15,54,15
97,Bristol Rovers,14,9,23,67,87,-20,51,16
97,Oxford United,13,9,24,48,63,-15,48,17
97,Cheltenham,13,9,24,36,64,-28,48,18
97,Burton Albion,11,13,22,58,87,-29,46,19
97,Cambridge Utd,13,6,27,40,74,-34,45,20
97,Morecambe,11,11,24,43,74,-31,44,21
97,Acc'ton Stanley,10,13,23,42,73,-31,43,22
97,MK Dons,11,8,27,42,70,-28,41,23
97,FG Rovers,8,9,29,37,85,-48,33,24
98,Sheffield Weds,31,12,3,79,27,52,105,1
98,Ipswich Town,27,14,5,91,38,53,95,2
98,Plymouth Argyle,28,11,7,87,48,39,95,3
98,Barnsley,26,11,9,78,39,39,89,4
98,Derby County,26,11,9,79,44,35,89,5
98,Bolton,20,14,12,61,38,23,74,6
98,Portsmouth,19,15,12,66,54,12,72,7
98,P'borough Utd,22,4,20,70,60,10,70,8
98,Wycombe,19,10,17,59,53,6,67,9
98,Shrewsbury,19,8,19,51,50,1,65,10
98,Lincoln City,13,22,11,44,43,1,61,11
98,Fleetwood Town,15,15,16,56,51,5,60,12
98,Charlton Ath,15,13,18,63,59,4,58,13
98,Exeter City,15,13,18,61,59,2,58,14
98,Port Vale,16,8,22,56,73,-17,56,15
98,Bristol Rovers,14,11,21,57,79,-22,53,16
98,Oxford United,13,12,21,49,56,-7,51,17
98,Cheltenham,14,7,25,34,64,-30,49,18
98,Burton Albion,12,12,22,60,88,-28,48,19
98,Cambridge Utd,13,8,25,42,73,-31,47,20
98,Acc'ton Stanley,10,14,22,39,77,-38,44,21
98,Morecambe,9,16,21,45,72,-27,43,22
98,MK Dons,11,8,27,45,71,-26,41,23
98,FG Rovers,5,11,30,35,91,-56,26,24
99,Sheffield Weds,29,11,6,92,30,62,98,1
99,Ipswich Town,25,14,7,86,42,44,89,2
99,Barnsley,26,10,10,66,37,29,88,3
99,Plymouth Argyle,26,10,10,85,58,27,88,4
99,Bolton,25,11,10,72,38,34,86,5
99,Wycombe,23,11,12,65,38,27,80,6
99,Derby County,21,15,10,70,43,27,78,7
99,Portsmouth,19,16,11,67,47,20,73,8
99,P'borough Utd,22,7,17,76,59,17,73,9
99,Shrewsbury,20,9,17,57,51,6,69,10
99,Charlton Ath,17,14,15,67,58,9,65,11
99,Lincoln City,14,21,11,45,45,0,63,12
99,Port Vale,16,12,18,47,61,-14,60,13
99,Fleetwood Town,14,15,17,47,48,-1,57,14
99,Exeter City,15,10,21,61,66,-5,55,15
99,Bristol Rovers,14,10,22,63,84,-21,52,16
99,Oxford United,13,12,21,44,59,-15,51,17
99,Cheltenham,13,9,24,34,61,-27,48,18
99,Morecambe,11,14,21,48,69,-21,47,19
99,Cambridge Utd,13,8,25,43,73,-30,47,20
99,MK Dons,12,8,26,46,75,-29,44,21
99,Burton Albion,10,12,24,58,89,-31,42,22
99,Acc'ton Stanley,9,11,26,31,77,-46,38,23
99,FG Rovers,5,10,31,29,91,-62,25,24
100,Sheffield Weds,31,12,3,84,31,53,105,1
100,Plymouth Argyle,29,10,7,88,48,40,97,2
100,Ipswich Town,26,14,6,93,42,51,92,3
100,Bolton,26,9,11,74,40,34,87,4
100,Barnsley,26,9,11,65,39,26,87,5
100,P'borough Utd,24,6,16,82,58,24,78,6
100,Derby County,22,11,13,66,43,23,77,7
100,Wycombe,21,10,15,57,41,16,73,8
100,Portsmouth,19,16,11,64,49,15,73,9
100,Charlton Ath,17,14,15,65,55,10,65,10
100,Fleetwood Town,16,17,13,52,43,9,65,11
100,Shrewsbury,18,10,18,58,58,0,64,12
100,Port Vale,16,11,19,51,63,-12,59,13
100,Bristol Rovers,16,10,20,60,75,-15,58,14
100,Lincoln City,11,23,12,44,46,-2,56,15
100,Exeter City,15,11,20,60,64,-4,56,16
100,Burton Albion,12,10,24,54,84,-30,46,17
100,Acc'ton Stanley,11,13,22,38,73,-35,46,18
100,Morecambe,11,12,23,45,77,-32,45,19
100,MK Dons,11,9,26,43,72,-29,42,20
100,Cheltenham,11,9,26,33,63,-30,42,21
100,Oxford United,10,11,25,44,60,-16,41,22
100,Cambridge Utd,10,8,28,35,74,-39,38,23
100,FG Rovers,6,9,31,36,93,-57,27,24
101,Sheffield Weds,32,11,3,81,30,51,107,1
101,Ipswich Town,26,14,6,85,44,41,92,2
101,Plymouth Argyle,27,9,10,81,53,28,90,3
101,Derby County,26,11,9,78,38,40,89,4
101,Barnsley,27,6,13,77,42,35,87,5
101,Bolton,24,11,11,68,35,33,83,6
101,P'borough Utd,23,6,17,84,64,20,75,7
101,Shrewsbury,21,8,17,57,48,9,71,8
101,Wycombe,19,11,16,56,46,10,68,9
101,Fleetwood Town,17,15,14,57,45,12,66,10
101,Charlton Ath,17,14,15,65,57,8,65,11
101,Lincoln City,13,24,9,44,41,3,63,12
101,Portsmouth,15,17,14,60,54,6,62,13
101,Exeter City,14,12,20,54,65,-11,54,14
101,Oxford United,13,13,20,46,56,-10,52,15
101,Acc'ton Stanley,13,13,20,49,70,-21,52,16
101,Bristol Rovers,13,12,21,65,88,-23,51,17
101,Port Vale,13,10,23,43,69,-26,49,18
101,Burton Albion,12,11,23,59,88,-29,47,19
101,Cheltenham,11,13,22,37,62,-25,46,20
101,Morecambe,10,12,24,46,74,-28,42,21
101,MK Dons,10,11,25,44,70,-26,41,22
101,Cambridge Utd,9,8,29,32,80,-48,35,23
101,FG Rovers,5,12,29,33,82,-49,27,24
102,Sheffield Weds,32,10,4,83,31,52,106,1
102,Plymouth Argyle,29,10,7,93,50,43,97,2
102,Ipswich Town,23,16,7,80,41,39,85,3
102,Derby County,23,13,10,69,44,25,82,4
102,Bolton,23,12,11,64,35,29,81,5
102,Barnsley,23,10,13,68,42,26,79,6
102,Wycombe,23,9,14,62,45,17,78,7
102,Portsmouth,20,15,11,72,50,22,75,8
102,P'borough Utd,21,9,16,74,55,19,72,9
102,Shrewsbury,18,10,18,49,47,2,64,10
102,Fleetwood Town,16,15,15,47,40,7,63,11
102,Charlton Ath,15,15,16,64,62,2,60,12
102,Exeter City,15,13,18,59,57,2,58,13
102,Lincoln City,12,22,12,41,46,-5,58,14
102,Oxford United,14,12,20,51,56,-5,54,15
102,Bristol Rovers,13,13,20,57,75,-18,52,16
102,Port Vale,14,10,22,46,66,-20,52,17
102,Acc'ton Stanley,13,13,20,42,66,-24,52,18
102,Burton Albion,13,11,22,55,83,-28,50,19
102,Morecambe,11,11,24,44,81,-37,44,20
102,Cheltenham,9,14,23,32,62,-30,41,21
102,MK Dons,10,8,28,43,71,-28,38,22
102,Cambridge Utd,10,6,30,34,75,-41,36,23
102,FG Rovers,9,9,28,32,81,-49,36,24
103,Sheffield Weds,28,10,8,76,33,43,94,1
103,Bolton,26,10,10,72,33,39,88,2
103,Plymouth Argyle,24,16,6,76,48,28,88,3
103,Ipswich Town,24,15,7,79,40,39,87,4
103,Barnsley,26,9,11,69,37,32,87,5
103,Derby County,24,11,11,81,47,34,83,6
103,Wycombe,22,9,15,62,45,17,75,7
103,Portsmouth,20,14,12,66,56,10,74,8
103,P'borough Utd,21,8,17,74,59,15,71,9
103,Shrewsbury,19,9,18,56,48,8,66,10
103,Fleetwood Town,17,14,15,56,48,8,65,11
103,Exeter City,17,12,17,59,59,0,63,12
103,Charlton Ath,16,13,17,65,60,5,61,13
103,Lincoln City,14,19,13,43,45,-2,61,14
103,Oxford United,14,13,19,51,52,-1,55,15
103,Bristol Rovers,14,11,21,62,81,-19,53,16
103,Port Vale,13,11,22,44,61,-17,50,17
103,Burton Albion,13,10,23,56,90,-34,49,18
103,Acc'ton Stanley,11,14,21,42,73,-31,47,19
103,Cambridge Utd,11,10,25,39,71,-32,43,20
103,Morecambe,9,15,22,43,71,-28,42,21
103,MK Dons,10,10,26,39,70,-31,40,22
103,Cheltenham,10,8,28,31,68,-37,38,23
103,FG Rovers,9,9,28,40,86,-46,36,24
104,Sheffield Weds,31,10,5,95,35,60,103,1
104,Plymouth Argyle,29,9,8,83,46,37,96,2
104,Ipswich Town,25,16,5,92,45,47,91,3
104,Bolton,25,11,10,67,32,35,86,4
104,Barnsley,25,9,12,71,42,29,84,5
104,Derby County,24,10,12,76,44,32,82,6
104,Wycombe,23,8,15,68,50,18,77,7
104,Portsmouth,21,13,12,65,51,14,76,8
104,P'borough Utd,20,7,19,70,60,10,67,9
104,Shrewsbury,17,13,16,53,51,2,64,10
104,Lincoln City,14,20,12,46,49,-3,62,11
104,Fleetwood Town,14,18,14,47,42,5,60,12
104,Charlton Ath,15,15,16,65,64,1,60,13
104,Port Vale,16,9,21,47,68,-21,57,14
104,Oxford United,14,12,20,50,57,-7,54,15
104,Bristol Rovers,14,12,20,63,77,-14,54,16
104,Exeter City,13,13,20,67,73,-6,52,17
104,Acc'ton Stanley,13,12,21,43,69,-26,51,18
104,Cheltenham,11,12,23,37,65,-28,45,19
104,Morecambe,11,11,24,46,78,-32,44,20
104,Cambridge Utd,12,6,28,36,69,-33,42,21
104,MK Dons,11,8,27,43,71,-28,41,22
104,Burton Albion,9,11,26,47,90,-43,38,23
104,FG Rovers,7,11,28,38,87,-49,32,24
105,Sheffield Weds,30,10,6,86,30,56,100,1
105,Bolton,28,9,9,79,32,47,93,2
105,Plymouth Argyle,27,11,8,82,53,29,92,3
105,Barnsley,27,8,11,73,42,31,89,4
105,Ipswich Town,22,19,5,81,43,38,85,5
105,Derby County,23,14,9,73,39,34,83,6
105,Wycombe,24,10,12,68,44,24,82,7
105,P'borough Utd,22,8,16,82,56,26,74,8
105,Shrewsbury,21,9,16,56,48,8,72,9
105,Portsmouth,19,14,13,65,56,9,71,10
105,Charlton Ath,17,13,16,69,58,11,64,11
105,Exeter City,16,14,16,58,56,2,62,12
105,Fleetwood Town,14,16,16,51,52,-1,58,13
105,Lincoln City,11,24,11,46,49,-3,57,14
105,Port Vale,15,10,21,44,62,-18,55,15
105,Oxford United,13,11,22,50,62,-12,50,16
105,Bristol Rovers,12,11,23,57,81,-24,47,17
105,Cheltenham,12,11,23,38,65,-27,47,18
105,MK Dons,11,10,25,40,68,-28,43,19
105,Burton Albion,10,13,23,54,88,-34,43,20
105,Acc'ton Stanley,9,13,24,39,73,-34,40,21
105,Morecambe,8,12,26,41,75,-34,36,22
105,Cambridge Utd,10,6,30,35,80,-45,36,23
105,FG Rovers,7,12,27,35,90,-55,33,24
106,Sheffield Weds,30,11,5,84,29,55,101,1
106,Barnsley,27,9,10,77,38,39,90,2
106,Ipswich Town,25,15,6,82,45,37,90,3
106,Plymouth Argyle,26,11,9,85,55,30,89,4
106,Derby County,24,13,9,72,37,35,85,5
106,Bolton,22,10,14,60,37,23,76,6
106,P'borough Utd,23,6,17,75,55,20,75,7
106,Wycombe,21,8,17,56,45,11,71,8
106,Shrewsbury,21,7,18,53,49,4,70,9
106,Portsmouth,17,14,15,56,50,6,65,10
106,Fleetwood Town,16,15,15,51,44,7,63,11
106,Charlton Ath,16,14,16,68,61,7,62,12
106,Lincoln City,13,21,12,48,51,-3,60,13
106,Port Vale,16,11,19,50,64,-14,59,14
106,Exeter City,14,12,20,58,61,-3,54,15
106,Oxford United,13,13,20,47,59,-12,52,16
106,Burton Albion,13,13,20,64,88,-24,52,17
106,Bristol Rovers,13,12,21,61,79,-18,51,18
106,MK Dons,13,9,24,43,64,-21,48,19
106,Acc'ton Stanley,11,12,23,36,70,-34,45,20
106,Cambridge Utd,12,7,27,35,72,-37,43,21
106,Morecambe,9,14,23,49,76,-27,41,22
106,Cheltenham,10,11,25,32,70,-38,41,23
106,FG Rovers,7,12,27,37,80,-43,33,24
107,Plymouth Argyle,31,10,5,89,46,43,103,1
107,Sheffield Weds,29,12,5,81,29,52,99,2
107,Ipswich Town,24,14,8,87,45,42,86,3
107,Bolton,25,10,11,68,34,34,85,4
107,Barnsley,25,9,12,64,36,28,84,5
107,Wycombe,24,9,13,64,41,23,81,6
107,Derby County,22,12,12,70,45,25,78,7
107,Portsmouth,21,15,10,63,46,17,78,8
107,P'borough Utd,23,8,15,77,52,25,77,9
107,Lincoln City,14,22,10,42,43,-1,64,10
107,Charlton Ath,17,12,17,63,61,2,63,11
107,Shrewsbury,17,11,18,54,54,0,62,12
107,Exeter City,13,16,17,56,57,-1,55,13
107,Fleetwood Town,14,13,19,46,49,-3,55,14
107,Port Vale,15,10,21,45,61,-16,55,15
107,Bristol Rovers,15,10,21,63,83,-20,55,16
107,Oxford United,13,10,23,44,57,-13,49,17
107,Burton Albion,13,9,24,50,78,-28,48,18
107,MK Dons,13,8,25,45,70,-25,47,19
107,Acc'ton Stanley,10,14,22,37,73,-36,44,20
107,Morecambe,10,13,23,46,72,-26,43,21
107,Cheltenham,11,8,27,34,65,-31,41,22
107,Cambridge Utd,11,6,29,35,75,-40,39,23
107,FG Rovers,7,9,30,31,82,-51,30,24
108,Sheffield Weds,30,10,6,80,32,48,100,1
108,Ipswich Town,26,15,5,83,40,43,93,2
108,Plymouth Argyle,25,12,9,89,54,35,87,3
108,Barnsley,26,9,11,72,41,31,87,4
108,Derby County,24,13,9,75,37,38,85,5
108,Bolton,21,13,12,67,39,28,76,6
108,Wycombe,23,5,18,61,46,15,74,7
108,Portsmouth,19,16,11,64,52,12,73,8
108,P'borough Utd,21,6,19,80,65,15,69,9
108,Shrewsbury,19,11,16,53,50,3,68,10
108,Charlton Ath,17,13,16,63,61,2,64,11
108,Fleetwood Town,16,14,16,48,47,1,62,12
108,Lincoln City,12,21,13,44,48,-4,57,13
108,Exeter City,14,14,18,57,65,-8,56,14
108,Bristol Rovers,15,10,21,65,87,-22,55,15
108,Oxford United,13,14,19,49,60,-11,53,16
108,Port Vale,13,12,21,45,61,-16,51,17
108,Acc'ton Stanley,12,13,21,37,62,-25,49,18
108,Burton Albion,13,10,23,59,91,-32,49,19
108,Morecambe,12,12,22,45,70,-25,48,20
108,Cheltenham,12,11,23,37,60,-23,47,21
108,Cambridge Utd,11,9,26,43,73,-30,42,22
108,MK Dons,11,8,27,44,69,-25,41,23
108,FG Rovers,6,11,29,31,81,-50,29,24
109,Sheffield Weds,30,12,4,83,30,53,102,1
109,Plymouth Argyle,30,9,7,86,51,35,99,2
109,Barnsley,28,7,11,79,42,37,91,3
109,Ipswich Town,26,12,8,84,53,31,90,4
109,Derby County,24,14,8,80,37,43,86,5
109,P'borough Utd,27,4,15,93,61,32,85,6
109,Wycombe,24,8,14,70,43,27,80,7
109,Bolton,21,15,10,66,38,28,78,8
109,Charlton Ath,18,12,16,60,54,6,66,9
109,Portsmouth,16,17,13,61,55,6,65,10
109,Fleetwood Town,16,14,16,49,47,2,62,11
109,Shrewsbury,17,9,20,49,51,-2,60,12
109,Lincoln City,14,18,14,44,48,-4,60,13
109,Port Vale,15,11,20,44,63,-19,56,14
109,Exeter City,15,9,22,55,67,-12,54,15
109,Bristol Rovers,13,13,20,60,81,-21,52,16
109,Oxford United,13,12,21,49,54,-5,51,17
109,Cheltenham,13,9,24,40,63,-23,48,18
109,Cambridge Utd,12,7,27,37,65,-28,43,19
109,Acc'ton Stanley,10,12,24,37,70,-33,42,20
109,Burton Albion,9,14,23,46,83,-37,41,21
109,Morecambe,9,13,24,46,75,-29,40,22
109,MK Dons,10,10,26,39,75,-36,40,23
109,FG Rovers,6,11,29,35,86,-51,29,24
110,Sheffield Weds,31,10,5,87,27,60,103,1
110,Plymouth Argyle,29,12,5,90,49,41,99,2
110,Ipswich Town,25,14,7,95,47,48,89,3
110,Barnsley,27,8,11,81,44,37,89,4
110,Bolton,25,12,9,63,31,32,87,5
110,Derby County,22,13,11,73,45,28,79,6
110,Wycombe,24,7,15,73,46,27,79,7
110,Portsmouth,21,15,10,64,46,18,78,8
110,P'borough Utd,22,7,17,75,60,15,73,9
110,Shrewsbury,21,10,15,58,47,11,73,10
110,Charlton Ath,18,12,16,72,61,11,66,11
110,Lincoln City,14,21,11,50,44,6,63,12
110,Fleetwood Town,14,15,17,55,50,5,57,13
110,Exeter City,14,13,19,54,63,-9,55,14
110,Port Vale,15,8,23,51,76,-25,53,15
110,Bristol Rovers,14,10,22,64,81,-17,52,16
110,Acc'ton Stanley,12,12,22,42,75,-33,48,17
110,Oxford United,11,10,25,46,64,-18,43,18
110,Morecambe,10,13,23,47,75,-28,43,19
110,Cheltenham,11,10,25,32,65,-33,43,20
110,Burton Albion,10,11,25,51,94,-43,41,21
110,Cambridge Utd,9,12,25,35,76,-41,39,22
110,MK Dons,9,10,27,38,71,-33,37,23
110,FG Rovers,6,11,29,31,90,-59,29,24
111,Sheffield Weds,30,12,4,87,32,55,102,1
111,Derby County,24,13,9,71,36,35,85,2
111,Bolton,25,10,11,70,36,34,85,3
111,Plymouth Argyle,24,13,9,77,55,22,85,4
111,Barnsley,25,8,13,72,44,28,83,5
111,Ipswich Town,22,15,9,82,49,33,81,6
111,Wycombe,24,8,14,61,36,25,80,7
111,P'borough Utd,21,8,17,73,53,20,71,8
111,Shrewsbury,20,9,17,54,53,1,69,9
111,Portsmouth,17,14,15,59,51,8,65,10
111,Charlton Ath,16,16,14,66,61,5,64,11
111,Port Vale,17,10,19,52,63,-11,61,12
111,Lincoln City,13,21,12,44,46,-2,60,13
111,Fleetwood Town,13,20,13,46,43,3,59,14
111,Bristol Rovers,15,11,20,64,75,-11,56,15
111,Exeter City,15,10,21,55,59,-4,55,16
111,Acc'ton Stanley,13,15,18,43,62,-19,54,17
111,Cambridge Utd,14,8,24,44,69,-25,50,18
111,Burton Albion,12,12,22,56,93,-37,48,19
111,Oxford United,11,14,21,47,61,-14,47,20
111,Cheltenham,10,9,27,32,65,-33,39,21
111,MK Dons,8,14,24,39,70,-31,38,22
111,Morecambe,8,13,25,39,78,-39,37,23
111,FG Rovers,8,11,27,40,83,-43,35,24
112,Sheffield Weds,31,10,5,80,27,53,103,1
112,Plymouth Argyle,31,8,7,90,52,38,101,2
112,Ipswich Town,26,14,6,83,44,39,92,3
112,Barnsley,26,9,11,75,44,31,87,4
112,Bolton,25,10,11,67,36,31,85,5
112,Wycombe,23,10,13,64,41,23,79,6
112,Derby County,21,14,11,66,42,24,77,7
112,Portsmouth,20,15,11,70,54,16,75,8
112,P'borough Utd,19,8,19,72,61,11,65,9
112,Fleetwood Town,16,16,14,58,45,13,64,10
112,Charlton Ath,16,14,16,69,58,11,62,11
112,Lincoln City,13,21,12,45,44,1,60,12
112,Shrewsbury,17,9,20,52,52,0,60,13
112,Bristol Rovers,14,13,19,65,81,-16,55,14
112,Port Vale,15,10,21,49,69,-20,55,15
112,Exeter City,14,12,20,58,64,-6,54,16
112,Cheltenham,15,7,24,37,59,-22,52,17
112,Burton Albion,14,10,22,61,85,-24,52,18
112,Morecambe,13,11,22,44,72,-28,50,19
112,Acc'ton Stanley,12,12,22,42,74,-32,48,20
112,Oxford United,10,13,23,47,64,-17,43,21
112,MK Dons,10,7,29,41,78,-37,37,22
112,Cambridge Utd,9,8,29,38,81,-43,35,23
112,FG Rovers,6,11,29,38,84,-46,29,24
113,Plymouth Argyle,28,9,9,83,48,35,93,1
113,Sheffield Weds,25,15,6,71,32,39,90,2
113,Ipswich Town,25,14,7,83,42,41,89,3
113,Barnsley,27,7,12,73,45,28,88,4
113,Bolton,24,13,9,66,34,32,85,5
113,Portsmouth,22,16,8,73,49,24,82,6
113,Derby County,23,12,11,72,45,27,81,7
113,P'borough Utd,24,7,15,87,59,28,79,8
113,Wycombe,22,8,16,67,52,15,74,9
113,Shrewsbury,19,10,17,57,50,7,67,10
113,Lincoln City,14,21,11,45,41,4,63,11
113,Fleetwood Town,15,17,14,50,46,4,62,12
113,Charlton Ath,15,14,17,65,62,3,59,13
113,Port Vale,16,9,21,49,65,-16,57,14
113,Exeter City,13,15,18,54,59,-5,54,15
113,Bristol Rovers,12,14,20,58,76,-18,50,16
113,Oxford United,11,15,20,47,58,-11,48,17
113,Burton Albion,13,9,24,58,85,-27,48,18
113,Morecambe,12,11,23,49,76,-27,47,19
113,Cheltenham,10,12,24,31,64,-33,42,20
113,Acc'ton Stanley,9,14,23,34,72,-38,41,21
113,MK Dons,11,7,28,46,75,-29,40,22
113,Cambridge Utd,9,10,27,34,74,-40,37,23
113,FG Rovers,8,11,27,36,79,-43,35,24
114,Sheffield Weds,29,12,5,81,27,54,99,1
114,Plymouth Argyle,28,10,8,86,52,34,94,2
114,Barnsley,25,10,11,73,43,30,85,3
114,Ipswich Town,23,14,9,86,46,40,83,4
114,P'borough Utd,26,5,15,85,57,28,83,5
114,Bolton,25,8,13,64,37,27,83,6
114,Wycombe,24,8,14,77,50,27,80,7
114,Portsmouth,20,17,9,70,50,20,77,8
114,Derby County,20,14,12,68,43,25,74,9
114,Fleetwood Town,16,16,14,56,45,11,64,10
114,Charlton Ath,16,14,16,71,60,11,62,11
114,Exeter City,17,11,18,57,53,4,62,12
114,Shrewsbury,17,8,21,48,60,-12,59,13
114,Burton Albion,16,10,20,64,80,-16,58,14
114,Bristol Rovers,15,10,21,61,80,-19,55,15
114,Oxford United,14,11,21,50,58,-8,53,16
114,Port Vale,13,12,21,42,63,-21,51,17
114,Lincoln City,9,22,15,36,57,-21,49,18
114,Cheltenham,13,10,23,35,62,-27,49,19
114,Acc'ton Stanley,11,14,21,41,68,-27,47,20
114,Morecambe,10,15,21,45,79,-34,45,21
114,Cambridge Utd,12,6,28,39,75,-36,42,22
114,MK Dons,9,11,26,40,72,-32,38,23
114,FG Rovers,5,10,31,29,87,-58,25,24
115,Sheffield Weds,30,11,5,86,29,57,101,1
115,Plymouth Argyle,27,10,9,81,53,28,91,2
115,Barnsley,25,12,9,71,39,32,87,3
115,Ipswich Town,23,17,6,81,41,40,86,4
115,Bolton,25,9,12,70,35,35,84,5
115,Derby County,22,12,12,66,44,22,78,6
115,P'borough Utd,22,10,14,79,54,25,76,7
115,Wycombe,21,9,16,55,41,14,72,8
115,Shrewsbury,20,9,17,56,49,7,69,9
115,Portsmouth,17,17,12,60,48,12,68,10
115,Charlton Ath,17,13,16,64,57,7,64,11
115,Fleetwood Town,15,17,14,60,44,16,62,12
115,Lincoln City,12,23,11,43,44,-1,59,13
115,Exeter City,16,10,20,55,58,-3,58,14
115,Oxford United,14,11,21,46,56,-10,53,15
115,Port Vale,13,13,20,44,66,-22,52,16
115,Bristol Rovers,13,13,20,63,86,-23,52,17
115,Cheltenham,14,9,23,35,65,-30,51,18
115,MK Dons,13,11,22,48,61,-13,50,19
115,Burton Albion,12,10,24,50,83,-33,46,20
115,Acc'ton Stanley,11,12,23,36,73,-37,45,21
115,Cambridge Utd,11,9,26,42,75,-33,42,22
115,Morecambe,8,12,26,40,76,-36,36,23
115,FG Rovers,6,11,29,31,85,-54,29,24
116,Sheffield Weds,30,13,3,90,36,54,103,1
116,Plymouth Argyle,27,11,8,82,54,28,92,2
116,Bolton,25,10,11,72,34,38,85,3
116,Derby County,23,13,10,72,40,32,82,4
116,Barnsley,24,9,13,65,44,21,81,5
116,Ipswich Town,22,14,10,82,54,28,80,6
116,Wycombe,24,7,15,70,55,15,79,7
116,Portsmouth,21,15,10,80,55,25,78,8
116,P'borough Utd,22,8,16,78,57,21,74,9
116,Shrewsbury,18,11,17,59,48,11,65,10
116,Fleetwood Town,16,16,14,50,50,0,64,11
116,Lincoln City,13,23,10,47,45,2,62,12
116,Bristol Rovers,17,10,19,70,79,-9,61,13
116,Exeter City,14,15,17,62,61,1,57,14
116,Charlton Ath,13,17,16,59,62,-3,56,15
116,Oxford United,14,13,19,49,56,-7,55,16
116,Port Vale,14,9,23,48,71,-23,51,17
116,Burton Albion,11,12,23,53,80,-27,45,18
116,Acc'ton Stanley,10,14,22,37,66,-29,44,19
116,Morecambe,10,13,23,42,72,-30,43,20
116,Cheltenham,9,13,24,36,66,-30,40,21
116,MK Dons,9,12,25,38,67,-29,39,22
116,Cambridge Utd,8,13,25,37,74,-37,37,23
116,FG Rovers,7,11,28,35,87,-52,32,24
117,Sheffield Weds,30,10,6,83,36,47,100,1
117,Plymouth Argyle,28,11,7,83,43,40,95,2
117,Barnsley,27,8,11,73,39,34,89,3
117,Ipswich Town,24,13,9,86,49,37,85,4
117,Derby County,24,11,11,79,45,34,83,5
117,Bolton,23,12,11,72,41,31,81,6
117,Wycombe,23,9,14,61,40,21,78,7
117,P'borough Utd,23,6,17,77,60,17,75,8
117,Fleetwood Town,17,16,13,57,48,9,67,9
117,Charlton Ath,17,14,15,63,60,3,65,10
117,Portsmouth,16,15,15,63,61,2,63,11
117,Port Vale,16,10,20,50,66,-16,58,12
117,Shrewsbury,16,9,21,49,52,-3,57,13
117,Lincoln City,11,24,11,44,47,-3,57,14
117,Exeter City,14,15,17,54,58,-4,57,15
117,Bristol Rovers,15,11,20,67,80,-13,56,16
117,Oxford United,13,14,19,46,57,-11,53,17
117,Cheltenham,12,11,23,36,60,-24,47,18
117,Burton Albion,12,11,23,55,82,-27,47,19
117,MK Dons,11,9,26,39,70,-31,42,20
117,Acc'ton Stanley,9,15,22,37,69,-32,42,21
117,Morecambe,9,13,24,42,75,-33,40,22
117,Cambridge Utd,9,13,24,34,67,-33,40,23
117,FG Rovers,7,12,27,37,82,-45,33,24
118,Sheffield Weds,32,10,4,88,28,60,106,1
118,Plymouth Argyle,27,12,7,87,49,38,93,2
118,Barnsley,27,8,11,73,40,33,89,3
118,Bolton,26,10,10,73,36,37,88,4
118,Ipswich Town,24,15,7,84,47,37,87,5
118,Derby County,23,14,9,75,43,32,83,6
118,Wycombe,25,8,13,73,42,31,83,7
118,Portsmouth,19,17,10,61,50,11,74,8
118,P'borough Utd,22,6,18,80,58,22,72,9
118,Charlton Ath,16,17,13,66,59,7,65,10
118,Exeter City,16,12,18,62,61,1,60,11
118,Fleetwood Town,15,14,17,52,51,1,59,12
118,Shrewsbury,15,13,18,47,50,-3,58,13
118,Lincoln City,11,23,12,41,49,-8,56,14
118,Bristol Rovers,14,11,21,63,84,-21,53,15
118,Port Vale,13,12,21,44,61,-17,51,16
118,Acc'ton Stanley,12,13,21,41,68,-27,49,17
118,Oxford United,12,12,22,44,60,-16,48,18
118,Morecambe,11,12,23,46,69,-23,45,19
118,Burton Albion,11,10,25,50,86,-36,43,20
118,Cheltenham,11,10,25,37,73,-36,43,21
118,MK Dons,9,12,25,39,67,-28,39,22
118,Cambridge Utd,10,7,29,33,76,-43,37,23
118,FG Rovers,7,10,29,39,91,-52,31,24
119,Sheffield Weds,30,12,4,78,27,51,102,1
119,Plymouth Argyle,29,11,6,89,46,43,98,2
119,Barnsley,26,9,11,70,40,30,87,3
119,Ipswich Town,24,14,8,82,44,38,86,4
119,Bolton,25,10,11,69,37,32,85,5
119,Derby County,23,13,10,78,38,40,82,6
119,P'borough Utd,23,8,15,74,48,26,77,7
119,Wycombe,22,10,14,66,44,22,76,8
119,Portsmouth,17,16,13,63,52,11,67,9
119,Shrewsbury,19,10,17,51,52,-1,67,10
119,Fleetwood Town,16,15,15,49,44,5,63,11
119,Charlton Ath,16,15,15,70,66,4,63,12
119,Lincoln City,11,24,11,44,47,-3,57,13
119,Oxford United,15,12,19,47,51,-4,57,14
119,Exeter City,14,14,18,55,56,-1,56,15
119,Port Vale,13,12,21,44,66,-22,51,16
119,Bristol Rovers,13,10,23,59,81,-22,49,17
119,Morecambe,12,12,22,49,76,-27,48,18
119,MK Dons,13,7,26,44,67,-23,46,19
119,Cheltenham,12,9,25,32,68,-36,45,20
119,Burton Albion,11,12,23,54,91,-37,45,21
119,Acc'ton Stanley,9,16,21,33,61,-28,43,22
119,Cambridge Utd,9,9,28,32,70,-38,36,23
119,FG Rovers,6,8,32,31,91,-60,26,24
120,Sheffield Weds,31,10,5,87,35,52,103,1
120,Ipswich Town,25,15,6,78,35,43,90,2
120,Plymouth Argyle,26,11,9,86,53,33,89,3
120,Barnsley,25,11,10,67,40,27,86,4
120,Derby County,23,11,12,69,44,25,80,5
120,Bolton,22,11,13,64,36,28,77,6
120,Portsmouth,20,15,11,71,54,17,75,7
120,P'borough Utd,23,5,18,80,55,25,74,8
120,Wycombe,21,9,16,65,48,17,72,9
120,Lincoln City,16,19,11,51,44,7,67,10
120,Shrewsbury,17,12,17,52,49,3,63,11
120,Fleetwood Town,15,15,16,47,47,0,60,12
120,Charlton Ath,14,16,16,61,63,-2,58,13
120,Cheltenham,16,7,23,37,62,-25,55,14
120,Exeter City,14,12,20,58,66,-8,54,15
120,Oxford United,14,11,21,49,60,-11,53,16
120,Bristol Rovers,15,8,23,61,80,-19,53,17
120,Port Vale,14,9,23,47,69,-22,51,18
120,Acc'ton Stanley,11,15,20,44,69,-25,48,19
120,Cambridge Utd,12,10,24,39,72,-33,46,20
120,MK Dons,12,9,25,42,68,-26,45,21
120,Burton Albion,11,12,23,51,80,-29,45,22
120,Morecambe,10,13,23,48,74,-26,43,23
120,FG Rovers,6,12,28,31,82,-51,30,24
121,Sheffield Weds,29,10,7,89,37,52,97,1
121,Plymouth Argyle,29,10,7,91,51,40,97,2
121,Ipswich Town,25,15,6,88,46,42,90,3
121,Barnsley,24,11,11,77,47,30,83,4
121,Portsmouth,22,15,9,74,48,26,81,5
121,Bolton,22,13,11,68,35,33,79,6
121,Derby County,22,10,14,74,52,22,76,7
121,Wycombe,19,12,15,60,47,13,69,8
121,P'borough Utd,20,7,19,72,60,12,67,9
121,Fleetwood Town,17,14,15,52,48,4,65,10
121,Charlton Ath,17,13,16,71,62,9,64,11
121,Lincoln City,13,24,9,44,40,4,63,12
121,Shrewsbury,16,10,20,53,58,-5,58,13
121,Bristol Rovers,15,11,20,64,84,-20,56,14
121,Exeter City,14,12,20,57,62,-5,54,15
121,Port Vale,15,8,23,46,70,-24,53,16
121,Cheltenham,14,10,22,32,52,-20,52,17
121,Acc'ton Stanley,13,13,20,45,73,-28,52,18
121,Burton Albion,13,10,23,56,89,-33,49,19
121,Oxford United,12,12,22,49,63,-14,48,20
121,MK Dons,12,8,26,49,75,-26,44,21
121,Morecambe,9,17,20,46,73,-27,44,22
121,Cambridge Utd,12,6,28,38,75,-37,42,23
121,FG Rovers,7,11,28,37,85,-48,32,24
122,Sheffield Weds,32,10,4,90,36,54,106,1
122,Ipswich Town,23,18,5,86,44,42,87,2
122,Plymouth Argyle,24,12,10,73,49,24,84,3
122,Derby County,23,13,10,74,45,29,82,4
122,Bolton,23,13,10,66,38,28,82,5
122,Barnsley,23,11,12,65,40,25,80,6
122,Wycombe,23,10,13,63,39,24,79,7
122,Portsmouth,18,17,11,70,54,16,71,8
122,Shrewsbury,19,12,15,59,48,11,69,9
122,P'borough Utd,21,5,20,72,64,8,68,10
122,Fleetwood Town,15,16,15,51,42,9,61,11
122,Charlton Ath,15,16,15,64,57,7,61,12
122,Lincoln City,11,24,11,39,45,-6,57,13
122,Exeter City,14,13,19,58,62,-4,55,14
122,Burton Albion,15,10,21,63,81,-18,55,15
122,Oxford United,12,15,19,46,53,-7,51,16
122,Bristol Rovers,14,9,23,58,80,-22,51,17
122,Morecambe,11,15,20,41,61,-20,48,18
122,Cambridge Utd,13,8,25,39,72,-33,47,19
122,Acc'ton Stanley,11,13,22,40,72,-32,46,20
122,MK Dons,12,9,25,42,70,-28,45,21
122,Port Vale,12,9,25,38,71,-33,45,22
122,Cheltenham,10,12,24,37,66,-29,42,23
122,FG Rovers,8,10,28,40,85,-45,34,24
123,Plymouth Argyle,31,9,6,95,46,49,102,1
123,Sheffield Weds,29,9,8,82,39,43,96,2
123,Ipswich Town,26,14,6,84,40,44,92,3
123,Barnsley,27,8,11,80,45,35,89,4
123,Bolton,25,9,12,68,39,29,84,5
123,Wycombe,25,8,13,72,47,25,83,6
123,Derby County,23,12,11,80,51,29,81,7
123,P'borough Utd,25,5,16,81,59,22,80,8
123,Portsmouth,19,17,10,63,47,16,74,9
123,Shrewsbury,18,12,16,53,50,3,66,10
123,Charlton Ath,16,16,14,66,58,8,64,11
123,Fleetwood Town,16,15,15,53,46,7,63,12
123,Lincoln City,12,22,12,44,47,-3,58,13
123,Oxford United,13,13,20,50,58,-8,52,14
123,Port Vale,14,10,22,49,68,-19,52,15
123,Acc'ton Stanley,12,15,19,40,63,-23,51,16
123,Exeter City,12,13,21,60,72,-12,49,17
123,Bristol Rovers,11,12,23,58,83,-25,45,18
123,Cheltenham,11,11,24,35,62,-27,44,19
123,Burton Albion,11,9,26,51,95,-44,42,20
123,MK Dons,11,7,28,44,73,-29,40,21
123,Morecambe,8,15,23,42,73,-31,39,22
123,Cambridge Utd,10,7,29,38,82,-44,37,23
123,FG Rovers,6,14,26,36,81,-45,32,24
124,Sheffield Weds,31,11,4,81,29,52,104,1
124,Plymouth Argyle,28,11,7,85,52,33,95,2
124,Wycombe,27,7,12,70,39,31,88,3
124,Ipswich Town,24,15,7,87,44,43,87,4
124,Barnsley,26,9,11,75,44,31,87,5
124,Bolton,25,11,10,72,33,39,86,6
124,Derby County,24,13,9,80,39,41,85,7
124,P'borough Utd,21,8,17,69,50,19,71,8
124,Portsmouth,17,16,13,58,60,-2,67,9
124,Shrewsbury,19,8,19,52,57,-5,65,10
124,Fleetwood Town,16,15,15,54,47,7,63,11
124,Burton Albion,16,10,20,66,75,-9,58,12
124,Charlton Ath,13,16,17,57,56,1,55,13
124,Lincoln City,11,22,13,44,51,-7,55,14
124,Exeter City,13,13,20,53,63,-10,52,15
124,Bristol Rovers,13,12,21,61,81,-20,51,16
124,Port Vale,13,11,22,46,67,-21,50,17
124,Oxford United,12,13,21,49,60,-11,49,18
124,Acc'ton Stanley,12,13,21,40,72,-32,49,19
124,Cheltenham,12,11,23,35,61,-26,47,20
124,MK Dons,12,10,24,48,69,-21,46,21
124,Morecambe,9,14,23,42,72,-30,41,22
124,Cambridge Utd,8,10,28,32,77,-45,34,23
124,FG Rovers,5,11,30,32,90,-58,26,24
125,Sheffield Weds,29,12,5,88,33,55,99,1
125,Plymouth Argyle,29,11,6,80,48,32,98,2
125,Barnsley,28,9,9,73,35,38,93,3
125,Ipswich Town,24,16,6,88,44,44,88,4
125,Bolton,25,11,10,73,37,36,86,5
125,Derby County,23,15,8,74,37,37,84,6
125,Portsmouth,19,15,12,69,50,19,72,7
125,Wycombe,20,11,15,60,48,12,71,8
125,Shrewsbury,20,10,16,57,52,5,70,9
125,P'borough Utd,19,8,19,68,58,10,65,10
125,Charlton Ath,17,13,16,68,58,10,64,11
125,Fleetwood Town,13,20,13,49,45,4,59,12
125,Lincoln City,12,19,15,45,49,-4,55,13
125,Bristol Rovers,14,12,20,68,80,-12,54,14
125,Cheltenham,15,9,22,37,56,-19,54,15
125,Exeter City,13,14,19,54,60,-6,53,16
125,Port Vale,14,11,21,49,68,-19,53,17
125,Oxford United,13,11,22,44,62,-18,50,18
125,Burton Albion,13,9,24,55,81,-26,48,19
125,MK Dons,12,8,26,42,71,-29,44,20
125,Morecambe,10,13,23,43,79,-36,43,21
125,Acc'ton Stanley,9,15,22,38,78,-40,42,22
125,Cambridge Utd,9,9,28,33,73,-40,36,23
125,FG Rovers,6,11,29,34,87,-53,29,24
126,Sheffield Weds,30,10,6,84,31,53,100,1
126,Plymouth Argyle,30,9,7,81,46,35,99,2
126,Bolton,26,11,9,65,31,34,89,3
126,Barnsley,25,9,12,70,41,29,84,4
126,Derby County,23,14,9,76,37,39,83,5
126,Ipswich Town,21,15,10,74,45,29,78,6
126,Portsmouth,21,15,10,63,47,16,78,7
126,Wycombe,22,10,14,62,37,25,76,8
126,P'borough Utd,21,9,16,74,56,18,72,9
126,Charlton Ath,18,14,14,67,55,12,68,10
126,Shrewsbury,19,9,18,56,51,5,66,11
126,Fleetwood Town,15,16,15,48,42,6,61,12
126,Lincoln City,14,19,13,44,50,-6,61,13
126,Exeter City,16,12,18,56,58,-2,60,14
126,Bristol Rovers,14,8,24,59,80,-21,50,15
126,Port Vale,14,8,24,46,69,-23,50,16
126,Oxford United,11,14,21,47,59,-12,47,17
126,Burton Albion,12,11,23,57,82,-25,47,18
126,Acc'ton Stanley,10,15,21,34,68,-34,45,19
126,Cheltenham,11,11,24,31,64,-33,44,20
126,MK Dons,11,10,25,41,70,-29,43,21
126,Cambridge Utd,11,7,28,32,71,-39,40,22
126,Morecambe,8,15,23,43,75,-32,39,23
126,FG Rovers,8,11,27,32,77,-45,35,24
127,Sheffield Weds,28,15,3,80,30,50,99,1
127,Derby County,27,12,7,76,37,39,93,2
127,Plymouth Argyle,25,13,8,83,57,26,88,3
127,Ipswich Town,24,15,7,77,44,33,87,4
127,Bolton,24,10,12,70,42,28,82,5
127,Barnsley,23,11,12,71,47,24,80,6
127,Portsmouth,20,16,10,70,47,23,76,7
127,P'borough Utd,22,8,16,76,53,23,74,8
127,Wycombe,22,8,16,60,45,15,74,9
127,Charlton Ath,17,14,15,76,64,12,65,10
127,Shrewsbury,17,11,18,54,50,4,62,11
127,Fleetwood Town,15,16,15,44,43,1,61,12
127,Exeter City,14,15,17,57,59,-2,57,13
127,Lincoln City,12,21,13,40,44,-4,57,14
127,Burton Albion,15,11,20,66,82,-16,56,15
127,Port Vale,14,12,20,46,61,-15,54,16
127,Bristol Rovers,14,10,22,57,75,-18,52,17
127,Oxford United,11,14,21,44,56,-12,47,18
127,Morecambe,11,14,21,49,73,-24,47,19
127,Cheltenham,11,11,24,30,61,-31,44,20
127,Acc'ton Stanley,10,12,24,36,73,-37,42,21
127,MK Dons,11,8,27,39,69,-30,41,22
127,Cambridge Utd,11,8,27,35,73,-38,41,23
127,FG Rovers,6,11,29,33,84,-51,29,24
128,Plymouth Argyle,32,8,6,98,51,47,104,1
128,Sheffield Weds,27,12,7,71,29,42,93,2
128,Bolton,24,13,9,67,32,35,85,3
128,Ipswich Town,23,15,8,78,45,33,84,4
128,Barnsley,24,11,11,70,44,26,83,5
128,Derby County,22,13,11,71,41,30,79,6
128,Wycombe,22,8,16,66,46,20,74,7
128,Shrewsbury,21,8,17,57,55,2,71,8
128,Portsmouth,19,13,14,67,50,17,70,9
128,P'borough Utd,20,8,18,75,57,18,68,10
128,Lincoln City,14,21,11,49,46,3,63,11
128,Charlton Ath,16,14,16,64,62,2,62,12
128,Fleetwood Town,14,16,16,50,49,1,58,13
128,Exeter City,14,15,17,54,60,-6,57,14
128,Bristol Rovers,15,11,20,65,89,-24,56,15
128,Port Vale,15,10,21,48,65,-17,55,16
128,Burton Albion,13,12,21,54,80,-26,51,17
128,Oxford United,12,12,22,52,68,-16,48,18
128,Cheltenham,11,12,23,32,57,-25,45,19
128,Cambridge Utd,13,6,27,38,71,-33,45,20
128,Morecambe,9,16,21,46,71,-25,43,21
128,Acc'ton Stanley,9,16,21,40,72,-32,43,22
128,MK Dons,9,11,26,37,63,-26,38,23
128,FG Rovers,8,11,27,40,86,-46,35,24
129,Sheffield Weds,29,12,5,78,30,48,99,1
129,Plymouth Argyle,28,10,8,85,44,41,94,2
129,Barnsley,27,7,12,74,43,31,88,3
129,Derby County,24,13,9,70,38,32,85,4
129,Bolton,24,12,10,62,31,31,84,5
129,Ipswich Town,21,16,9,81,52,29,79,6
129,Wycombe,23,7,16,69,44,25,76,7
129,P'borough Utd,24,4,18,71,56,15,76,8
129,Shrewsbury,20,8,18,52,45,7,68,9
129,Portsmouth,17,16,13,61,52,9,67,10
129,Lincoln City,14,19,13,47,49,-2,61,11
129,Fleetwood Town,14,18,14,49,42,7,60,12
129,Charlton Ath,15,15,16,62,60,2,60,13
129,Exeter City,15,11,20,55,60,-5,56,14
129,Port Vale,15,11,20,46,59,-13,56,15
129,Bristol Rovers,15,10,21,61,81,-20,55,16
129,Oxford United,13,11,22,42,55,-13,50,17
129,Cheltenham,13,11,22,37,58,-21,50,18
129,MK Dons,13,7,26,49,69,-20,46,19
129,Cambridge Utd,12,10,24,39,70,-31,46,20
129,Burton Albion,12,10,24,53,87,-34,46,21
129,Acc'ton Stanley,9,14,23,37,72,-35,41,22
129,Morecambe,8,14,24,39,77,-38,38,23
129,FG Rovers,9,10,27,36,81,-45,37,24
130,Sheffield Weds,31,11,4,95,38,57,104,1
130,Bolton,27,9,10,79,38,41,90,2
130,Barnsley,27,8,11,83,44,39,89,3
130,Plymouth Argyle,26,11,9,85,50,35,89,4
130,Ipswich Town,22,16,8,84,49,35,82,5
130,Derby County,24,10,12,75,47,28,82,6
130,P'borough Utd,24,5,17,81,57,24,77,7
130,Wycombe,19,13,14,66,52,14,70,8
130,Shrewsbury,19,11,16,57,53,4,68,9
130,Portsmouth,17,14,15,62,60,2,65,10
130,Exeter City,17,13,16,60,56,4,64,11
130,Charlton Ath,17,13,16,64,64,0,64,12
130,Fleetwood Town,15,16,15,52,51,1,61,13
130,Bristol Rovers,15,12,19,66,76,-10,57,14
130,Port Vale,15,8,23,46,63,-17,53,15
130,Lincoln City,10,22,14,40,51,-11,52,16
130,Cheltenham,13,12,21,32,52,-20,51,17
130,Oxford United,12,12,22,49,64,-15,48,18
130,Morecambe,11,15,20,52,70,-18,48,19
130,Acc'ton Stanley,10,16,20,40,71,-31,46,20
130,MK Dons,11,10,25,43,69,-26,43,21
130,Burton Albion,10,11,25,55,98,-43,41,22
130,Cambridge Utd,9,11,26,34,77,-43,38,23
130,FG Rovers,6,11,29,33,83,-50,29,24
131,Sheffield Weds,31,11,4,86,29,57,104,1
131,Barnsley,27,9,10,73,36,37,90,2
131,Plymouth Argyle,26,11,9,83,57,26,89,3
131,Ipswich Town,23,17,6,83,44,39,86,4
131,Wycombe,26,7,13,75,41,34,85,5
131,Bolton,22,14,10,68,37,31,80,6
131,Derby County,21,14,11,67,39,28,77,7
131,P'borough Utd,22,7,17,70,56,14,73,8
131,Shrewsbury,19,8,19,54,54,0,65,9
131,Portsmouth,15,15,16,57,55,2,60,10
131,Charlton Ath,15,14,17,64,60,4,59,11
131,Oxford United,16,11,19,47,49,-2,59,12
131,Fleetwood Town,14,16,16,46,46,0,58,13
131,Lincoln City,11,23,12,46,49,-3,56,14
131,Bristol Rovers,15,10,21,63,79,-16,55,15
131,Port Vale,14,11,21,48,65,-17,53,16
131,Burton Albion,14,11,21,58,79,-21,53,17
131,Exeter City,13,12,21,56,63,-7,51,18
131,Morecambe,13,12,21,51,75,-24,51,19
131,Acc'ton Stanley,12,15,19,44,69,-25,51,20
131,Cheltenham,11,11,24,31,62,-31,44,21
131,MK Dons,10,11,25,42,72,-30,41,22
131,Cambridge Utd,9,14,23,37,71,-34,41,23
131,FG Rovers,6,10,30,31,93,-62,28,24
132,Sheffield Weds,30,10,6,86,32,54,100,1
132,Plymouth Argyle,27,12,7,89,49,40,93,2
132,Derby County,25,12,9,73,39,34,87,3
132,Barnsley,25,10,11,79,40,39,85,4
132,Ipswich Town,23,16,7,77,43,34,85,5
132,Bolton,24,11,11,67,33,34,83,6
132,Wycombe,22,7,17,60,49,11,73,7
132,Portsmouth,20,12,14,65,53,12,72,8
132,P'borough Utd,20,10,16,73,63,10,70,9
132,Fleetwood Town,18,15,13,54,41,13,69,10
132,Charlton Ath,18,13,15,65,58,7,67,11
132,Lincoln City,15,20,11,50,48,2,65,12
132,Shrewsbury,18,10,18,52,56,-4,64,13
132,Exeter City,16,13,17,61,65,-4,61,14
132,Oxford United,15,12,19,50,53,-3,57,15
132,Port Vale,16,9,21,49,63,-14,57,16
132,Burton Albion,13,9,24,55,92,-37,48,17
132,Cheltenham,12,10,24,36,61,-25,46,18
132,Acc'ton Stanley,10,14,22,31,62,-31,44,19
132,Bristol Rovers,11,10,25,54,82,-28,43,20
132,Morecambe,9,14,23,44,74,-30,41,21
132,Cambridge Utd,11,7,28,35,69,-34,40,22
132,MK Dons,9,10,27,40,71,-31,37,23
132,FG Rovers,8,8,30,37,86,-49,32,24
133,Sheffield Weds,31,9,6,89,34,55,102,1
133,Plymouth Argyle,28,9,9,82,51,31,93,2
133,Derby County,25,13,8,79,39,40,88,3
133,Ipswich Town,23,17,6,86,44,42,86,4
133,Barnsley,25,10,11,70,38,32,85,5
133,Bolton,23,12,11,67,42,25,81,6
133,P'borough Utd,24,6,16,84,56,28,78,7
133,Portsmouth,19,14,13,65,53,12,71,8
133,Wycombe,19,12,15,56,46,10,69,9
133,Charlton Ath,18,14,14,77,58,19,68,10
133,Shrewsbury,19,9,18,54,54,0,66,11
133,Fleetwood Town,16,14,16,55,49,6,62,12
133,Lincoln City,12,22,12,43,48,-5,58,13
133,Exeter City,14,13,19,63,68,-5,55,14
133,Bristol Rovers,15,10,21,60,76,-16,55,15
133,Port Vale,14,11,21,49,67,-18,53,16
133,Acc'ton Stanley,13,13,20,35,59,-24,52,17
133,Oxford United,12,12,22,49,62,-13,48,18
133,Cheltenham,13,9,24,37,63,-26,48,19
133,Cambridge Utd,13,9,24,35,62,-27,48,20
133,MK Dons,11,10,25,40,65,-25,43,21
133,Burton Albion,10,10,26,47,85,-38,40,22
133,Morecambe,8,13,25,45,91,-46,37,23
133,FG Rovers,7,9,30,31,88,-57,30,24
134,Sheffield Weds,31,8,7,87,31,56,101,1
134,Plymouth Argyle,27,10,9,85,50,35,91,2
134,Barnsley,28,6,12,71,40,31,90,3
134,Ipswich Town,21,19,6,80,44,36,82,4
134,Derby County,22,14,10,70,43,27,80,5
134,Wycombe,23,8,15,68,48,20,77,6
134,Bolton,21,11,14,72,46,26,74,7
134,Portsmouth,20,14,12,68,57,11,74,8
134,Charlton Ath,18,13,15,67,60,7,67,9
134,P'borough Utd,20,6,20,62,51,11,66,10
134,Shrewsbury,19,8,19,51,50,1,65,11
134,Fleetwood Town,16,16,14,53,46,7,64,12
134,Lincoln City,14,21,11,43,45,-2,63,13
134,Exeter City,16,11,19,59,67,-8,59,14
134,Bristol Rovers,16,11,19,61,74,-13,59,15
134,Port Vale,15,12,19,48,63,-15,57,16
134,Burton Albion,14,12,20,63,80,-17,54,17
134,Acc'ton Stanley,12,13,21,39,66,-27,49,18
134,Cheltenham,12,11,23,40,61,-21,47,19
134,Oxford United,12,10,24,47,68,-21,46,20
134,Cambridge Utd,12,8,26,44,75,-31,44,21
134,Morecambe,10,13,23,51,76,-25,43,22
134,MK Dons,10,9,27,43,73,-30,39,23
134,FG Rovers,6,10,30,33,91,-58,28,24
135,Sheffield Weds,28,10,8,76,36,40,94,1
135,Plymouth Argyle,27,12,7,85,49,36,93,2
135,Barnsley,26,10,10,73,41,32,88,3
135,Wycombe,26,7,13,71,41,30,85,4
135,Ipswich Town,23,15,8,85,49,36,84,5
135,Derby County,24,11,11,80,42,38,83,6
135,Bolton,22,13,11,61,36,25,79,7
135,P'borough Utd,23,8,15,86,58,28,77,8
135,Portsmouth,20,13,13,73,50,23,73,9
135,Shrewsbury,19,10,17,56,54,2,67,10
135,Fleetwood Town,16,14,16,50,47,3,62,11
135,Charlton Ath,14,16,16,62,61,1,58,12
135,Exeter City,14,13,19,56,57,-1,55,13
135,Oxford United,14,13,19,53,62,-9,55,14
135,Lincoln City,11,21,14,44,51,-7,54,15
135,Bristol Rovers,13,11,22,63,82,-19,50,16
135,MK Dons,14,8,24,46,67,-21,50,17
135,Port Vale,13,11,22,47,72,-25,50,18
135,Acc'ton Stanley,13,11,22,43,75,-32,50,19
135,Cheltenham,12,11,23,38,61,-23,47,20
135,Cambridge Utd,11,10,25,44,78,-34,43,21
135,Burton Albion,9,15,22,51,83,-32,42,22
135,Morecambe,9,14,23,45,81,-36,41,23
135,FG Rovers,7,11,28,39,94,-55,32,24
136,Sheffield Weds,31,10,5,90,28,62,103,1
136,Plymouth Argyle,30,10,6,91,52,39,100,2
136,Derby County,26,11,9,82,40,42,89,3
136,Barnsley,28,5,13,66,42,24,89,4
136,Wycombe,27,7,12,70,42,28,88,5
136,Ipswich Town,23,16,7,82,46,36,85,6
136,Bolton,24,12,10,73,34,39,84,7
136,Portsmouth,22,14,10,68,47,21,80,8
136,P'borough Utd,23,8,15,79,56,23,77,9
136,Exeter City,17,11,18,64,63,1,62,10
136,Fleetwood Town,15,16,15,54,44,10,61,11
136,Charlton Ath,15,15,16,62,58,4,60,12
136,Lincoln City,13,19,14,43,50,-7,58,13
136,Shrewsbury,16,8,22,49,57,-8,56,14
136,Bristol Rovers,14,10,22,65,90,-25,52,15
136,Port Vale,13,10,23,49,68,-19,49,16
136,Cheltenham,11,12,23,31,60,-29,45,17
136,Oxford United,10,12,24,40,64,-24,42,18
136,MK Dons,11,9,26,40,70,-30,42,19
136,Cambridge Utd,11,9,26,40,71,-31,42,20
136,Morecambe,9,14,23,46,78,-32,41,21
136,Acc'ton Stanley,9,14,23,40,73,-33,41,22
136,Burton Albion,10,11,25,49,84,-35,41,23
136,FG Rovers,8,9,29,39,95,-56,33,24
137,Sheffield Weds,29,12,5,89,33,56,99,1
137,Barnsley,29,6,11,74,40,34,93,2
137,Plymouth Argyle,24,14,8,79,52,27,86,3
137,Bolton,23,14,9,75,37,38,83,4
137,Wycombe,25,7,14,71,38,33,82,5
137,Ipswich Town,21,17,8,82,50,32,80,6
137,Portsmouth,21,15,10,67,47,20,78,7
137,Derby County,21,14,11,67,44,23,77,8
137,P'borough Utd,23,7,16,76,55,21,76,9
137,Fleetwood Town,16,17,13,57,47,10,65,10
137,Shrewsbury,18,11,17,53,50,3,65,11
137,Charlton Ath,16,16,14,68,58,10,64,12
137,Exeter City,15,11,20,57,65,-8,56,13
137,Port Vale,14,12,20,46,65,-19,54,14
137,Lincoln City,10,23,13,40,52,-12,53,15
137,Bristol Rovers,13,12,21,58,78,-20,51,16
137,Oxford United,12,14,20,47,59,-12,50,17
137,Burton Albion,13,9,24,60,94,-34,48,18
137,Morecambe,11,14,21,44,66,-22,47,19
137,Acc'ton Stanley,10,17,19,42,68,-26,47,20
137,Cheltenham,11,10,25,33,67,-34,43,21
137,MK Dons,11,9,26,43,71,-28,42,22
137,FG Rovers,7,12,27,36,80,-44,33,23
137,Cambridge Utd,8,9,29,32,80,-48,33,24
138,Sheffield Weds,29,11,6,76,27,49,98,1
138,Plymouth Argyle,27,11,8,85,50,35,92,2
138,Barnsley,27,9,10,70,41,29,90,3
138,Derby County,24,13,9,79,41,38,85,4
138,Ipswich Town,23,15,8,79,44,35,84,5
138,Wycombe,25,7,14,66,39,27,82,6
138,P'borough Utd,25,6,15,80,54,26,81,7
138,Bolton,22,12,12,64,40,24,78,8
138,Portsmouth,16,17,13,65,56,9,65,9
138,Shrewsbury,18,10,18,51,48,3,64,10
138,Fleetwood Town,15,17,14,49,43,6,62,11
138,Port Vale,16,12,18,49,62,-13,60,12
138,Charlton Ath,15,14,17,59,56,3,59,13
138,Oxford United,15,13,18,54,52,2,58,14
138,Exeter City,15,12,19,61,60,1,57,15
138,Lincoln City,11,23,12,48,54,-6,56,16
138,Bristol Rovers,15,9,22,63,81,-18,54,17
138,Burton Albion,11,14,21,52,88,-36,47,18
138,Acc'ton Stanley,10,14,22,41,73,-32,44,19
138,Morecambe,10,13,23,41,67,-26,43,20
138,Cheltenham,10,12,24,37,73,-36,42,21
138,MK Dons,10,10,26,38,69,-31,40,22
138,Cambridge Utd,10,8,28,38,76,-38,38,23
138,FG Rovers,7,10,29,34,85,-51,31,24
139,Sheffield Weds,30,11,5,84,30,54,101,1
139,Plymouth Argyle,29,11,6,92,48,44,98,2
139,Ipswich Town,25,17,4,84,40,44,92,3
139,Derby County,23,12,11,75,42,33,81,4
139,Barnsley,24,9,13,74,43,31,81,5
139,Bolton,23,11,12,70,38,32,80,6
139,Portsmouth,22,14,10,67,46,21,80,7
139,Shrewsbury,20,11,15,56,45,11,71,8
139,Wycombe,21,7,18,57,53,4,70,9
139,P'borough Utd,20,7,19,74,61,13,67,10
139,Fleetwood Town,15,18,13,50,42,8,63,11
139,Exeter City,16,14,16,62,54,8,62,12
139,Lincoln City,11,24,11,42,46,-4,57,13
139,Charlton Ath,14,14,18,63,68,-5,56,14
139,Bristol Rovers,15,11,20,68,78,-10,56,15
139,Port Vale,15,10,21,53,72,-19,55,16
139,Acc'ton Stanley,12,15,19,44,72,-28,51,17
139,Burton Albion,12,12,22,54,89,-35,48,18
139,Oxford United,12,11,23,46,65,-19,47,19
139,Morecambe,10,14,22,51,80,-29,44,20
139,Cheltenham,12,7,27,32,59,-27,43,21
139,MK Dons,11,10,25,42,74,-32,43,22
139,Cambridge Utd,11,8,27,38,75,-37,41,23
139,FG Rovers,5,10,31,28,86,-58,25,24
140,Plymouth Argyle,29,12,5,85,44,41,99,1
140,Sheffield Weds,26,14,6,77,34,43,92,2
140,Ipswich Town,24,15,7,81,42,39,87,3
140,Derby County,23,12,11,74,45,29,81,4
140,P'borough Utd,24,7,15,73,52,21,79,5
140,Barnsley,23,9,14,60,39,21,78,6
140,Bolton,22,11,13,66,37,29,77,7
140,Portsmouth,20,14,12,66,46,20,74,8
140,Wycombe,21,9,16,59,49,10,72,9
140,Fleetwood Town,17,15,14,49,41,8,66,10
140,Charlton Ath,17,14,15,63,58,5,65,11
140,Shrewsbury,17,11,18,50,49,1,62,12
140,Lincoln City,11,23,12,40,44,-4,56,13
140,Exeter City,14,13,19,53,56,-3,55,14
140,Port Vale,15,9,22,49,65,-16,54,15
140,MK Dons,15,7,24,43,67,-24,52,16
140,Acc'ton Stanley,13,13,20,41,66,-25,52,17
140,Oxford United,13,12,21,48,54,-6,51,18
140,Cheltenham,14,8,24,37,57,-20,50,19
140,Burton Albion,13,10,23,61,89,-28,49,20
140,Bristol Rovers,13,10,23,58,87,-29,49,21
140,Cambridge Utd,11,9,26,40,73,-33,42,22
140,Morecambe,10,11,25,42,75,-33,41,23
140,FG Rovers,8,10,28,32,78,-46,34,24
141,Sheffield Weds,29,12,5,84,32,52,99,1
141,Plymouth Argyle,25,15,6,84,48,36,90,2
141,Ipswich Town,25,14,7,84,44,40,89,3
141,Bolton,25,11,10,65,37,28,86,4
141,Derby County,24,11,11,79,45,34,83,5
141,Barnsley,24,8,14,66,45,21,80,6
141,Wycombe,24,6,16,68,45,23,78,7
141,P'borough Utd,23,7,16,83,58,25,76,8
141,Shrewsbury,23,6,17,58,52,6,75,9
141,Portsmouth,19,14,13,64,50,14,71,10
141,Charlton Ath,18,15,13,70,54,16,69,11
141,Fleetwood Town,15,15,16,47,44,3,60,12
141,Lincoln City,14,18,14,50,51,-1,60,13
141,Port Vale,14,12,20,50,63,-13,54,14
141,Bristol Rovers,14,12,20,65,81,-16,54,15
141,Exeter City,13,13,20,58,75,-17,52,16
141,Oxford United,12,13,21,52,62,-10,49,17
141,Cheltenham,12,11,23,35,62,-27,47,18
141,Burton Albion,11,13,22,58,86,-28,46,19
141,Acc'ton Stanley,10,16,20,37,65,-28,46,20
141,Cambridge Utd,11,8,27,34,73,-39,41,21
141,MK Dons,10,9,27,42,71,-29,39,22
141,Morecambe,8,14,24,39,76,-37,38,23
141,FG Rovers,7,11,28,34,87,-53,32,24
142,Sheffield Weds,31,10,5,89,30,59,103,1
142,Plymouth Argyle,31,8,7,88,45,43,101,2
142,Derby County,26,12,8,75,38,37,90,3
142,Ipswich Town,24,15,7,85,44,41,87,4
142,Barnsley,26,8,12,72,41,31,86,5
142,Bolton,25,9,12,63,33,30,84,6
142,Wycombe,23,9,14,58,39,19,78,7
142,Portsmouth,19,16,11,65,48,17,73,8
142,P'borough Utd,21,4,21,77,58,19,67,9
142,Lincoln City,15,21,10,49,50,-1,66,10
142,Exeter City,17,9,20,59,59,0,60,11
142,Shrewsbury,17,9,20,51,55,-4,60,12
142,Cheltenham,16,10,20,37,56,-19,58,13
142,Fleetwood Town,14,15,17,45,45,0,57,14
142,Charlton Ath,13,16,17,59,61,-2,55,15
142,Port Vale,14,11,21,47,64,-17,53,16
142,Burton Albion,13,12,21,54,86,-32,51,17
142,Bristol Rovers,13,11,22,56,83,-27,50,18
142,Oxford United,11,14,21,45,56,-11,47,19
142,Morecambe,10,13,23,47,73,-26,43,20
142,Acc'ton Stanley,10,12,24,37,74,-37,42,21
142,MK Dons,9,12,25,36,64,-28,39,22
142,Cambridge Utd,10,8,28,34,74,-40,38,23
142,FG Rovers,7,10,29,35,87,-52,31,24
143,Sheffield Weds,31,12,3,87,30,57,105,1
143,Plymouth Argyle,30,10,6,93,47,46,100,2
143,Derby County,26,10,10,77,40,37,88,3
143,Bolton,25,9,12,65,34,31,84,4
143,Ipswich Town,22,16,8,72,41,31,82,5
143,Barnsley,22,11,13,71,50,21,77,6
143,P'borough Utd,23,5,18,74,59,15,74,7
143,Wycombe,21,10,15,61,43,18,73,8
143,Charlton Ath,18,15,13,72,56,16,69,9
143,Portsmouth,18,14,14,62,57,5,68,10
143,Shrewsbury,18,10,18,56,54,2,64,11
143,Fleetwood Town,16,15,15,46,41,5,63,12
143,Lincoln City,11,23,12,42,44,-2,56,13
143,Bristol Rovers,14,12,20,58,72,-14,54,14
143,Exeter City,14,11,21,59,62,-3,53,15
143,Oxford United,14,11,21,50,57,-7,53,16
143,Port Vale,14,10,22,44,69,-25,52,17
143,Burton Albion,13,12,21,61,85,-24,51,18
143,Cheltenham,11,12,23,31,62,-31,45,19
143,MK Dons,11,10,25,41,67,-26,43,20
143,Acc'ton Stanley,10,12,24,40,72,-32,42,21
143,Cambridge Utd,11,9,26,35,70,-35,42,22
143,Morecambe,8,16,22,42,72,-30,40,23
143,FG Rovers,9,9,28,33,88,-55,36,24
144,Sheffield Weds,29,12,5,80,32,48,99,1
144,Ipswich Town,28,12,6,104,47,57,96,2
144,Barnsley,28,8,10,83,41,42,92,3
144,Plymouth Argyle,26,12,8,85,52,33,90,4
144,Derby County,24,14,8,72,40,32,86,5
144,Bolton,24,11,11,63,34,29,83,6
144,Wycombe,23,6,17,63,46,17,75,7
144,P'borough Utd,23,4,19,78,63,15,73,8
144,Portsmouth,17,17,12,60,50,10,68,9
144,Shrewsbury,19,8,19,57,61,-4,65,10
144,Fleetwood Town,16,16,14,48,42,6,64,11
144,Charlton Ath,14,14,18,60,59,1,56,12
144,Lincoln City,12,20,14,46,51,-5,56,13
144,Bristol Rovers,15,10,21,59,73,-14,55,14
144,Port Vale,15,9,22,48,69,-21,54,15
144,Exeter City,13,13,20,53,63,-10,52,16
144,Oxford United,13,12,21,47,59,-12,51,17
144,Acc'ton Stanley,12,13,21,40,67,-27,49,18
144,Cheltenham,13,10,23,36,63,-27,49,19
144,Burton Albion,11,12,23,56,91,-35,45,20
144,MK Dons,12,8,26,46,75,-29,44,21
144,Cambridge Utd,11,9,26,37,72,-35,42,22
144,Morecambe,8,17,21,43,69,-26,41,23
144,FG Rovers,7,11,28,31,76,-45,32,24
145,Sheffield Weds,34,8,4,86,27,59,110,1
145,Plymouth Argyle,28,11,7,90,54,36,95,2
145,Derby County,26,11,9,80,41,39,89,3
145,Ipswich Town,24,15,7,82,44,38,87,4
145,Bolton,24,10,12,71,36,35,82,5
145,Barnsley,22,12,12,69,41,28,78,6
145,Wycombe,22,11,13,65,43,22,77,7
145,P'borough Utd,23,7,16,78,55,23,76,8
145,Shrewsbury,19,9,18,58,55,3,66,9
145,Portsmouth,15,18,13,61,55,6,63,10
145,Fleetwood Town,16,14,16,51,47,4,62,11
145,Lincoln City,12,23,11,40,43,-3,59,12
145,Bristol Rovers,16,9,21,63,74,-11,57,13
145,Charlton Ath,13,17,16,55,55,0,56,14
145,Port Vale,15,10,21,46,63,-17,55,15
145,Exeter City,14,12,20,59,67,-8,54,16
145,Oxford United,13,13,20,47,58,-11,52,17
145,Cheltenham,13,9,24,37,60,-23,48,18
145,Acc'ton Stanley,11,14,21,38,76,-38,47,19
145,Cambridge Utd,12,9,25,41,72,-31,45,20
145,Morecambe,10,14,22,42,69,-27,44,21
145,Burton Albion,11,9,26,53,95,-42,42,22
145,MK Dons,10,10,26,38,65,-27,40,23
145,FG Rovers,6,11,29,36,91,-55,29,24
146,Sheffield Weds,32,11,3,86,27,59,107,1
146,Plymouth Argyle,29,9,8,90,47,43,96,2
146,Ipswich Town,25,13,8,84,47,37,88,3
146,Bolton,24,12,10,67,34,33,84,4
146,Derby County,23,14,9,78,44,34,83,5
146,Portsmouth,23,14,9,81,51,30,83,6
146,Barnsley,24,7,15,68,46,22,79,7
146,Wycombe,22,9,15,65,46,19,75,8
146,P'borough Utd,23,4,19,73,59,14,73,9
146,Lincoln City,16,21,9,48,41,7,69,10
146,Fleetwood Town,18,12,16,52,46,6,66,11
146,Charlton Ath,16,16,14,66,59,7,64,12
146,Shrewsbury,17,10,19,52,58,-6,61,13
146,Exeter City,15,10,21,57,62,-5,55,14
146,Port Vale,15,9,22,49,66,-17,54,15
146,Acc'ton Stanley,14,12,20,51,69,-18,54,16
146,Bristol Rovers,13,11,22,67,85,-18,50,17
146,Oxford United,11,13,22,47,67,-20,46,18
146,Burton Albion,11,12,23,52,87,-35,45,19
146,Morecambe,9,15,22,49,80,-31,42,20
146,MK Dons,11,7,28,42,75,-33,40,21
146,Cheltenham,10,9,27,37,66,-29,39,22
146,Cambridge Utd,10,8,28,40,79,-39,38,23
146,FG Rovers,6,12,28,35,95,-60,30,24
147,Sheffield Weds,31,11,4,80,30,50,104,1
147,Plymouth Argyle,29,9,8,88,50,38,96,2
147,Barnsley,27,7,12,78,47,31,88,3
147,Ipswich Town,23,14,9,81,45,36,83,4
147,Wycombe,24,8,14,69,44,25,80,5
147,Derby County,21,16,9,67,42,25,79,6
147,Bolton,22,11,13,61,38,23,77,7
147,P'borough Utd,23,4,19,74,61,13,73,8
147,Portsmouth,18,17,11,71,53,18,71,9
147,Fleetwood Town,16,19,11,51,41,10,67,10
147,Shrewsbury,19,9,18,57,49,8,66,11
147,Lincoln City,15,21,10,48,46,2,66,12
147,Exeter City,15,13,18,66,63,3,58,13
147,Charlton Ath,14,15,17,60,59,1,57,14
147,Burton Albion,15,12,19,59,74,-15,57,15
147,Port Vale,15,9,22,50,68,-18,54,16
147,Bristol Rovers,13,11,22,59,80,-21,50,17
147,Oxford United,11,14,21,44,56,-12,47,18
147,Cheltenham,11,11,24,35,61,-26,44,19
147,MK Dons,11,11,24,39,66,-27,44,20
147,Morecambe,10,13,23,45,79,-34,43,21
147,Acc'ton Stanley,9,13,24,38,72,-34,40,22
147,Cambridge Utd,9,10,27,35,74,-39,37,23
147,FG Rovers,6,12,28,30,87,-57,30,24
148,Barnsley,32,6,8,81,37,44,102,1
148,Sheffield Weds,27,12,7,76,34,42,93,2
148,Plymouth Argyle,27,9,10,88,61,27,90,3
148,Ipswich Town,24,15,7,81,43,38,87,4
148,Bolton,24,11,11,66,37,29,83,5
148,Wycombe,24,9,13,66,42,24,81,6
148,Derby County,22,14,10,78,44,34,80,7
148,P'borough Utd,23,5,18,77,58,19,74,8
148,Portsmouth,19,15,12,66,50,16,72,9
148,Shrewsbury,20,9,17,55,50,5,69,10
148,Fleetwood Town,15,18,13,51,44,7,63,11
148,Bristol Rovers,16,12,18,64,74,-10,60,12
148,Lincoln City,12,18,16,40,49,-9,54,13
148,Charlton Ath,12,17,17,58,64,-6,53,14
148,Exeter City,12,15,19,54,58,-4,51,15
148,Oxford United,13,12,21,52,66,-14,51,16
148,Morecambe,13,12,21,49,70,-21,51,17
148,Port Vale,13,11,22,46,71,-25,50,18
148,MK Dons,13,10,23,49,66,-17,49,19
148,Acc'ton Stanley,9,18,19,39,64,-25,45,20
148,Burton Albion,11,12,23,55,85,-30,45,21
148,Cheltenham,12,8,26,36,65,-29,44,22
148,Cambridge Utd,8,9,29,33,81,-48,33,23
148,FG Rovers,6,13,27,31,78,-47,31,24
149,Sheffield Weds,31,12,3,92,28,64,105,1
149,Barnsley,30,5,11,80,42,38,95,2
149,Ipswich Town,25,13,8,87,53,34,88,3
149,Plymouth Argyle,26,10,10,79,51,28,88,4
149,Bolton,25,10,11,71,36,35,85,5
149,Derby County,23,12,11,70,39,31,81,6
149,P'borough Utd,25,5,16,75,50,25,80,7
149,Wycombe,21,11,14,62,45,17,74,8
149,Charlton Ath,19,14,13,76,56,20,71,9
149,Portsmouth,18,15,13,61,49,12,69,10
149,Fleetwood Town,18,15,13,49,43,6,69,11
149,Shrewsbury,18,8,20,57,54,3,62,12
149,Exeter City,14,15,17,57,61,-4,57,13
149,Port Vale,16,8,22,46,61,-15,56,14
149,Lincoln City,11,21,14,40,49,-9,54,15
149,Oxford United,13,12,21,45,55,-10,51,16
149,Burton Albion,11,12,23,55,89,-34,45,17
149,Bristol Rovers,11,11,24,56,91,-35,44,18
149,Cambridge Utd,12,8,26,38,73,-35,44,19
149,MK Dons,11,10,25,42,66,-24,43,20
149,Morecambe,10,13,23,45,75,-30,43,21
149,Cheltenham,10,10,26,31,64,-33,40,22
149,Acc'ton Stanley,9,12,25,38,78,-40,39,23
149,FG Rovers,9,10,27,38,82,-44,37,24
150,Sheffield Weds,28,11,7,78,36,42,95,1
150,Plymouth Argyle,28,9,9,81,50,31,93,2
150,Barnsley,28,6,12,87,48,39,90,3
150,Ipswich Town,24,15,7,83,43,40,87,4
150,Derby County,24,10,12,70,41,29,82,5
150,Wycombe,24,8,14,69,41,28,80,6
150,Bolton,23,11,12,68,40,28,80,7
150,P'borough Utd,24,7,15,78,53,25,79,8
150,Portsmouth,18,14,14,63,52,11,68,9
150,Fleetwood Town,18,13,15,53,46,7,67,10
150,Shrewsbury,19,10,17,52,49,3,67,11
150,Lincoln City,13,23,10,44,42,2,62,12
150,Exeter City,14,15,17,58,59,-1,57,13
150,Bristol Rovers,15,12,19,63,78,-15,57,14
150,Port Vale,15,11,20,52,70,-18,56,15
150,Charlton Ath,13,16,17,58,63,-5,55,16
150,Burton Albion,14,11,21,57,83,-26,53,17
150,Cheltenham,13,13,20,35,53,-18,52,18
150,Oxford United,12,12,22,46,63,-17,48,19
150,MK Dons,11,9,26,42,74,-32,42,20
150,Acc'ton Stanley,10,12,24,39,71,-32,42,21
150,Morecambe,9,11,26,44,78,-34,38,22
150,Cambridge Utd,9,9,28,37,76,-39,36,23
150,FG Rovers,7,10,29,35,83,-48,31,24
151,Plymouth Argyle,30,11,5,92,46,46,101,1
151,Sheffield Weds,28,12,6,79,35,44,96,2
151,Barnsley,27,8,11,79,46,33,89,3
151,Derby County,25,13,8,79,42,37,88,4
151,Ipswich Town,24,14,8,81,42,39,86,5
151,Bolton,25,10,11,71,37,34,85,6
151,Wycombe,23,10,13,70,46,24,79,7
151,P'borough Utd,22,6,18,80,61,19,72,8
151,Portsmouth,18,17,11,61,50,11,71,9
151,Shrewsbury,18,11,17,48,48,0,65,10
151,Charlton Ath,17,11,18,65,62,3,62,11
151,Fleetwood Town,14,16,16,46,50,-4,58,12
151,Lincoln City,11,23,12,43,50,-7,56,13
151,Exeter City,15,9,22,58,68,-10,54,14
151,Burton Albion,14,12,20,57,80,-23,54,15
151,Port Vale,14,9,23,42,63,-21,51,16
151,Oxford United,13,11,22,47,58,-11,50,17
151,MK Dons,12,13,21,47,62,-15,49,18
151,Bristol Rovers,12,13,21,61,80,-19,49,19
151,Morecambe,12,12,22,44,71,-27,48,20
151,Acc'ton Stanley,11,14,21,35,63,-28,47,21
151,Cheltenham,9,9,28,30,66,-36,36,22
151,Cambridge Utd,9,9,28,35,76,-41,36,23
151,FG Rovers,6,13,27,32,80,-48,31,24
152,Sheffield Weds,30,10,6,84,33,51,100,1
152,Plymouth Argyle,28,10,8,85,49,36,94,2
152,Ipswich Town,25,16,5,84,43,41,91,3
152,Bolton,26,9,11,68,36,32,87,4
152,Derby County,23,15,8,78,46,32,84,5
152,Wycombe,23,9,14,61,38,23,78,6
152,Barnsley,22,12,12,61,41,20,78,7
152,P'borough Utd,21,8,17,79,58,21,71,8
152,Portsmouth,18,17,11,65,51,14,71,9
152,Shrewsbury,18,10,18,54,53,1,64,10
152,Exeter City,16,12,18,56,55,1,60,11
152,Port Vale,17,9,20,48,64,-16,60,12
152,Fleetwood Town,14,17,15,53,48,5,59,13
152,Charlton Ath,15,14,17,60,58,2,59,14
152,Lincoln City,11,25,10,45,44,1,58,15
152,Bristol Rovers,15,9,22,61,79,-18,54,16
152,Cheltenham,14,9,23,40,65,-25,51,17
152,Oxford United,11,14,21,44,63,-19,47,18
152,Acc'ton Stanley,11,13,22,39,67,-28,46,19
152,MK Dons,12,9,25,47,75,-28,45,20
152,Burton Albion,10,11,25,58,91,-33,41,21
152,Cambridge Utd,11,8,27,39,76,-37,41,22
152,Morecambe,8,15,23,41,71,-30,39,23
152,FG Rovers,8,9,29,37,83,-46,33,24
153,Sheffield Weds,32,10,4,85,31,54,106,1
153,Plymouth Argyle,28,11,7,84,48,36,95,2
153,Barnsley,28,5,13,72,41,31,89,3
153,Ipswich Town,24,14,8,83,42,41,86,4
153,Bolton,23,10,13,64,38,26,79,5
153,Wycombe,22,11,13,63,41,22,77,6
153,Portsmouth,21,14,11,68,50,18,77,7
153,Derby County,22,10,14,71,46,25,76,8
153,P'borough Utd,22,8,16,74,52,22,74,9
153,Shrewsbury,19,11,16,58,51,7,68,10
153,Lincoln City,15,20,11,45,40,5,65,11
153,Fleetwood Town,16,16,14,50,48,2,64,12
153,Charlton Ath,14,18,14,60,58,2,60,13
153,Exeter City,15,13,18,56,57,-1,58,14
153,Port Vale,14,12,20,47,62,-15,54,15
153,Bristol Rovers,14,11,21,62,82,-20,53,16
153,Oxford United,13,10,23,43,59,-16,49,17
153,MK Dons,12,10,24,43,68,-25,46,18
153,Acc'ton Stanley,11,13,22,37,75,-38,46,19
153,Burton Albion,11,11,24,58,87,-29,44,20
153,Morecambe,9,16,21,41,66,-25,43,21
153,Cheltenham,11,8,27,31,63,-32,41,22
153,Cambridge Utd,9,10,27,37,76,-39,37,23
153,FG Rovers,5,12,29,36,87,-51,27,24
154,Sheffield Weds,32,9,5,97,34,63,105,1
154,Barnsley,30,7,9,83,42,41,97,2
154,Bolton,27,10,9,78,33,45,91,3
154,Plymouth Argyle,25,10,11,80,53,27,85,4
154,Ipswich Town,23,14,9,77,48,29,83,5
154,Wycombe,24,9,13,69,47,22,81,6
154,Derby County,21,15,10,67,41,26,78,7
154,P'borough Utd,21,9,16,71,57,14,72,8
154,Shrewsbury,20,11,15,58,45,13,71,9
154,Lincoln City,15,20,11,45,43,2,65,10
154,Portsmouth,15,19,12,65,54,11,64,11
154,Charlton Ath,17,12,17,66,62,4,63,12
154,Port Vale,18,9,19,52,61,-9,63,13
154,Fleetwood Town,14,16,16,47,49,-2,58,14
154,Exeter City,14,13,19,56,56,0,55,15
154,Acc'ton Stanley,12,13,21,39,70,-31,49,16
154,Burton Albion,12,11,23,52,82,-30,47,17
154,Oxford United,11,12,23,44,61,-17,45,18
154,Bristol Rovers,12,9,25,59,90,-31,45,19
154,Morecambe,10,14,22,48,77,-29,44,20
154,Cheltenham,10,12,24,34,64,-30,42,21
154,MK Dons,10,10,26,46,77,-31,40,22
154,Cambridge Utd,10,9,27,36,72,-36,39,23
154,FG Rovers,7,11,28,31,82,-51,32,24
155,Sheffield Weds,33,8,5,94,34,60,107,1
155,Plymouth Argyle,30,9,7,93,49,44,99,2
155,Wycombe,28,7,11,69,34,35,91,3
155,Ipswich Town,25,14,7,78,39,39,89,4
155,Bolton,26,8,12,62,34,28,86,5
155,Barnsley,25,10,11,70,41,29,85,6
155,Derby County,20,17,9,69,43,26,77,7
155,Portsmouth,21,14,11,65,52,13,77,8
155,P'borough Utd,21,9,16,78,60,18,72,9
155,Fleetwood Town,17,14,15,51,45,6,65,10
155,Shrewsbury,18,11,17,55,54,1,65,11
155,Lincoln City,14,20,12,48,48,0,62,12
155,Charlton Ath,15,13,18,60,61,-1,58,13
155,Port Vale,16,8,22,48,65,-17,56,14
155,Exeter City,14,13,19,65,65,0,55,15
155,Bristol Rovers,13,12,21,60,80,-20,51,16
155,Oxford United,12,12,22,50,62,-12,48,17
155,Cheltenham,13,8,25,36,62,-26,47,18
155,MK Dons,12,9,25,49,69,-20,45,19
155,Acc'ton Stanley,10,12,24,31,69,-38,42,20
155,Burton Albion,10,10,26,46,85,-39,40,21
155,Morecambe,9,11,26,43,77,-34,38,22
155,Cambridge Utd,10,8,28,34,73,-39,38,23
155,FG Rovers,6,11,29,31,84,-53,29,24
156,Sheffield Weds,29,12,5,84,40,44,99,1
156,Ipswich Town,26,16,4,84,42,42,94,2
156,Plymouth Argyle,26,11,9,77,49,28,89,3
156,Bolton,25,11,10,69,36,33,86,4
156,Wycombe,26,8,12,64,38,26,86,5
156,Derby County,22,16,8,76,46,30,82,6
156,Barnsley,24,10,12,71,44,27,82,7
156,P'borough Utd,23,5,18,84,61,23,74,8
156,Portsmouth,18,15,13,65,53,12,69,9
156,Charlton Ath,17,13,16,74,63,11,64,10
156,Lincoln City,14,22,10,54,46,8,64,11
156,Shrewsbury,19,7,20,58,54,4,64,12
156,Bristol Rovers,17,9,20,67,74,-7,60,13
156,Exeter City,15,14,17,59,56,3,59,14
156,Fleetwood Town,14,16,16,46,45,1,58,15
156,Port Vale,15,10,21,45,64,-19,55,16
156,Cheltenham,14,10,22,40,56,-16,52,17
156,Oxford United,12,11,23,48,63,-15,47,18
156,Burton Albion,12,11,23,58,87,-29,47,19
156,MK Dons,11,10,25,45,71,-26,43,20
156,Acc'ton Stanley,10,13,23,34,68,-34,43,21
156,Morecambe,9,12,25,44,77,-33,39,22
156,Cambridge Utd,9,6,31,29,82,-53,33,23
156,FG Rovers,7,8,31,35,95,-60,29,24
157,Sheffield Weds,30,10,6,93,33,60,100,1
157,Ipswich Town,24,16,6,87,39,48,88,2
157,Plymouth Argyle,25,12,9,76,49,27,87,3
157,Derby County,23,13,10,75,44,31,82,4
157,Barnsley,24,9,13,77,47,30,81,5
157,Portsmouth,20,18,8,68,46,22,78,6
157,Bolton,22,10,14,63,42,21,76,7
157,Wycombe,22,7,17,70,49,21,73,8
157,P'borough Utd,23,4,19,75,60,15,73,9
157,Shrewsbury,20,9,17,57,51,6,69,10
157,Exeter City,19,11,16,63,58,5,68,11
157,Fleetwood Town,15,18,13,53,43,10,63,12
157,Bristol Rovers,17,11,18,72,79,-7,62,13
157,Charlton Ath,14,15,17,64,63,1,57,14
157,Lincoln City,11,22,13,41,51,-10,55,15
157,Port Vale,13,14,19,44,61,-17,53,16
157,Cheltenham,14,8,24,41,62,-21,50,17
157,Oxford United,12,13,21,51,59,-8,49,18
157,Cambridge Utd,12,9,25,39,74,-35,45,19
157,Morecambe,10,13,23,50,80,-30,43,20
157,Acc'ton Stanley,9,15,22,35,80,-45,42,21
157,MK Dons,10,11,25,38,68,-30,41,22
157,Burton Albion,9,14,23,48,90,-42,41,23
157,FG Rovers,8,10,28,41,93,-52,34,24
158,Sheffield Weds,32,8,6,88,29,59,104,1
158,Plymouth Argyle,29,11,6,89,44,45,98,2
158,Ipswich Town,25,13,8,90,50,40,88,3
158,Barnsley,26,9,11,69,45,24,87,4
158,Derby County,23,13,10,75,44,31,82,5
158,P'borough Utd,23,8,15,78,58,20,77,6
158,Bolton,21,12,13,65,41,24,75,7
158,Wycombe,21,10,15,67,47,20,73,8
158,Portsmouth,18,18,10,58,44,14,72,9
158,Shrewsbury,20,9,17,56,55,1,69,10
158,Lincoln City,14,19,13,50,49,1,61,11
158,Fleetwood Town,14,18,14,45,41,4,60,12
158,Exeter City,15,13,18,60,57,3,58,13
158,Charlton Ath,14,15,17,61,59,2,57,14
158,Oxford United,13,15,18,53,57,-4,54,15
158,Bristol Rovers,13,15,18,59,72,-13,54,16
158,Port Vale,15,7,24,44,63,-19,52,17
158,Burton Albion,12,11,23,52,85,-33,47,18
158,Cheltenham,12,10,24,35,68,-33,46,19
158,Acc'ton Stanley,8,17,21,37,66,-29,41,20
158,Cambridge Utd,11,8,27,38,79,-41,41,21
158,Morecambe,8,16,22,39,76,-37,40,22
158,MK Dons,10,9,27,35,66,-31,39,23
158,FG Rovers,6,14,26,36,84,-48,32,24
159,Sheffield Weds,31,9,6,89,27,62,102,1
159,Plymouth Argyle,29,9,8,96,50,46,96,2
159,Ipswich Town,25,16,5,88,42,46,91,3
159,Bolton,24,10,12,68,37,31,82,4
159,Barnsley,23,11,12,77,48,29,80,5
159,Derby County,21,12,13,68,42,26,75,6
159,Wycombe,22,8,16,63,41,22,74,7
159,Portsmouth,19,16,11,63,46,17,73,8
159,Shrewsbury,21,10,15,58,46,12,73,9
159,P'borough Utd,20,11,15,70,57,13,71,10
159,Fleetwood Town,17,17,12,53,41,12,68,11
159,Charlton Ath,16,15,15,64,59,5,63,12
159,Exeter City,16,12,18,57,61,-4,60,13
159,Lincoln City,11,22,13,38,45,-7,55,14
159,Bristol Rovers,14,12,20,58,77,-19,54,15
159,Port Vale,14,11,21,48,67,-19,53,16
159,Burton Albion,14,10,22,56,83,-27,52,17
159,Oxford United,11,16,19,47,61,-14,49,18
159,Acc'ton Stanley,12,13,21,38,71,-33,49,19
159,Cheltenham,13,6,27,40,74,-34,45,20
159,Morecambe,10,13,23,39,71,-32,43,21
159,MK Dons,10,9,27,36,71,-35,39,22
159,Cambridge Utd,10,9,27,32,68,-36,39,23
159,FG Rovers,6,9,31,31,92,-61,27,24
160,Sheffield Weds,29,14,3,88,31,57,101,1
160,Plymouth Argyle,28,9,9,86,50,36,93,2
160,Derby County,26,10,10,75,40,35,88,3
160,Ipswich Town,23,15,8,79,40,39,84,4
160,Barnsley,23,13,10,68,40,28,82,5
160,Bolton,22,13,11,64,36,28,79,6
160,Wycombe,23,9,14,63,38,25,78,7
160,Portsmouth,21,14,11,65,46,19,77,8
160,Shrewsbury,22,10,14,54,45,9,76,9
160,P'borough Utd,21,6,19,74,60,14,69,10
160,Fleetwood Town,17,15,14,52,45,7,66,11
160,Charlton Ath,15,14,17,66,62,4,59,12
160,Lincoln City,13,18,15,45,52,-7,57,13
160,Exeter City,15,11,20,57,66,-9,56,14
160,Port Vale,16,8,22,47,64,-17,56,15
160,Burton Albion,14,11,21,66,86,-20,53,16
160,Oxford United,13,10,23,44,61,-17,49,17
160,Cheltenham,13,10,23,39,70,-31,49,18
160,Cambridge Utd,13,9,24,37,67,-30,48,19
160,Morecambe,11,13,22,48,72,-24,46,20
160,Bristol Rovers,11,12,23,54,76,-22,45,21
160,MK Dons,11,8,27,45,71,-26,41,22
160,Acc'ton Stanley,9,13,24,40,77,-37,40,23
160,FG Rovers,5,11,30,34,95,-61,26,24
161,Sheffield Weds,29,10,7,82,36,46,97,1
161,Derby County,26,12,8,75,36,39,90,2
161,Plymouth Argyle,26,12,8,85,51,34,90,3
161,Barnsley,27,7,12,74,38,36,88,4
161,Ipswich Town,23,18,5,81,42,39,87,5
161,Wycombe,23,10,13,70,41,29,79,6
161,Bolton,23,10,13,65,40,25,79,7
161,Portsmouth,20,14,12,64,51,13,74,8
161,P'borough Utd,22,7,17,72,59,13,73,9
161,Shrewsbury,21,7,18,55,48,7,70,10
161,Fleetwood Town,17,15,14,56,44,12,66,11
161,Exeter City,17,10,19,60,62,-2,61,12
161,Charlton Ath,14,16,16,58,59,-1,58,13
161,Lincoln City,11,22,13,39,46,-7,55,14
161,Port Vale,14,13,19,44,61,-17,55,15
161,Bristol Rovers,14,12,20,66,81,-15,54,16
161,Oxford United,13,12,21,48,55,-7,51,17
161,Cheltenham,14,9,23,39,60,-21,51,18
161,Burton Albion,12,10,24,53,93,-40,46,19
161,MK Dons,11,12,23,46,66,-20,45,20
161,Morecambe,9,13,24,38,68,-30,40,21
161,Acc'ton Stanley,8,12,26,31,75,-44,36,22
161,Cambridge Utd,10,6,30,31,77,-46,36,23
161,FG Rovers,7,13,26,37,80,-43,34,24
162,Sheffield Weds,30,11,5,87,32,55,101,1
162,Plymouth Argyle,30,10,6,91,53,38,100,2
162,Ipswich Town,24,17,5,86,38,48,89,3
162,Barnsley,25,8,13,72,50,22,83,4
162,Wycombe,22,11,13,66,40,26,77,5
162,Portsmouth,21,14,11,69,49,20,77,6
162,Derby County,22,10,14,66,45,21,76,7
162,Bolton,21,12,13,65,39,26,75,8
162,Shrewsbury,22,7,17,59,48,11,73,9
162,P'borough Utd,22,5,19,76,64,12,71,10
162,Charlton Ath,17,12,17,64,59,5,63,11
162,Fleetwood Town,14,19,13,44,41,3,61,12
162,Exeter City,15,14,17,56,63,-7,59,13
162,Lincoln City,12,22,12,43,48,-5,58,14
162,Oxford United,14,13,19,49,53,-4,55,15
162,Port Vale,15,10,21,46,62,-16,55,16
162,Bristol Rovers,14,11,21,62,81,-19,53,17
162,Burton Albion,12,10,24,52,85,-33,46,18
162,Morecambe,10,15,21,44,64,-20,45,19
162,Cheltenham,11,12,23,35,62,-27,45,20
162,MK Dons,11,9,26,43,71,-28,42,21
162,Cambridge Utd,12,5,29,35,72,-37,41,22
162,Acc'ton Stanley,9,13,24,36,76,-40,40,23
162,FG Rovers,6,12,28,32,83,-51,30,24
163,Sheffield Weds,28,10,8,89,32,57,94,1
163,Ipswich Town,25,16,5,90,41,49,91,2
163,Plymouth Argyle,25,12,9,78,52,26,87,3
163,Derby County,25,11,10,74,39,35,86,4
163,Bolton,24,11,11,65,34,31,83,5
163,P'borough Utd,25,7,14,79,53,26,82,6
163,Wycombe,23,11,12,64,37,27,80,7
163,Portsmouth,20,17,9,63,44,19,77,8
163,Barnsley,22,11,13,61,44,17,77,9
163,Charlton Ath,18,12,16,73,62,11,66,10
163,Shrewsbury,18,9,19,51,54,-3,63,11
163,Fleetwood Town,14,16,16,44,44,0,58,12
163,Exeter City,15,11,20,62,70,-8,56,13
163,Lincoln City,10,23,13,42,53,-11,53,14
163,Oxford United,14,10,22,54,62,-8,52,15
163,Bristol Rovers,13,13,20,61,79,-18,52,16
163,Cheltenham,14,9,23,33,57,-24,51,17
163,Port Vale,13,11,22,44,70,-26,50,18
163,Burton Albion,11,13,22,55,83,-28,46,19
163,MK Dons,10,13,23,43,68,-25,43,20
163,Acc'ton Stanley,10,12,24,40,77,-37,42,21
163,Morecambe,9,14,23,45,78,-33,41,22
163,Cambridge Utd,9,12,25,37,72,-35,39,23
163,FG Rovers,8,14,24,39,81,-42,38,24
164,Sheffield Weds,28,13,5,82,31,51,97,1
164,Bolton,26,11,9,72,34,38,89,2
164,Plymouth Argyle,26,10,10,85,53,32,88,3
164,Ipswich Town,24,13,9,87,44,43,85,4
164,Barnsley,25,9,12,78,48,30,84,5
164,Portsmouth,23,15,8,73,49,24,84,6
164,P'borough Utd,26,5,15,75,52,23,83,7
164,Wycombe,23,9,14,58,41,17,78,8
164,Derby County,21,13,12,65,39,26,76,9
164,Charlton Ath,20,12,14,72,56,16,72,10
164,Bristol Rovers,18,10,18,67,68,-1,64,11
164,Fleetwood Town,16,14,16,50,48,2,62,12
164,Shrewsbury,16,14,16,51,50,1,62,13
164,Lincoln City,11,22,13,38,46,-8,55,14
164,Exeter City,13,15,18,56,62,-6,54,15
164,Port Vale,14,10,22,46,65,-19,52,16
164,Oxford United,13,12,21,43,59,-16,51,17
164,Acc'ton Stanley,12,12,22,43,72,-29,48,18
164,Burton Albion,11,13,22,52,83,-31,46,19
164,Cambridge Utd,12,8,26,41,73,-32,44,20
164,Morecambe,9,14,23,48,78,-30,41,21
164,Cheltenham,10,9,27,30,62,-32,39,22
164,MK Dons,9,8,29,38,75,-37,35,23
164,FG Rovers,6,9,31,31,93,-62,27,24
165,Sheffield Weds,30,11,5,81,30,51,101,1
165,Plymouth Argyle,30,10,6,93,49,44,100,2
165,Ipswich Town,24,17,5,93,40,53,89,3
165,Barnsley,24,12,10,67,38,29,84,4
165,Derby County,22,12,12,74,49,25,78,5
165,Bolton,22,9,15,64,43,21,75,6
165,Wycombe,21,8,17,61,48,13,71,7
165,P'borough Utd,21,7,18,75,61,14,70,8
165,Portsmouth,18,15,13,65,53,12,69,9
165,Bristol Rovers,19,9,18,66,70,-4,66,10
165,Shrewsbury,18,11,17,52,49,3,65,11
165,Fleetwood Town,16,13,17,52,50,2,61,12
165,Port Vale,17,10,19,51,66,-15,61,13
165,Charlton Ath,15,14,17,62,62,0,59,14
165,Lincoln City,13,19,14,45,50,-5,58,15
165,Exeter City,14,13,19,57,65,-8,55,16
165,Burton Albion,15,10,21,65,84,-19,55,17
165,Morecambe,12,14,20,47,67,-20,50,18
165,Cheltenham,13,9,24,37,69,-32,48,19
165,Acc'ton Stanley,12,11,23,45,78,-33,47,20
165,Cambridge Utd,13,8,25,40,74,-34,47,21
165,Oxford United,10,13,23,41,58,-17,43,22
165,MK Dons,8,14,24,37,64,-27,38,23
165,FG Rovers,5,11,30,30,83,-53,26,24
166,Sheffield Weds,28,11,7,82,32,50,95,1
166,Ipswich Town,26,15,5,90,39,51,93,2
166,Barnsley,28,9,9,74,38,36,93,3
166,Plymouth Argyle,25,11,10,83,56,27,86,4
166,Bolton,24,12,10,72,35,37,84,5
166,P'borough Utd,26,4,16,77,57,20,82,6
166,Wycombe,22,11,13,66,47,19,77,7
166,Derby County,20,15,11,70,44,26,75,8
166,Portsmouth,17,17,12,64,52,12,68,9
166,Shrewsbury,19,10,17,52,48,4,67,10
166,Charlton Ath,15,14,17,67,63,4,59,11
166,Exeter City,14,16,16,61,64,-3,58,12
166,Bristol Rovers,16,10,20,61,78,-17,58,13
166,Fleetwood Town,13,16,17,50,46,4,55,14
166,Port Vale,15,10,21,45,65,-20,55,15
166,Lincoln City,11,20,15,40,48,-8,53,16
166,MK Dons,14,8,24,44,73,-29,50,17
166,Oxford United,12,13,21,45,56,-11,49,18
166,Burton Albion,13,9,24,60,92,-32,48,19
166,Acc'ton Stanley,11,12,23,39,67,-28,45,20
166,Cambridge Utd,12,8,26,35,71,-36,44,21
166,Morecambe,10,13,23,42,71,-29,43,22
166,Cheltenham,10,11,25,31,64,-33,41,23
166,FG Rovers,9,9,28,37,81,-44,36,24
167,Sheffield Weds,30,12,4,87,33,54,102,1
167,Plymouth Argyle,26,13,7,83,46,37,91,2
167,Ipswich Town,25,14,7,87,45,42,89,3
167,Derby County,23,14,9,73,44,29,83,4
167,Bolton,24,9,13,65,40,25,81,5
167,Barnsley,24,8,14,69,47,22,80,6
167,Wycombe,22,10,14,60,38,22,76,7
167,P'borough Utd,22,7,17,77,55,22,73,8
167,Fleetwood Town,17,16,13,52,43,9,67,9
167,Shrewsbury,18,11,17,53,53,0,65,10
167,Charlton Ath,16,16,14,68,56,12,64,11
167,Portsmouth,15,19,12,63,54,9,64,12
167,Lincoln City,12,21,13,38,47,-9,57,13
167,Port Vale,16,9,21,51,62,-11,57,14
167,Oxford United,15,11,20,58,59,-1,56,15
167,Bristol Rovers,14,10,22,57,78,-21,52,16
167,Exeter City,12,13,21,57,67,-10,49,17
167,Acc'ton Stanley,12,13,21,43,75,-32,49,18
167,Burton Albion,12,12,22,54,81,-27,48,19
167,MK Dons,12,10,24,44,69,-25,46,20
167,Morecambe,11,12,23,45,69,-24,45,21
167,Cambridge Utd,12,8,26,38,75,-37,44,22
167,Cheltenham,12,6,28,34,70,-36,42,23
167,FG Rovers,8,10,28,31,81,-50,34,24
168,Sheffield Weds,33,10,3,97,31,66,109,1
168,Plymouth Argyle,27,8,11,83,54,29,89,2
168,Ipswich Town,24,16,6,79,40,39,88,3
168,Barnsley,26,9,11,77,41,36,87,4
168,Derby County,24,9,13,75,46,29,81,5
168,Bolton,22,13,11,66,37,29,79,6
168,Wycombe,21,13,12,64,41,23,76,7
168,Portsmouth,19,16,11,60,45,15,73,8
168,P'borough Utd,21,7,18,75,57,18,70,9
168,Shrewsbury,19,10,17,53,49,4,67,10
168,Lincoln City,13,24,9,47,48,-1,63,11
168,Fleetwood Town,15,17,14,51,47,4,62,12
168,Bristol Rovers,17,10,19,65,73,-8,61,13
168,Port Vale,15,11,20,44,59,-15,56,14
168,Charlton Ath,13,14,19,57,64,-7,53,15
168,Exeter City,13,14,19,58,69,-11,53,16
168,Oxford United,13,11,22,49,58,-9,50,17
168,Cheltenham,13,10,23,44,71,-27,49,18
168,Cambridge Utd,13,9,24,39,70,-31,48,19
168,MK Dons,12,10,24,42,68,-26,46,20
168,Burton Albion,12,9,25,56,94,-38,45,21
168,Morecambe,9,14,23,44,71,-27,41,22
168,Acc'ton Stanley,9,11,26,37,75,-38,38,23
168,FG Rovers,7,9,30,37,91,-54,30,24
169,Sheffield Weds,33,10,3,89,27,62,109,1
169,Ipswich Town,24,17,5,77,39,38,89,2
169,Plymouth Argyle,26,11,9,87,56,31,89,3
169,Bolton,26,8,12,71,38,33,86,4
169,Barnsley,27,5,14,71,45,26,86,5
169,Derby County,24,12,10,78,43,35,84,6
169,Wycombe,24,8,14,65,40,25,80,7
169,Portsmouth,20,14,12,64,49,15,74,8
169,P'borough Utd,22,7,17,69,54,15,73,9
169,Shrewsbury,20,7,19,50,45,5,67,10
169,Charlton Ath,17,14,15,67,56,11,65,11
169,Lincoln City,13,21,12,49,47,2,60,12
169,Exeter City,16,12,18,60,62,-2,60,13
169,Port Vale,15,11,20,47,62,-15,56,14
169,Fleetwood Town,13,16,17,49,57,-8,55,15
169,Bristol Rovers,15,8,23,60,80,-20,53,16
169,Oxford United,14,10,22,53,59,-6,52,17
169,Burton Albion,14,10,22,54,84,-30,52,18
169,Cheltenham,11,12,23,32,60,-28,45,19
169,Morecambe,11,11,24,47,77,-30,44,20
169,Acc'ton Stanley,9,14,23,34,72,-38,41,21
169,Cambridge Utd,11,7,28,37,72,-35,40,22
169,MK Dons,10,8,28,43,76,-33,38,23
169,FG Rovers,6,9,31,41,94,-53,27,24
170,Sheffield Weds,30,10,6,86,31,55,100,1
170,Plymouth Argyle,29,11,6,93,47,46,98,2
170,Barnsley,27,8,11,76,44,32,89,3
170,Derby County,23,13,10,77,40,37,82,4
170,Wycombe,24,10,12,63,38,25,82,5
170,Bolton,22,15,9,65,38,27,81,6
170,Ipswich Town,22,13,11,82,49,33,79,7
170,Portsmouth,20,15,11,68,53,15,75,8
170,P'borough Utd,23,5,18,75,57,18,74,9
170,Shrewsbury,19,9,18,53,52,1,66,10
170,Fleetwood Town,15,16,15,50,47,3,61,11
170,Charlton Ath,15,14,17,64,67,-3,59,12
170,Exeter City,16,10,20,61,65,-4,58,13
170,Lincoln City,12,22,12,41,45,-4,58,14
170,Port Vale,16,10,20,49,62,-13,58,15
170,Bristol Rovers,16,8,22,66,89,-23,56,16
170,Oxford United,12,15,19,50,59,-9,51,17
170,Cheltenham,13,11,22,33,55,-22,50,18
170,Burton Albion,11,11,24,54,93,-39,44,19
170,Morecambe,9,16,21,43,68,-25,43,20
170,Cambridge Utd,12,7,27,41,72,-31,43,21
170,MK Dons,11,9,26,42,70,-28,42,22
170,Acc'ton Stanley,7,14,25,33,74,-41,35,23
170,FG Rovers,6,12,28,32,82,-50,30,24
171,Sheffield Weds,32,10,4,92,29,63,106,1
171,Plymouth Argyle,29,10,7,86,53,33,97,2
171,Bolton,24,13,9,64,34,30,85,3
171,Derby County,24,11,11,77,43,34,83,4
171,Ipswich Town,22,15,9,78,47,31,81,5
171,Barnsley,24,9,13,64,39,25,81,6
171,Wycombe,21,13,12,60,38,22,76,7
171,P'borough Utd,22,7,17,71,55,16,73,8
171,Shrewsbury,18,11,17,57,52,5,65,9
171,Portsmouth,16,17,13,60,56,4,65,10
171,Lincoln City,14,22,10,49,45,4,64,11
171,Fleetwood Town,15,17,14,47,45,2,62,12
171,Charlton Ath,14,16,16,64,61,3,58,13
171,Bristol Rovers,15,13,18,69,78,-9,58,14
171,Port Vale,15,12,19,51,64,-13,57,15
171,Exeter City,13,15,18,56,62,-6,54,16
171,Oxford United,14,11,21,51,62,-11,53,17
171,Cheltenham,13,8,25,32,58,-26,47,18
171,MK Dons,12,9,25,40,62,-22,45,19
171,Morecambe,10,15,21,49,73,-24,45,20
171,Burton Albion,11,11,24,52,89,-37,44,21
171,Acc'ton Stanley,9,16,21,34,66,-32,43,22
171,Cambridge Utd,9,7,30,34,74,-40,34,23
171,FG Rovers,7,10,29,34,86,-52,31,24
172,Sheffield Weds,30,10,6,85,32,53,100,1
172,Plymouth Argyle,27,11,8,82,47,35,92,2
172,Derby County,26,11,9,72,37,35,89,3
172,Ipswich Town,23,15,8,78,46,32,84,4
172,Bolton,24,9,13,71,36,35,81,5
172,Barnsley,24,5,17,63,49,14,77,6
172,Wycombe,22,10,14,61,45,16,76,7
172,Shrewsbury,21,9,16,55,48,7,72,8
172,P'borough Utd,21,6,19,70,56,14,69,9
172,Portsmouth,17,16,13,60,53,7,67,10
172,Fleetwood Town,17,14,15,54,45,9,65,11
172,Exeter City,18,11,17,61,57,4,65,12
172,Port Vale,18,11,17,52,60,-8,65,13
172,Charlton Ath,17,12,17,68,61,7,63,14
172,Lincoln City,13,22,11,44,46,-2,61,15
172,Oxford United,13,13,20,47,54,-7,52,16
172,Bristol Rovers,14,9,23,65,77,-12,51,17
172,Cheltenham,14,8,24,37,59,-22,50,18
172,Morecambe,11,14,21,47,70,-23,47,19
172,Burton Albion,12,10,24,55,85,-30,46,20
172,Acc'ton Stanley,9,13,24,37,71,-34,40,21
172,Cambridge Utd,10,10,26,36,79,-43,40,22
172,MK Dons,9,11,26,40,74,-34,38,23
172,FG Rovers,6,12,28,31,84,-53,30,24
173,Sheffield Weds,30,10,6,88,30,58,100,1
173,Barnsley,26,8,12,77,40,37,86,2
173,Ipswich Town,23,16,7,91,42,49,85,3
173,Derby County,24,13,9,72,37,35,85,4
173,Plymouth Argyle,23,15,8,73,52,21,84,5
173,Wycombe,24,9,13,69,46,23,81,6
173,Bolton,22,13,11,69,40,29,79,7
173,P'borough Utd,22,7,17,73,56,17,73,8
173,Shrewsbury,21,8,17,55,55,0,71,9
173,Portsmouth,17,16,13,58,50,8,67,10
173,Exeter City,17,11,18,62,60,2,62,11
173,Charlton Ath,15,16,15,61,60,1,61,12
173,Fleetwood Town,14,16,16,48,46,2,58,13
173,Lincoln City,12,22,12,43,47,-4,58,14
173,Burton Albion,14,14,18,59,78,-19,56,15
173,Bristol Rovers,14,13,19,68,83,-15,55,16
173,Oxford United,14,12,20,47,57,-10,54,17
173,Port Vale,12,12,22,39,62,-23,48,18
173,Acc'ton Stanley,10,16,20,44,70,-26,46,19
173,Morecambe,9,16,21,42,68,-26,43,20
173,MK Dons,11,9,26,38,69,-31,42,21
173,Cheltenham,10,10,26,29,67,-38,40,22
173,Cambridge Utd,10,10,26,36,75,-39,40,23
173,FG Rovers,7,10,29,38,89,-51,31,24
174,Sheffield Weds,30,12,4,87,31,56,102,1
174,Plymouth Argyle,30,9,7,91,52,39,99,2
174,Derby County,26,11,9,76,38,38,89,3
174,Barnsley,27,7,12,84,45,39,88,4
174,Wycombe,26,5,15,62,42,20,83,5
174,Ipswich Town,22,16,8,82,46,36,82,6
174,Bolton,24,9,13,62,39,23,81,7
174,P'borough Utd,23,8,15,80,52,28,77,8
174,Charlton Ath,18,13,15,68,57,11,67,9
174,Fleetwood Town,17,16,13,55,45,10,67,10
174,Portsmouth,17,13,16,58,59,-1,64,11
174,Lincoln City,15,19,12,46,47,-1,64,12
174,Exeter City,17,12,17,62,59,3,63,13
174,Shrewsbury,18,6,22,52,59,-7,60,14
174,Port Vale,16,10,20,52,65,-13,58,15
174,Bristol Rovers,15,9,22,63,84,-21,54,16
174,Oxford United,12,15,19,49,56,-7,51,17
174,Morecambe,11,12,23,47,77,-30,45,18
174,Burton Albion,12,9,25,58,92,-34,45,19
174,MK Dons,12,8,26,45,73,-28,44,20
174,Cheltenham,10,10,26,33,69,-36,40,21
174,Acc'ton Stanley,8,14,24,38,70,-32,38,22
174,Cambridge Utd,10,7,29,38,74,-36,37,23
174,FG Rovers,6,10,30,32,89,-57,28,24
175,Sheffield Weds,30,13,3,91,32,59,103,1
175,Plymouth Argyle,27,11,8,94,53,41,92,2
175,Ipswich Town,25,16,5,86,40,46,91,3
175,Derby County,26,11,9,80,44,36,89,4
175,Wycombe,26,8,12,70,46,24,86,5
175,Barnsley,24,9,13,77,47,30,81,6
175,Bolton,22,14,10,65,36,29,80,7
175,P'borough Utd,21,7,18,78,63,15,70,8
175,Portsmouth,18,16,12,65,53,12,70,9
175,Charlton Ath,17,14,15,67,54,13,65,10
175,Fleetwood Town,17,14,15,50,43,7,65,11
175,Lincoln City,15,19,12,51,50,1,64,12
175,Exeter City,16,14,16,58,58,0,62,13
175,Shrewsbury,17,9,20,53,54,-1,60,14
175,Port Vale,16,11,19,49,67,-18,59,15
175,Bristol Rovers,14,11,21,68,83,-15,53,16
175,Oxford United,12,11,23,49,64,-15,47,17
175,Burton Albion,11,11,24,63,90,-27,44,18
175,Cheltenham,12,8,26,35,63,-28,44,19
175,Acc'ton Stanley,10,14,22,34,68,-34,44,20
175,MK Dons,12,7,27,42,69,-27,43,21
175,Morecambe,10,11,25,46,85,-39,41,22
175,Cambridge Utd,10,7,29,29,81,-52,37,23
175,FG Rovers,6,10,30,33,90,-57,28,24
176,Sheffield Weds,28,11,7,82,31,51,95,1
176,Plymouth Argyle,28,11,7,87,48,39,95,2
176,Barnsley,29,8,9,72,39,33,95,3
176,Bolton,25,11,10,70,35,35,86,4
176,Ipswich Town,22,16,8,81,46,35,82,5
176,Wycombe,24,7,15,63,47,16,79,6
176,Shrewsbury,23,7,16,64,46,18,76,7
176,Derby County,20,15,11,70,45,25,75,8
176,P'borough Utd,22,7,17,76,58,18,73,9
176,Portsmouth,19,16,11,60,49,11,73,10
176,Charlton Ath,16,14,16,66,56,10,62,11
176,Lincoln City,13,21,12,45,47,-2,60,12
176,Exeter City,16,11,19,62,58,4,59,13
176,Fleetwood Town,13,16,17,53,52,1,55,14
176,Oxford United,15,9,22,48,57,-9,54,15
176,Port Vale,13,12,21,44,67,-23,51,16
176,Acc'ton Stanley,13,11,22,42,71,-29,50,17
176,Bristol Rovers,13,10,23,61,84,-23,49,18
176,Cheltenham,13,10,23,37,61,-24,49,19
176,Burton Albion,12,12,22,53,86,-33,48,20
176,Morecambe,11,12,23,45,73,-28,45,21
176,MK Dons,11,8,27,42,73,-31,41,22
176,Cambridge Utd,10,6,30,37,81,-44,36,23
176,FG Rovers,7,11,28,38,88,-50,32,24
177,Sheffield Weds,28,12,6,84,33,51,96,1
177,Plymouth Argyle,29,9,8,84,46,38,96,2
177,Ipswich Town,25,14,7,85,41,44,89,3
177,Bolton,26,9,11,65,38,27,87,4
177,Barnsley,25,10,11,69,43,26,85,5
177,Derby County,24,12,10,75,39,36,84,6
177,Wycombe,21,9,16,58,42,16,72,7
177,P'borough Utd,22,5,19,80,62,18,71,8
177,Shrewsbury,21,8,17,59,52,7,71,9
177,Portsmouth,18,15,13,63,52,11,69,10
177,Lincoln City,15,20,11,45,44,1,65,11
177,Exeter City,17,11,18,59,59,0,62,12
177,Charlton Ath,15,16,15,68,64,4,61,13
177,Port Vale,15,9,22,53,66,-13,54,14
177,Fleetwood Town,13,14,19,47,52,-5,53,15
177,Cheltenham,14,10,22,38,54,-16,52,16
177,Oxford United,12,15,19,44,52,-8,51,17
177,Burton Albion,12,15,19,56,84,-28,51,18
177,Bristol Rovers,13,11,22,63,86,-23,50,19
177,Acc'ton Stanley,11,14,21,39,72,-33,47,20
177,MK Dons,10,10,26,41,71,-30,40,21
177,Cambridge Utd,10,10,26,32,69,-37,40,22
177,Morecambe,8,13,25,39,72,-33,37,23
177,FG Rovers,6,13,27,34,87,-53,31,24
178,Sheffield Weds,30,10,6,81,32,49,100,1
178,Ipswich Town,25,15,6,82,41,41,90,2
178,Plymouth Argyle,26,11,9,78,50,28,89,3
178,Barnsley,26,8,12,71,40,31,86,4
178,Derby County,24,13,9,72,41,31,85,5
178,Bolton,24,9,13,66,38,28,81,6
178,P'borough Utd,23,8,15,80,58,22,77,7
178,Wycombe,23,8,15,57,41,16,77,8
178,Charlton Ath,19,14,13,78,55,23,71,9
178,Portsmouth,18,17,11,60,47,13,71,10
178,Fleetwood Town,16,17,13,53,41,12,65,11
178,Shrewsbury,19,8,19,58,56,2,65,12
178,Exeter City,16,11,19,56,58,-2,59,13
178,Lincoln City,11,25,10,40,43,-3,58,14
178,Bristol Rovers,15,12,19,61,72,-11,57,15
178,Port Vale,15,11,20,52,66,-14,56,16
178,Oxford United,13,10,23,52,61,-9,49,17
178,Burton Albion,12,10,24,52,91,-39,46,18
178,MK Dons,11,10,25,40,67,-27,43,19
178,Cambridge Utd,12,6,28,38,74,-36,42,20
178,Acc'ton Stanley,10,11,25,35,77,-42,41,21
178,Cheltenham,10,10,26,32,64,-32,40,22
178,Morecambe,9,12,25,44,72,-28,39,23
178,FG Rovers,7,10,29,34,87,-53,31,24
179,Sheffield Weds,30,13,3,87,32,55,103,1
179,Plymouth Argyle,29,11,6,89,49,40,98,2
179,Barnsley,25,10,11,67,38,29,85,3
179,Ipswich Town,22,17,7,81,43,38,83,4
179,Bolton,23,13,10,70,39,31,82,5
179,P'borough Utd,24,7,15,81,59,22,79,6
179,Derby County,22,12,12,70,44,26,78,7
179,Wycombe,23,8,15,61,43,18,77,8
179,Portsmouth,18,14,14,68,54,14,68,9
179,Shrewsbury,18,11,17,56,52,4,65,10
179,Lincoln City,14,21,11,46,42,4,63,11
179,Charlton Ath,15,15,16,72,61,11,60,12
179,Exeter City,16,12,18,62,64,-2,60,13
179,Fleetwood Town,14,16,16,47,48,-1,58,14
179,Bristol Rovers,16,10,20,66,81,-15,58,15
179,Oxford United,15,11,20,47,50,-3,56,16
179,Port Vale,14,10,22,43,67,-24,52,17
179,Cheltenham,13,8,25,37,63,-26,47,18
179,Acc'ton Stanley,12,10,24,37,70,-33,46,19
179,Morecambe,9,16,21,46,70,-24,43,20
179,Burton Albion,10,13,23,57,97,-40,43,21
179,Cambridge Utd,12,7,27,35,76,-41,43,22
179,MK Dons,11,7,28,42,71,-29,40,23
179,FG Rovers,6,10,30,29,83,-54,28,24
180,Plymouth Argyle,32,8,6,87,45,42,104,1
180,Sheffield Weds,29,11,6,83,33,50,98,2
180,Barnsley,27,9,10,77,41,36,90,3
180,Ipswich Town,25,14,7,83,42,41,89,4
180,Derby County,24,12,10,75,43,32,84,5
180,Wycombe,25,7,14,73,46,27,82,6
180,Bolton,22,12,12,62,37,25,78,7
180,P'borough Utd,22,8,16,75,59,16,74,8
180,Shrewsbury,20,7,19,55,52,3,67,9
180,Portsmouth,17,14,15,64,61,3,65,10
180,Port Vale,19,7,20,52,62,-10,64,11
180,Lincoln City,13,21,12,47,50,-3,60,12
180,Fleetwood Town,15,14,17,52,49,3,59,13
180,Charlton Ath,16,11,19,61,65,-4,59,14
180,Exeter City,15,12,19,55,59,-4,57,15
180,Bristol Rovers,15,10,21,61,74,-13,55,16
180,Burton Albion,13,11,22,61,83,-22,50,17
180,Cheltenham,14,8,24,39,65,-26,50,18
180,Morecambe,12,10,24,53,76,-23,46,19
180,Acc'ton Stanley,11,12,23,36,72,-36,45,20
180,Oxford United,11,11,24,49,64,-15,44,21
180,MK Dons,10,9,27,47,76,-29,39,22
180,Cambridge Utd,10,7,29,38,80,-42,37,23
180,FG Rovers,6,13,27,35,86,-51,31,24
181,Ipswich Town,27,14,5,84,39,45,95,1
181,Sheffield Weds,27,13,6,83,36,47,94,2
181,Plymouth Argyle,27,12,7,85,47,38,93,3
181,Derby County,25,12,9,69,33,36,87,4
181,Bolton,23,13,10,73,36,37,82,5
181,Barnsley,24,7,15,77,48,29,79,6
181,Portsmouth,20,16,10,63,52,11,76,7
181,P'borough Utd,22,7,17,82,62,20,73,8
181,Lincoln City,17,18,11,52,47,5,69,9
181,Shrewsbury,20,8,18,61,58,3,68,10
181,Wycombe,19,10,17,56,49,7,67,11
181,Exeter City,17,13,16,64,57,7,64,12
181,Charlton Ath,17,13,16,62,56,6,64,13
181,Bristol Rovers,16,9,21,67,81,-14,57,14
181,Fleetwood Town,13,17,16,48,47,1,56,15
181,Port Vale,12,14,20,43,64,-21,50,16
181,MK Dons,14,8,24,41,64,-23,50,17
181,Burton Albion,13,11,22,63,89,-26,50,18
181,Oxford United,12,11,23,48,65,-17,47,19
181,Acc'ton Stanley,10,15,21,36,67,-31,45,20
181,Cheltenham,11,9,26,40,71,-31,42,21
181,Cambridge Utd,10,9,27,35,75,-40,39,22
181,Morecambe,8,11,27,40,83,-43,35,23
181,FG Rovers,8,10,28,41,87,-46,34,24
182,Sheffield Weds,29,10,7,76,33,43,97,1
182,Barnsley,29,7,10,81,38,43,94,2
182,Plymouth Argyle,27,13,6,83,49,34,94,3
182,Derby County,25,11,10,71,39,32,86,4
182,Bolton,24,11,11,69,39,30,83,5
182,P'borough Utd,24,6,16,76,52,24,78,6
182,Ipswich Town,21,14,11,78,52,26,77,7
182,Wycombe,21,10,15,63,47,16,73,8
182,Portsmouth,18,16,12,70,55,15,70,9
182,Charlton Ath,17,15,14,71,57,14,66,10
182,Exeter City,17,15,14,63,55,8,66,11
182,Shrewsbury,19,7,20,57,53,4,64,12
182,Lincoln City,14,21,11,51,47,4,63,13
182,Fleetwood Town,15,16,15,47,43,4,61,14
182,Bristol Rovers,15,10,21,63,82,-19,55,15
182,Burton Albion,14,9,23,61,85,-24,51,16
182,Port Vale,13,11,22,41,66,-25,50,17
182,Cheltenham,14,7,25,41,67,-26,49,18
182,Acc'ton Stanley,11,15,20,41,66,-25,48,19
182,Cambridge Utd,13,8,25,39,70,-31,47,20
182,Oxford United,9,13,24,43,66,-23,40,21
182,MK Dons,10,8,28,42,77,-35,38,22
182,FG Rovers,8,11,27,32,79,-47,35,23
182,Morecambe,7,12,27,40,82,-42,33,24
183,Sheffield Weds,30,11,5,84,30,54,101,1
183,Plymouth Argyle,28,11,7,94,56,38,95,2
183,Ipswich Town,25,16,5,92,43,49,91,3
183,Barnsley,26,9,11,80,43,37,87,4
183,Derby County,23,12,11,69,44,25,81,5
183,Bolton,23,10,13,64,39,25,79,6
183,Wycombe,22,9,15,64,46,18,75,7
183,P'borough Utd,23,4,19,73,55,18,73,8
183,Portsmouth,18,17,11,66,50,16,71,9
183,Shrewsbury,20,7,19,61,55,6,67,10
183,Lincoln City,14,21,11,47,46,1,63,11
183,Exeter City,17,11,18,62,57,5,62,12
183,Charlton Ath,16,13,17,66,59,7,61,13
183,Fleetwood Town,15,16,15,49,44,5,61,14
183,Port Vale,16,10,20,49,67,-18,58,15
183,Oxford United,14,12,20,48,56,-8,54,16
183,Bristol Rovers,14,11,21,65,82,-17,53,17
183,MK Dons,14,7,25,48,71,-23,49,18
183,Burton Albion,12,10,24,60,92,-32,46,19
183,Acc'ton Stanley,10,14,22,36,77,-41,44,20
183,Cambridge Utd,10,10,26,35,71,-36,40,21
183,FG Rovers,10,10,26,40,81,-41,40,22
183,Cheltenham,10,7,29,31,73,-42,37,23
183,Morecambe,7,12,27,41,87,-46,33,24
184,Sheffield Weds,30,11,5,87,35,52,101,1
184,Plymouth Argyle,27,13,6,91,50,41,94,2
184,Ipswich Town,25,16,5,85,39,46,91,3
184,Bolton,24,10,12,67,36,31,82,4
184,Barnsley,24,10,12,69,46,23,82,5
184,Shrewsbury,24,9,13,58,41,17,81,6
184,Wycombe,23,9,14,63,41,22,78,7
184,Derby County,20,16,10,67,43,24,76,8
184,Portsmouth,19,15,12,64,52,12,72,9
184,P'borough Utd,22,5,19,76,62,14,71,10
184,Charlton Ath,16,13,17,63,57,6,61,11
184,Fleetwood Town,13,16,17,46,46,0,55,12
184,Bristol Rovers,15,10,21,64,80,-16,55,13
184,Cheltenham,14,12,20,38,55,-17,54,14
184,Port Vale,14,10,22,47,70,-23,52,15
184,Exeter City,13,12,21,55,67,-12,51,16
184,Burton Albion,13,10,23,60,87,-27,49,17
184,Morecambe,12,12,22,48,67,-19,48,18
184,Lincoln City,9,20,17,39,52,-13,47,19
184,Oxford United,11,14,21,44,61,-17,47,20
184,Cambridge Utd,12,8,26,41,80,-39,44,21
184,MK Dons,11,10,25,43,67,-24,43,22
184,Acc'ton Stanley,9,14,23,35,67,-32,41,23
184,FG Rovers,9,11,26,36,85,-49,38,24
185,Sheffield Weds,28,13,5,83,32,51,97,1
185,Barnsley,28,7,11,84,46,38,91,2
185,Plymouth Argyle,26,12,8,77,48,29,90,3
185,Ipswich Town,25,14,7,83,43,40,89,4
185,Derby County,23,14,9,70,40,30,83,5
185,Bolton,24,11,11,63,33,30,83,6
185,P'borough Utd,22,9,15,80,56,24,75,7
185,Wycombe,22,8,16,68,48,20,74,8
185,Portsmouth,18,18,10,62,48,14,72,9
185,Charlton Ath,18,13,15,66,57,9,67,10
185,Shrewsbury,19,10,17,55,47,8,67,11
185,Fleetwood Town,17,14,15,52,45,7,65,12
185,Lincoln City,13,21,12,43,44,-1,60,13
185,Exeter City,15,14,17,58,58,0,59,14
185,Bristol Rovers,16,9,21,73,83,-10,57,15
185,Cheltenham,15,9,22,32,59,-27,54,16
185,Acc'ton Stanley,13,13,20,37,61,-24,52,17
185,Port Vale,14,8,24,45,67,-22,50,18
185,MK Dons,13,7,26,44,70,-26,46,19
185,Oxford United,10,12,24,47,65,-18,42,20
185,Cambridge Utd,10,8,28,36,74,-38,38,21
185,Burton Albion,9,11,26,52,97,-45,38,22
185,Morecambe,7,16,23,36,75,-39,37,23
185,FG Rovers,6,11,29,33,83,-50,29,24
186,Sheffield Weds,30,12,4,84,29,55,102,1
186,Ipswich Town,25,13,8,83,42,41,88,2
186,Plymouth Argyle,26,9,11,86,61,25,87,3
186,Wycombe,26,8,12,64,39,25,86,4
186,Derby County,23,15,8,68,39,29,84,5
186,Bolton,25,8,13,74,41,33,83,6
186,Barnsley,22,13,11,60,42,18,79,7
186,Shrewsbury,20,10,16,55,44,11,70,8
186,Portsmouth,18,15,13,60,51,9,69,9
186,P'borough Utd,21,4,21,73,68,5,67,10
186,Exeter City,17,10,19,68,62,6,61,11
186,Charlton Ath,15,16,15,68,62,6,61,12
186,Fleetwood Town,15,16,15,52,50,2,61,13
186,Lincoln City,12,21,13,43,51,-8,57,14
186,Acc'ton Stanley,15,11,20,51,72,-21,56,15
186,Bristol Rovers,15,10,21,75,85,-10,55,16
186,MK Dons,14,9,23,49,66,-17,51,17
186,Burton Albion,13,11,22,55,77,-22,50,18
186,Oxford United,11,13,22,52,67,-15,46,19
186,Morecambe,11,12,23,45,75,-30,45,20
186,Cheltenham,12,9,25,38,69,-31,45,21
186,Port Vale,11,11,24,44,72,-28,44,22
186,Cambridge Utd,9,10,27,34,71,-37,37,23
186,FG Rovers,7,12,27,36,82,-46,33,24
187,Sheffield Weds,32,9,5,86,27,59,105,1
187,Ipswich Town,27,14,5,83,36,47,95,2
187,Barnsley,27,7,12,81,49,32,88,3
187,Plymouth Argyle,25,13,8,80,50,30,88,4
187,Bolton,24,12,10,63,33,30,84,5
187,Wycombe,24,8,14,64,46,18,80,6
187,Derby County,22,12,12,70,44,26,78,7
187,P'borough Utd,21,7,18,70,57,13,70,8
187,Shrewsbury,19,9,18,52,52,0,66,9
187,Lincoln City,15,19,12,47,47,0,64,10
187,Portsmouth,15,18,13,62,55,7,63,11
187,Fleetwood Town,16,15,15,51,44,7,63,12
187,Charlton Ath,15,14,17,63,58,5,59,13
187,Exeter City,15,12,19,54,61,-7,57,14
187,Bristol Rovers,14,12,20,65,80,-15,54,15
187,Oxford United,13,12,21,50,60,-10,51,16
187,Port Vale,12,14,20,49,68,-19,50,17
187,Cambridge Utd,12,11,23,41,68,-27,47,18
187,Burton Albion,11,13,22,50,79,-29,46,19
187,Acc'ton Stanley,10,15,21,35,64,-29,45,20
187,MK Dons,12,8,26,47,75,-28,44,21
187,Cheltenham,12,8,26,33,62,-29,44,22
187,Morecambe,9,12,25,41,71,-30,39,23
187,FG Rovers,7,12,27,34,85,-51,33,24
188,Sheffield Weds,33,9,4,86,28,58,108,1
188,Plymouth Argyle,30,8,8,90,52,38,98,2
188,Ipswich Town,24,15,7,81,43,38,87,3
188,Derby County,25,11,10,79,45,34,86,4
188,P'borough Utd,26,3,17,87,54,33,81,5
188,Bolton,23,10,13,65,41,24,79,6
188,Wycombe,23,9,14,65,42,23,78,7
188,Barnsley,23,9,14,65,46,19,78,8
188,Portsmouth,17,15,14,58,54,4,66,9
188,Fleetwood Town,17,14,15,49,46,3,65,10
188,Shrewsbury,18,10,18,59,52,7,64,11
188,Charlton Ath,17,13,16,68,62,6,64,12
188,Lincoln City,14,22,10,49,47,2,64,13
188,Oxford United,16,12,18,55,61,-6,60,14
188,Port Vale,16,9,21,50,64,-14,57,15
188,Exeter City,14,12,20,61,67,-6,54,16
188,Bristol Rovers,14,10,22,65,79,-14,52,17
188,MK Dons,14,8,24,47,66,-19,50,18
188,Morecambe,10,14,22,46,77,-31,44,19
188,Acc'ton Stanley,11,11,24,45,79,-34,44,20
188,Cambridge Utd,11,8,27,37,79,-42,41,21
188,Cheltenham,10,9,27,30,62,-32,39,22
188,Burton Albion,10,9,27,53,89,-36,39,23
188,FG Rovers,6,10,30,34,89,-55,28,24
189,Sheffield Weds,30,11,5,85,32,53,101,1
189,Barnsley,30,7,9,86,37,49,97,2
189,Plymouth Argyle,25,13,8,84,58,26,88,3
189,Derby County,22,15,9,73,44,29,81,4
189,Ipswich Town,21,17,8,78,44,34,80,5
189,Bolton,23,10,13,64,36,28,79,6
189,Wycombe,21,7,18,60,48,12,70,7
189,Shrewsbury,20,8,18,57,51,6,68,8
189,P'borough Utd,20,7,19,76,69,7,67,9
189,Portsmouth,16,18,12,65,54,11,66,10
189,Charlton Ath,16,17,13,65,56,9,65,11
189,Exeter City,16,12,18,62,58,4,60,12
189,Lincoln City,13,21,12,44,54,-10,60,13
189,Port Vale,15,12,19,48,62,-14,57,14
189,Fleetwood Town,13,17,16,44,45,-1,56,15
189,Oxford United,13,12,21,46,57,-11,51,16
189,Bristol Rovers,13,12,21,65,87,-22,51,17
189,Cheltenham,13,11,22,39,57,-18,50,18
189,Acc'ton Stanley,11,15,20,36,59,-23,48,19
189,Morecambe,12,12,22,46,77,-31,48,20
189,Burton Albion,11,14,21,53,82,-29,47,21
189,MK Dons,11,9,26,43,71,-28,42,22
189,Cambridge Utd,10,10,26,40,73,-33,40,23
189,FG Rovers,9,9,28,36,84,-48,36,24
190,Ipswich Town,28,14,4,88,37,51,98,1
190,Sheffield Weds,28,11,7,86,34,52,95,2
190,Plymouth Argyle,28,11,7,86,54,32,95,3
190,Bolton,26,8,12,74,37,37,86,4
190,Barnsley,25,10,11,80,42,38,85,5
190,Derby County,23,15,8,74,40,34,84,6
190,Wycombe,23,8,15,71,43,28,77,7
190,Shrewsbury,20,10,16,56,50,6,70,8
190,P'borough Utd,21,6,19,79,59,20,69,9
190,Portsmouth,18,15,13,69,57,12,69,10
190,Charlton Ath,16,14,16,66,64,2,62,11
190,Fleetwood Town,15,15,16,49,46,3,60,12
190,Exeter City,15,13,18,65,70,-5,58,13
190,Lincoln City,12,20,14,42,46,-4,56,14
190,Oxford United,14,12,20,58,59,-1,54,15
190,Bristol Rovers,14,11,21,64,85,-21,53,16
190,Cheltenham,15,8,23,40,62,-22,53,17
190,Burton Albion,12,13,21,55,81,-26,49,18
190,Port Vale,12,11,23,44,72,-28,47,19
190,MK Dons,13,7,26,45,70,-25,46,20
190,Acc'ton Stanley,10,15,21,37,78,-41,45,21
190,Cambridge Utd,11,8,27,43,87,-44,41,22
190,Morecambe,8,15,23,42,77,-35,39,23
190,FG Rovers,5,10,31,32,95,-63,25,24
191,Sheffield Weds,29,13,4,92,33,59,100,1
191,Plymouth Argyle,28,9,9,85,50,35,93,2
191,Barnsley,26,10,10,73,38,35,88,3
191,Ipswich Town,23,15,8,81,46,35,84,4
191,Derby County,23,15,8,71,40,31,84,5
191,Bolton,24,10,12,67,43,24,82,6
191,P'borough Utd,24,6,16,79,56,23,78,7
191,Wycombe,23,6,17,67,47,20,75,8
191,Portsmouth,19,17,10,70,54,16,74,9
191,Shrewsbury,20,11,15,58,50,8,71,10
191,Charlton Ath,17,13,16,67,60,7,64,11
191,Exeter City,16,14,16,58,56,2,62,12
191,Fleetwood Town,14,18,14,52,42,10,60,13
191,Lincoln City,12,22,12,40,47,-7,58,14
191,Port Vale,15,9,22,50,65,-15,54,15
191,Bristol Rovers,14,11,21,66,85,-19,53,16
191,Oxford United,13,13,20,47,57,-10,52,17
191,Burton Albion,14,10,22,54,78,-24,52,18
191,Cheltenham,11,10,25,34,63,-29,43,19
191,Cambridge Utd,12,6,28,36,75,-39,42,20
191,Acc'ton Stanley,9,14,23,37,72,-35,41,21
191,Morecambe,9,13,24,45,83,-38,40,22
191,MK Dons,9,11,26,42,77,-35,38,23
191,FG Rovers,5,10,31,32,86,-54,25,24
192,Sheffield Weds,33,10,3,90,28,62,109,1
192,Barnsley,28,9,9,83,47,36,93,2
192,Plymouth Argyle,27,10,9,93,52,41,91,3
192,Derby County,26,10,10,84,44,40,88,4
192,Ipswich Town,24,14,8,82,46,36,86,5
192,P'borough Utd,23,7,16,77,53,24,76,6
192,Bolton,21,13,12,63,42,21,76,7
192,Wycombe,23,7,16,65,46,19,76,8
192,Portsmouth,18,14,14,62,51,11,68,9
192,Charlton Ath,17,12,17,69,57,12,63,10
192,Shrewsbury,17,11,18,53,57,-4,62,11
192,Fleetwood Town,15,14,17,61,49,12,59,12
192,Bristol Rovers,15,14,17,66,83,-17,59,13
192,Lincoln City,13,19,14,41,48,-7,58,14
192,Exeter City,15,12,19,63,66,-3,57,15
192,Port Vale,14,12,20,42,59,-17,54,16
192,Acc'ton Stanley,13,12,21,39,67,-28,51,17
192,Cambridge Utd,12,10,24,37,71,-34,46,18
192,Oxford United,11,12,23,49,64,-15,45,19
192,MK Dons,13,6,27,45,76,-31,45,20
192,Morecambe,10,13,23,45,75,-30,43,21
192,Burton Albion,11,10,25,54,98,-44,43,22
192,Cheltenham,11,6,29,32,68,-36,39,23
192,FG Rovers,8,11,27,39,87,-48,35,24
193,Sheffield Weds,32,9,5,97,31,66,105,1
193,Barnsley,28,9,9,79,42,37,93,2
193,Plymouth Argyle,27,10,9,85,57,28,91,3
193,Ipswich Town,25,15,6,87,44,43,90,4
193,Derby County,24,12,10,76,42,34,84,5
193,Wycombe,23,10,13,64,43,21,79,6
193,Portsmouth,19,18,9,62,41,21,75,7
193,Bolton,21,11,14,63,42,21,74,8
193,P'borough Utd,21,5,20,77,60,17,68,9
193,Fleetwood Town,17,17,12,56,41,15,68,10
193,Shrewsbury,20,8,18,52,50,2,68,11
193,Charlton Ath,14,16,16,70,66,4,58,12
193,Bristol Rovers,15,12,19,70,76,-6,57,13
193,Exeter City,15,11,20,57,65,-8,56,14
193,Lincoln City,11,22,13,41,51,-10,55,15
193,Morecambe,14,13,19,49,66,-17,55,16
193,Oxford United,14,10,22,47,57,-10,52,17
193,Port Vale,14,9,23,46,68,-22,51,18
193,Burton Albion,12,12,22,56,89,-33,48,19
193,MK Dons,13,7,26,41,68,-27,46,20
193,Cheltenham,9,12,25,29,64,-35,39,21
193,Cambridge Utd,10,9,27,40,77,-37,39,22
193,Acc'ton Stanley,8,12,26,32,76,-44,36,23
193,FG Rovers,5,13,28,35,95,-60,28,24
194,Sheffield Weds,29,12,5,76,27,49,99,1
194,Plymouth Argyle,28,10,8,85,55,30,94,2
194,Ipswich Town,24,16,6,83,41,42,88,3
194,Wycombe,26,7,13,64,41,23,85,4
194,Barnsley,24,11,11,66,42,24,83,5
194,Bolton,23,11,12,64,36,28,80,6
194,Derby County,22,14,10,74,48,26,80,7
194,P'borough Utd,25,5,16,76,53,23,80,8
194,Charlton Ath,19,12,15,69,55,14,69,9
194,Portsmouth,16,18,12,65,54,11,66,10
194,Fleetwood Town,16,16,14,49,40,9,64,11
194,Lincoln City,14,20,12,48,45,3,62,12
194,Exeter City,16,13,17,61,58,3,61,13
194,Shrewsbury,16,9,21,48,57,-9,57,14
194,Oxford United,15,11,20,50,57,-7,56,15
194,Port Vale,15,9,22,46,64,-18,54,16
194,Bristol Rovers,14,10,22,60,76,-16,52,17
194,Morecambe,12,14,20,49,67,-18,50,18
194,Burton Albion,11,11,24,58,88,-30,44,19
194,Cheltenham,11,10,25,30,64,-34,43,20
194,MK Dons,12,6,28,44,72,-28,42,21
194,Acc'ton Stanley,10,12,24,39,72,-33,42,22
194,Cambridge Utd,10,7,29,36,77,-41,37,23
194,FG Rovers,7,10,29,33,84,-51,31,24
195,Sheffield Weds,35,8,3,97,32,65,113,1
195,Ipswich Town,27,14,5,82,37,45,95,2
195,Plymouth Argyle,28,8,10,85,57,28,92,3
195,Bolton,26,9,11,77,39,38,87,4
195,Derby County,24,11,11,76,43,33,83,5
195,Wycombe,26,5,15,70,43,27,83,6
195,Barnsley,24,9,13,67,41,26,81,7
195,P'borough Utd,23,6,17,73,53,20,75,8
195,Portsmouth,18,15,13,64,52,12,69,9
195,Shrewsbury,21,6,19,56,52,4,69,10
195,Charlton Ath,16,13,17,62,59,3,61,11
195,Lincoln City,13,22,11,45,45,0,61,12
195,Port Vale,16,11,19,45,59,-14,59,13
195,Bristol Rovers,14,13,19,64,75,-11,55,14
195,Exeter City,13,13,20,53,59,-6,52,15
195,Oxford United,13,12,21,49,57,-8,51,16
195,Cheltenham,13,10,23,40,66,-26,49,17
195,Fleetwood Town,11,15,20,44,59,-15,48,18
195,Burton Albion,12,10,24,55,87,-32,46,19
195,Cambridge Utd,12,9,25,33,70,-37,45,20
195,MK Dons,11,8,27,40,69,-29,41,21
195,Morecambe,10,10,26,41,73,-32,40,22
195,Acc'ton Stanley,8,12,26,38,81,-43,36,23
195,FG Rovers,8,11,27,40,88,-48,35,24
196,Sheffield Weds,29,13,4,77,26,51,100,1
196,Barnsley,28,8,10,73,38,35,92,2
196,Ipswich Town,25,15,6,83,43,40,90,3
196,Plymouth Argyle,26,12,8,81,56,25,90,4
196,Derby County,25,11,10,82,43,39,86,5
196,P'borough Utd,24,8,14,88,54,34,80,6
196,Bolton,23,11,12,62,34,28,80,7
196,Wycombe,24,6,16,71,51,20,78,8
196,Portsmouth,17,16,13,62,53,9,67,9
196,Fleetwood Town,16,15,15,51,41,10,63,10
196,Shrewsbury,17,11,18,51,53,-2,62,11
196,Charlton Ath,16,13,17,70,64,6,61,12
196,Lincoln City,13,22,11,47,48,-1,61,13
196,Bristol Rovers,16,11,19,66,78,-12,59,14
196,Oxford United,14,13,19,55,57,-2,55,15
196,Exeter City,13,15,18,53,63,-10,54,16
196,Port Vale,14,10,22,49,74,-25,52,17
196,MK Dons,12,10,24,40,64,-24,46,18
196,Acc'ton Stanley,9,18,19,38,61,-23,45,19
196,Burton Albion,12,9,25,53,87,-34,45,20
196,Cheltenham,12,8,26,35,65,-30,44,21
196,Cambridge Utd,11,7,28,39,76,-37,40,22
196,Morecambe,8,13,25,44,79,-35,37,23
196,FG Rovers,6,9,31,31,93,-62,27,24
197,Sheffield Weds,32,11,3,87,24,63,107,1
197,Plymouth Argyle,28,10,8,82,51,31,94,2
197,Ipswich Town,23,17,6,87,46,41,86,3
197,Barnsley,25,9,12,72,39,33,84,4
197,Derby County,22,14,10,73,40,33,80,5
197,Bolton,23,9,14,62,39,23,78,6
197,Portsmouth,19,13,14,61,55,6,70,7
197,Exeter City,19,12,15,64,51,13,69,8
197,Wycombe,20,9,17,59,46,13,69,9
197,P'borough Utd,20,7,19,66,60,6,67,10
197,Fleetwood Town,15,18,13,53,48,5,63,11
197,Charlton Ath,16,14,16,63,62,1,62,12
197,Shrewsbury,16,13,17,50,51,-1,61,13
197,Lincoln City,14,18,14,42,47,-5,60,14
197,Bristol Rovers,15,11,20,60,73,-13,56,15
197,Oxford United,15,10,21,50,57,-7,55,16
197,Burton Albion,15,10,21,58,82,-24,55,17
197,Port Vale,14,10,22,43,60,-17,52,18
197,Cheltenham,14,9,23,35,60,-25,51,19
197,Morecambe,12,11,23,48,71,-23,47,20
197,MK Dons,12,7,27,41,71,-30,43,21
197,Cambridge Utd,10,11,25,35,68,-33,41,22
197,Acc'ton Stanley,8,15,23,41,81,-40,39,23
197,FG Rovers,5,12,29,35,85,-50,27,24
198,Sheffield Weds,30,11,5,82,31,51,101,1
198,Plymouth Argyle,29,11,6,82,43,39,98,2
198,Ipswich Town,25,17,4,91,41,50,92,3
198,Wycombe,28,6,12,71,40,31,90,4
198,Barnsley,27,5,14,75,49,26,86,5
198,Bolton,23,12,11,64,38,26,81,6
198,Derby County,21,14,11,71,47,24,77,7
198,P'borough Utd,23,4,19,78,64,14,73,8
198,Portsmouth,18,15,13,69,60,9,69,9
198,Lincoln City,12,22,12,43,49,-6,58,10
198,Fleetwood Town,13,18,15,47,45,2,57,11
198,Burton Albion,16,9,21,70,92,-22,57,12
198,Charlton Ath,13,17,16,63,58,5,56,13
198,Shrewsbury,16,7,23,51,60,-9,55,14
198,Bristol Rovers,15,9,22,62,79,-17,54,15
198,Acc'ton Stanley,13,14,19,43,66,-23,53,16
198,Exeter City,13,12,21,53,64,-11,51,17
198,Port Vale,14,9,23,47,70,-23,51,18
198,Oxford United,12,14,20,52,61,-9,50,19
198,Morecambe,10,15,21,48,74,-26,45,20
198,MK Dons,12,8,26,43,70,-27,44,21
198,Cambridge Utd,12,8,26,41,72,-31,44,22
198,Cheltenham,11,10,25,34,61,-27,43,23
198,FG Rovers,7,11,28,34,80,-46,32,24
199,Sheffield Weds,30,12,4,83,33,50,102,1
199,Plymouth Argyle,28,11,7,86,47,39,95,2
199,Ipswich Town,25,14,7,85,50,35,89,3
199,Bolton,26,10,10,73,34,39,88,4
199,Barnsley,27,6,13,79,46,33,87,5
199,Derby County,22,14,10,73,42,31,80,6
199,Wycombe,24,6,16,60,44,16,78,7
199,P'borough Utd,23,8,15,76,55,21,77,8
199,Portsmouth,19,15,12,65,56,9,72,9
199,Charlton Ath,19,12,15,68,56,12,69,10
199,Fleetwood Town,15,17,14,49,44,5,62,11
199,Shrewsbury,18,8,20,59,60,-1,62,12
199,Port Vale,16,9,21,52,71,-19,57,13
199,Lincoln City,10,24,12,42,49,-7,54,14
199,Bristol Rovers,13,13,20,64,82,-18,52,15
199,Oxford United,12,13,21,47,54,-7,49,16
199,Exeter City,12,12,22,53,61,-8,48,17
199,MK Dons,13,8,25,50,69,-19,47,18
199,Burton Albion,12,10,24,61,91,-30,46,19
199,Cheltenham,12,9,25,38,69,-31,45,20
199,Morecambe,10,13,23,45,75,-30,43,21
199,Cambridge Utd,11,8,27,38,78,-40,41,22
199,Acc'ton Stanley,9,13,24,41,74,-33,40,23
199,FG Rovers,8,11,27,38,85,-47,35,24
200,Sheffield Weds,29,14,3,83,34,49,101,1
200,Plymouth Argyle,28,10,8,83,51,32,94,2
200,Ipswich Town,25,16,5,80,39,41,91,3
200,Barnsley,27,6,13,73,44,29,87,4
200,Portsmouth,22,14,10,71,51,20,80,5
200,Bolton,23,10,13,64,40,24,79,6
200,Derby County,22,12,12,70,43,27,78,7
200,Wycombe,22,9,15,62,44,18,75,8
200,P'borough Utd,21,9,16,73,55,18,72,9
200,Shrewsbury,19,10,17,53,50,3,67,10
200,Charlton Ath,17,12,17,65,66,-1,63,11
200,Fleetwood Town,15,16,15,46,41,5,61,12
200,Lincoln City,13,21,12,46,45,1,60,13
200,Exeter City,15,13,18,57,58,-1,58,14
200,Port Vale,16,10,20,46,64,-18,58,15
200,Bristol Rovers,14,12,20,62,78,-16,54,16
200,Cheltenham,13,11,22,38,59,-21,50,17
200,Oxford United,11,13,22,44,57,-13,46,18
200,Burton Albion,12,9,25,53,76,-23,45,19
200,Cambridge Utd,12,9,25,43,71,-28,45,20
200,Acc'ton Stanley,9,17,20,41,72,-31,44,21
200,MK Dons,11,8,27,37,64,-27,41,22
200,Morecambe,8,13,25,40,73,-33,37,23
200,FG Rovers,6,10,30,32,87,-55,28,24
201,Sheffield Weds,33,9,4,90,27,63,108,1
201,Plymouth Argyle,32,9,5,95,45,50,105,2
201,Ipswich Town,26,14,6,83,44,39,92,3
201,Derby County,26,12,8,77,43,34,90,4
201,Bolton,25,10,11,72,35,37,85,5
201,Barnsley,25,9,12,72,43,29,84,6
201,Wycombe,23,6,17,64,46,18,75,7
201,Portsmouth,19,14,13,62,57,5,71,8
201,P'borough Utd,21,6,19,72,61,11,69,9
201,Shrewsbury,20,9,17,54,53,1,69,10
201,Lincoln City,14,22,10,42,41,1,64,11
201,Charlton Ath,16,15,15,64,60,4,63,12
201,Fleetwood Town,15,14,17,56,51,5,59,13
201,Port Vale,15,9,22,49,70,-21,54,14
201,Bristol Rovers,15,8,23,58,84,-26,53,15
201,Oxford United,12,15,19,50,56,-6,51,16
201,Acc'ton Stanley,12,13,21,47,70,-23,49,17
201,Burton Albion,12,11,23,55,83,-28,47,18
201,Exeter City,11,12,23,49,67,-18,45,19
201,Cheltenham,11,9,26,34,61,-27,42,20
201,Morecambe,9,14,23,46,76,-30,41,21
201,Cambridge Utd,10,9,27,35,73,-38,39,22
201,MK Dons,10,8,28,47,76,-29,38,23
201,FG Rovers,6,11,29,37,88,-51,29,24
202,Sheffield Weds,30,11,5,78,27,51,101,1
202,Barnsley,28,9,9,71,32,39,93,2
202,Plymouth Argyle,25,13,8,74,46,28,88,3
202,Bolton,26,9,11,64,36,28,87,4
202,Derby County,23,12,11,65,41,24,81,5
202,Ipswich Town,21,16,9,84,50,34,79,6
202,P'borough Utd,23,7,16,74,53,21,76,7
202,Fleetwood Town,19,15,12,53,39,14,72,8
202,Portsmouth,17,20,9,67,48,19,71,9
202,Wycombe,20,9,17,58,48,10,69,10
202,Shrewsbury,19,9,18,60,51,9,66,11
202,Charlton Ath,16,16,14,66,57,9,64,12
202,Lincoln City,13,22,11,45,44,1,61,13
202,Bristol Rovers,15,13,18,64,68,-4,58,14
202,Port Vale,15,9,22,46,64,-18,54,15
202,Exeter City,12,17,17,53,58,-5,53,16
202,Oxford United,13,10,23,44,60,-16,49,17
202,Cheltenham,13,8,25,37,64,-27,47,18
202,Acc'ton Stanley,10,14,22,33,63,-30,44,19
202,Burton Albion,11,10,25,49,84,-35,43,20
202,Morecambe,10,13,23,45,82,-37,43,21
202,MK Dons,12,6,28,40,66,-26,42,22
202,Cambridge Utd,10,10,26,33,67,-34,40,23
202,FG Rovers,7,10,29,32,87,-55,31,24
203,Plymouth Argyle,30,9,7,95,47,48,99,1
203,Sheffield Weds,29,11,6,81,32,49,98,2
203,Ipswich Town,24,13,9,83,47,36,85,3
203,Derby County,24,12,10,70,37,33,84,4
203,Wycombe,24,10,12,66,39,27,82,5
203,Barnsley,24,9,13,65,48,17,81,6
203,Bolton,22,13,11,64,37,27,79,7
203,P'borough Utd,24,5,17,73,51,22,77,8
203,Portsmouth,19,16,11,57,46,11,73,9
203,Charlton Ath,19,12,15,79,61,18,69,10
203,Shrewsbury,18,10,18,51,51,0,64,11
203,Fleetwood Town,13,19,14,51,46,5,58,12
203,Lincoln City,11,24,11,43,46,-3,57,13
203,Exeter City,15,11,20,57,59,-2,56,14
203,Burton Albion,14,12,20,59,79,-20,54,15
203,Acc'ton Stanley,12,15,19,45,69,-24,51,16
203,Bristol Rovers,12,14,20,58,74,-16,50,17
203,Oxford United,12,13,21,47,57,-10,49,18
203,Port Vale,11,11,24,44,74,-30,44,19
203,Morecambe,9,16,21,39,70,-31,43,20
203,Cheltenham,11,8,27,35,70,-35,41,21
203,MK Dons,10,10,26,41,72,-31,40,22
203,Cambridge Utd,11,7,28,36,73,-37,40,23
203,FG Rovers,9,10,27,36,90,-54,37,24
204,Sheffield Weds,28,11,7,79,29,50,95,1
204,Plymouth Argyle,27,11,8,86,51,35,92,2
204,Ipswich Town,25,15,6,86,43,43,90,3
204,Barnsley,26,9,11,70,44,26,87,4
204,Derby County,25,11,10,76,38,38,86,5
204,Portsmouth,21,15,10,68,51,17,78,6
204,Bolton,22,9,15,62,45,17,75,7
204,Wycombe,21,9,16,68,50,18,72,8
204,P'borough Utd,22,6,18,71,55,16,72,9
204,Shrewsbury,19,10,17,53,47,6,67,10
204,Fleetwood Town,17,14,15,54,47,7,65,11
204,Exeter City,17,11,18,62,62,0,62,12
204,Lincoln City,14,19,13,42,48,-6,61,13
204,Bristol Rovers,17,9,20,72,81,-9,60,14
204,Charlton Ath,14,16,16,65,68,-3,58,15
204,Oxford United,15,10,21,52,60,-8,55,16
204,Port Vale,14,11,21,49,66,-17,53,17
204,Cambridge Utd,13,10,23,40,65,-25,49,18
204,Cheltenham,12,9,25,37,65,-28,45,19
204,Acc'ton Stanley,9,17,20,39,65,-26,44,20
204,Burton Albion,11,10,25,54,89,-35,43,21
204,MK Dons,11,8,27,42,73,-31,41,22
204,Morecambe,9,13,24,43,72,-29,40,23
204,FG Rovers,5,13,28,31,87,-56,28,24
205,Sheffield Weds,29,12,5,80,31,49,99,1
205,Plymouth Argyle,29,9,8,84,47,37,96,2
205,Derby County,28,10,8,88,39,49,94,3
205,Barnsley,25,11,10,71,34,37,86,4
205,P'borough Utd,26,5,15,82,55,27,83,5
205,Bolton,24,10,12,64,37,27,82,6
205,Wycombe,24,9,13,66,36,30,81,7
205,Ipswich Town,20,15,11,70,44,26,75,8
205,Shrewsbury,22,7,17,57,50,7,73,9
205,Portsmouth,18,17,11,63,49,14,71,10
205,Fleetwood Town,16,17,13,50,41,9,65,11
205,Exeter City,17,12,17,62,56,6,63,12
205,Charlton Ath,16,13,17,63,62,1,61,13
205,Lincoln City,11,21,14,43,55,-12,54,14
205,Cheltenham,15,9,22,41,58,-17,54,15
205,Port Vale,13,11,22,47,69,-22,50,16
205,Oxford United,11,13,22,47,61,-14,46,17
205,Burton Albion,12,10,24,53,95,-42,46,18
205,Bristol Rovers,12,9,25,57,87,-30,45,19
205,Cambridge Utd,12,9,25,36,66,-30,45,20
205,MK Dons,10,10,26,44,75,-31,40,21
205,Acc'ton Stanley,8,16,22,37,73,-36,40,22
205,Morecambe,9,12,25,42,79,-37,39,23
205,FG Rovers,6,11,29,37,85,-48,29,24
206,Sheffield Weds,28,14,4,84,30,54,98,1
206,Plymouth Argyle,29,10,7,93,49,44,97,2
206,Ipswich Town,25,14,7,88,41,47,89,3
206,Derby County,24,13,9,76,42,34,85,4
206,Barnsley,23,13,10,65,42,23,82,5
206,Bolton,21,15,10,59,35,24,78,6
206,Wycombe,21,8,17,60,47,13,71,7
206,Lincoln City,17,20,9,45,37,8,71,8
206,Shrewsbury,21,8,17,53,47,6,71,9
206,Portsmouth,18,15,13,63,51,12,69,10
206,Fleetwood Town,17,17,12,50,41,9,68,11
206,P'borough Utd,20,7,19,68,56,12,67,12
206,Charlton Ath,17,13,16,65,60,5,64,13
206,Port Vale,16,11,19,49,61,-12,59,14
206,Exeter City,14,13,19,59,65,-6,55,15
206,Bristol Rovers,13,10,23,60,76,-16,49,16
206,MK Dons,14,6,26,50,74,-24,48,17
206,Morecambe,12,12,22,45,69,-24,48,18
206,Oxford United,10,16,20,44,57,-13,46,19
206,Burton Albion,11,12,23,51,84,-33,45,20
206,Cheltenham,10,12,24,37,66,-29,42,21
206,Acc'ton Stanley,9,14,23,43,80,-37,41,22
206,Cambridge Utd,10,8,28,36,75,-39,38,23
206,FG Rovers,6,11,29,32,90,-58,29,24
207,Sheffield Weds,31,9,6,91,34,57,102,1
207,Barnsley,28,7,11,78,40,38,91,2
207,Plymouth Argyle,27,8,11,79,52,27,89,3
207,Bolton,24,11,11,74,37,37,83,4
207,Wycombe,25,6,15,67,44,23,81,5
207,Derby County,23,11,12,74,49,25,80,6
207,P'borough Utd,25,5,16,85,62,23,80,7
207,Ipswich Town,20,17,9,81,50,31,77,8
207,Portsmouth,17,17,12,61,49,12,68,9
207,Charlton Ath,18,12,16,64,53,11,66,10
207,Shrewsbury,18,11,17,57,55,2,65,11
207,Bristol Rovers,18,9,19,71,79,-8,63,12
207,Fleetwood Town,16,13,17,51,51,0,61,13
207,Lincoln City,13,21,12,43,47,-4,60,14
207,Port Vale,16,10,20,50,63,-13,58,15
207,Exeter City,13,12,21,58,68,-10,51,16
207,Oxford United,13,11,22,49,65,-16,50,17
207,Burton Albion,13,10,23,59,92,-33,49,18
207,Cheltenham,12,11,23,35,60,-25,47,19
207,Morecambe,12,11,23,41,67,-26,47,20
207,Acc'ton Stanley,10,13,23,35,69,-34,43,21
207,Cambridge Utd,10,10,26,34,73,-39,40,22
207,MK Dons,9,11,26,38,69,-31,38,23
207,FG Rovers,7,12,27,35,82,-47,33,24
208,Plymouth Argyle,30,10,6,87,47,40,100,1
208,Sheffield Weds,29,11,6,78,32,46,98,2
208,Ipswich Town,28,13,5,91,41,50,97,3
208,Bolton,24,10,12,73,37,36,82,4
208,Derby County,23,13,10,77,44,33,82,5
208,Wycombe,25,7,14,63,43,20,82,6
208,Barnsley,23,8,15,71,48,23,77,7
208,Portsmouth,21,13,12,69,53,16,76,8
208,P'borough Utd,22,8,16,76,60,16,74,9
208,Shrewsbury,20,8,18,56,53,3,68,10
208,Exeter City,16,13,17,64,61,3,61,11
208,Charlton Ath,15,14,17,67,61,6,59,12
208,Fleetwood Town,14,17,15,51,49,2,59,13
208,Lincoln City,11,23,12,45,48,-3,56,14
208,Port Vale,15,9,22,50,66,-16,54,15
208,Bristol Rovers,14,12,20,62,79,-17,54,16
208,Cheltenham,13,8,25,35,62,-27,47,17
208,MK Dons,12,9,25,43,69,-26,45,18
208,Oxford United,11,11,24,41,62,-21,44,19
208,Acc'ton Stanley,10,14,22,37,65,-28,44,20
208,Morecambe,10,12,24,40,75,-35,42,21
208,Burton Albion,9,15,22,54,94,-40,42,22
208,Cambridge Utd,9,12,25,38,71,-33,39,23
208,FG Rovers,8,10,28,31,79,-48,34,24
209,Plymouth Argyle,28,12,6,92,50,42,96,1
209,Sheffield Weds,26,14,6,79,34,45,92,2
209,Barnsley,28,8,10,75,41,34,92,3
209,Bolton,25,10,11,64,34,30,85,4
209,Derby County,24,12,10,78,44,34,84,5
209,Ipswich Town,23,15,8,79,51,28,84,6
209,Portsmouth,20,18,8,66,48,18,78,7
209,P'borough Utd,23,7,16,78,56,22,76,8
209,Wycombe,21,10,15,62,45,17,73,9
209,Charlton Ath,19,12,15,69,65,4,69,10
209,Exeter City,17,12,17,63,61,2,63,11
209,Bristol Rovers,17,11,18,72,71,1,62,12
209,Fleetwood Town,15,15,16,47,45,2,60,13
209,Shrewsbury,17,9,20,51,52,-1,60,14
209,Port Vale,16,11,19,49,63,-14,59,15
209,Lincoln City,11,25,10,41,46,-5,58,16
209,Oxford United,11,13,22,48,65,-17,46,17
209,Burton Albion,11,11,24,55,82,-27,44,18
209,Cheltenham,11,10,25,36,65,-29,43,19
209,MK Dons,10,10,26,37,68,-31,40,20
209,Morecambe,8,15,23,41,70,-29,39,21
209,Acc'ton Stanley,9,12,25,36,72,-36,39,22
209,FG Rovers,9,10,27,35,82,-47,37,23
209,Cambridge Utd,9,6,31,34,77,-43,33,24
210,Sheffield Weds,28,13,5,90,34,56,97,1
210,Ipswich Town,25,14,7,84,44,40,89,2
210,Barnsley,27,8,11,71,41,30,89,3
210,Plymouth Argyle,25,11,10,77,54,23,86,4
210,Derby County,23,11,12,70,45,25,80,5
210,Bolton,22,11,13,66,38,28,77,6
210,P'borough Utd,22,7,17,72,57,15,73,7
210,Portsmouth,18,16,12,67,48,19,70,8
210,Shrewsbury,19,8,19,56,53,3,65,9
210,Charlton Ath,16,16,14,63,55,8,64,10
210,Lincoln City,13,24,9,49,46,3,63,11
210,Wycombe,18,8,20,53,52,1,62,12
210,Exeter City,17,11,18,59,64,-5,62,13
210,Fleetwood Town,14,15,17,52,54,-2,57,14
210,Oxford United,14,12,20,47,56,-9,54,15
210,Bristol Rovers,14,12,20,64,79,-15,54,16
210,Port Vale,15,9,22,45,65,-20,54,17
210,Cambridge Utd,14,11,21,43,66,-23,53,18
210,Acc'ton Stanley,12,14,20,37,62,-25,50,19
210,Burton Albion,12,12,22,53,77,-24,48,20
210,Morecambe,11,13,22,45,68,-23,46,21
210,Cheltenham,11,10,25,34,62,-28,43,22
210,MK Dons,10,10,26,41,73,-32,40,23
210,FG Rovers,8,12,26,36,81,-45,36,24
211,Plymouth Argyle,29,10,7,83,47,36,97,1
211,Sheffield Weds,28,12,6,82,34,48,96,2
211,Barnsley,28,5,13,66,38,28,89,3
211,Ipswich Town,24,14,8,80,41,39,86,4
211,Wycombe,26,8,12,77,41,36,86,5
211,Bolton,26,8,12,72,38,34,86,6
211,Derby County,22,14,10,73,43,30,80,7
211,P'borough Utd,24,4,18,76,55,21,76,8
211,Shrewsbury,19,11,16,53,47,6,68,9
211,Fleetwood Town,17,15,14,57,45,12,66,10
211,Charlton Ath,16,16,14,64,59,5,64,11
211,Portsmouth,17,13,16,62,57,5,64,12
211,Lincoln City,13,19,14,42,48,-6,58,13
211,Bristol Rovers,16,8,22,62,78,-16,56,14
211,Exeter City,14,11,21,53,61,-8,53,15
211,Oxford United,14,10,22,47,62,-15,52,16
211,Port Vale,14,8,24,50,72,-22,50,17
211,MK Dons,13,11,22,45,67,-22,50,18
211,Morecambe,12,11,23,44,69,-25,47,19
211,Burton Albion,12,11,23,59,89,-30,47,20
211,Cheltenham,11,9,26,36,68,-32,42,21
211,Acc'ton Stanley,8,17,21,39,75,-36,41,22
211,Cambridge Utd,11,8,27,37,76,-39,41,23
211,FG Rovers,7,9,30,32,81,-49,30,24
212,Sheffield Weds,31,8,7,85,32,53,101,1
212,Barnsley,29,7,10,77,43,34,94,2
212,Plymouth Argyle,27,10,9,89,53,36,91,3
212,Ipswich Town,25,14,7,84,40,44,89,4
212,Bolton,25,9,12,67,33,34,84,5
212,Wycombe,25,8,13,77,41,36,83,6
212,P'borough Utd,24,5,17,80,55,25,77,7
212,Derby County,22,11,13,72,47,25,77,8
212,Portsmouth,19,15,12,68,58,10,72,9
212,Port Vale,19,11,16,53,56,-3,68,10
212,Shrewsbury,20,7,19,54,55,-1,67,11
212,Charlton Ath,15,16,15,62,57,5,61,12
212,Fleetwood Town,15,15,16,51,47,4,60,13
212,Lincoln City,13,20,13,44,46,-2,59,14
212,Exeter City,14,12,20,62,64,-2,54,15
212,Bristol Rovers,14,9,23,60,87,-27,51,16
212,Morecambe,12,13,21,45,66,-21,49,17
212,Oxford United,11,12,23,41,57,-16,45,18
212,Burton Albion,12,9,25,50,78,-28,45,19
212,MK Dons,12,7,27,43,76,-33,43,20
212,Cambridge Utd,12,7,27,39,80,-41,43,21
212,Acc'ton Stanley,9,14,23,38,73,-35,41,22
212,Cheltenham,10,11,25,33,73,-40,41,23
212,FG Rovers,8,8,30,37,94,-57,32,24
213,Sheffield Weds,29,12,5,82,34,48,99,1
213,Plymouth Argyle,27,8,11,81,56,25,89,2
213,Barnsley,26,9,11,75,44,31,87,3
213,Ipswich Town,23,15,8,81,48,33,84,4
213,Bolton,22,14,10,71,39,32,80,5
213,Derby County,22,13,11,72,42,30,79,6
213,Portsmouth,21,13,12,63,45,18,76,7
213,P'borough Utd,23,6,17,80,59,21,75,8
213,Wycombe,21,10,15,66,43,23,73,9
213,Fleetwood Town,17,16,13,54,44,10,67,10
213,Charlton Ath,16,16,14,65,59,6,64,11
213,Shrewsbury,18,8,20,55,58,-3,62,12
213,Exeter City,16,10,20,65,66,-1,58,13
213,Lincoln City,12,21,13,43,50,-7,57,14
213,Bristol Rovers,16,9,21,68,77,-9,57,15
213,Oxford United,14,11,21,53,59,-6,53,16
213,Port Vale,14,10,22,47,67,-20,52,17
213,Burton Albion,13,13,20,59,80,-21,52,18
213,Morecambe,11,14,21,44,70,-26,47,19
213,Cheltenham,11,11,24,31,65,-34,44,20
213,Acc'ton Stanley,10,13,23,39,75,-36,43,21
213,Cambridge Utd,11,9,26,36,75,-39,42,22
213,MK Dons,11,8,27,40,72,-32,41,23
213,FG Rovers,8,11,27,35,78,-43,35,24
214,Plymouth Argyle,29,10,7,88,46,42,97,1
214,Sheffield Weds,27,15,4,78,35,43,96,2
214,Barnsley,27,7,12,68,40,28,88,3
214,Bolton,26,9,11,69,37,32,87,4
214,Ipswich Town,23,16,7,88,46,42,85,5
214,Derby County,22,13,11,71,45,26,79,6
214,P'borough Utd,23,8,15,74,50,24,77,7
214,Wycombe,21,10,15,61,47,14,73,8
214,Shrewsbury,21,8,17,62,52,10,71,9
214,Portsmouth,17,16,13,62,53,9,67,10
214,Fleetwood Town,18,12,16,56,45,11,66,11
214,Charlton Ath,15,16,15,62,57,5,61,12
214,Exeter City,16,12,18,58,57,1,60,13
214,Lincoln City,11,25,10,44,48,-4,58,14
214,Oxford United,14,13,19,55,60,-5,55,15
214,Port Vale,15,10,21,49,68,-19,55,16
214,Bristol Rovers,14,10,22,58,75,-17,52,17
214,Burton Albion,12,11,23,55,81,-26,47,18
214,MK Dons,10,13,23,41,66,-25,43,19
214,Cambridge Utd,10,10,26,39,74,-35,40,20
214,Morecambe,8,15,23,44,73,-29,39,21
214,Acc'ton Stanley,8,15,23,33,71,-38,39,22
214,Cheltenham,10,9,27,35,74,-39,39,23
214,FG Rovers,9,9,28,37,87,-50,36,24
215,Sheffield Weds,28,12,6,87,40,47,96,1
215,Plymouth Argyle,27,9,10,81,57,24,90,2
215,Ipswich Town,25,14,7,79,42,37,89,3
215,Derby County,24,13,9,79,39,40,85,4
215,Barnsley,24,11,11,72,41,31,83,5
215,Bolton,24,10,12,68,37,31,82,6
215,Wycombe,25,6,15,70,44,26,81,7
215,Shrewsbury,22,9,15,62,46,16,75,8
215,P'borough Utd,22,4,20,71,59,12,70,9
215,Charlton Ath,19,12,15,72,57,15,69,10
215,Portsmouth,17,18,11,62,57,5,69,11
215,Lincoln City,13,23,10,44,40,4,62,12
215,Fleetwood Town,15,15,16,51,50,1,60,13
215,Exeter City,15,12,19,53,57,-4,57,14
215,Port Vale,15,11,20,46,64,-18,56,15
215,Bristol Rovers,14,10,22,65,87,-22,52,16
215,Oxford United,12,14,20,48,55,-7,50,17
215,Cheltenham,14,7,25,38,63,-25,49,18
215,MK Dons,12,9,25,44,68,-24,45,19
215,Acc'ton Stanley,9,15,22,35,67,-32,42,20
215,Burton Albion,10,12,24,50,85,-35,42,21
215,Cambridge Utd,12,6,28,40,78,-38,42,22
215,Morecambe,9,14,23,42,75,-33,41,23
215,FG Rovers,6,12,28,30,81,-51,30,24
216,Sheffield Weds,31,10,5,84,29,55,103,1
216,Plymouth Argyle,29,10,7,88,52,36,97,2
216,Ipswich Town,25,15,6,94,49,45,90,3
216,Bolton,25,10,11,65,37,28,85,4
216,Wycombe,26,7,13,70,44,26,85,5
216,Barnsley,25,9,12,76,45,31,84,6
216,Derby County,23,11,12,74,45,29,80,7
216,Portsmouth,21,16,9,66,48,18,79,8
216,P'borough Utd,21,7,18,69,57,12,70,9
216,Shrewsbury,19,11,16,60,50,10,68,10
216,Charlton Ath,16,15,15,63,58,5,63,11
216,Fleetwood Town,14,19,13,49,45,4,61,12
216,Lincoln City,13,20,13,42,47,-5,59,13
216,Port Vale,15,12,19,47,59,-12,57,14
216,Exeter City,15,11,20,60,62,-2,56,15
216,Bristol Rovers,13,12,21,60,77,-17,51,16
216,Oxford United,12,13,21,47,59,-12,49,17
216,MK Dons,13,9,24,46,68,-22,48,18
216,Cambridge Utd,12,7,27,35,71,-36,43,19
216,Cheltenham,10,10,26,34,72,-38,40,20
216,Burton Albion,10,10,26,54,94,-40,40,21
216,Acc'ton Stanley,8,13,25,37,74,-37,37,22
216,Morecambe,8,12,26,42,79,-37,36,23
216,FG Rovers,7,13,26,36,77,-41,34,24
217,Sheffield Weds,31,11,4,91,31,60,104,1
217,Plymouth Argyle,29,10,7,92,48,44,97,2
217,Barnsley,25,12,9,78,46,32,87,3
217,Ipswich Town,23,16,7,85,43,42,85,4
217,Derby County,24,12,10,70,39,31,84,5
217,Wycombe,24,10,12,63,42,21,82,6
217,P'borough Utd,24,6,16,75,55,20,78,7
217,Bolton,21,12,13,61,40,21,75,8
217,Portsmouth,17,14,15,63,53,10,65,9
217,Charlton Ath,18,11,17,68,63,5,65,10
217,Exeter City,16,14,16,67,55,12,62,11
217,Fleetwood Town,16,14,16,51,49,2,62,12
217,Shrewsbury,17,10,19,51,54,-3,61,13
217,Lincoln City,12,24,10,46,46,0,60,14
217,Port Vale,16,9,21,52,62,-10,57,15
217,Oxford United,14,11,21,48,61,-13,53,16
217,Bristol Rovers,14,10,22,59,85,-26,52,17
217,MK Dons,14,9,23,47,65,-18,51,18
217,Burton Albion,14,8,24,55,77,-22,50,19
217,Morecambe,11,13,22,46,74,-28,46,20
217,Cheltenham,10,10,26,33,68,-35,40,21
217,Acc'ton Stanley,8,13,25,34,75,-41,37,22
217,FG Rovers,9,8,29,38,88,-50,35,23
217,Cambridge Utd,9,5,32,28,82,-54,32,24
218,Sheffield Weds,33,9,4,91,29,62,108,1
218,Ipswich Town,26,15,5,90,45,45,93,2
218,Plymouth Argyle,26,12,8,83,50,33,90,3
218,Barnsley,27,5,14,74,45,29,86,4
218,Bolton,24,12,10,71,38,33,84,5
218,Derby County,23,12,11,74,44,30,81,6
218,Portsmouth,22,13,11,65,47,18,79,7
218,Wycombe,21,10,15,64,45,19,73,8
218,P'borough Utd,22,7,17,72,55,17,73,9
218,Charlton Ath,18,15,13,66,54,12,69,10
218,Exeter City,16,14,16,64,60,4,62,11
218,Lincoln City,13,21,12,42,44,-2,60,12
218,Shrewsbury,17,9,20,50,53,-3,60,13
218,Fleetwood Town,14,15,17,50,51,-1,57,14
218,Port Vale,16,8,22,48,62,-14,56,15
218,Bristol Rovers,14,10,22,58,84,-26,52,16
218,Acc'ton Stanley,12,15,19,39,68,-29,51,17
218,Oxford United,11,15,20,49,61,-12,48,18
218,Cheltenham,12,10,24,35,59,-24,46,19
218,Burton Albion,11,12,23,54,93,-39,45,20
218,MK Dons,12,8,26,48,71,-23,44,21
218,Cambridge Utd,10,8,28,32,71,-39,38,22
218,Morecambe,7,14,25,40,75,-35,35,23
218,FG Rovers,6,9,31,32,87,-55,27,24
219,Sheffield Weds,29,13,4,85,33,52,100,1
219,Plymouth Argyle,29,9,8,87,53,34,96,2
219,Ipswich Town,27,13,6,93,45,48,94,3
219,Bolton,25,10,11,71,37,34,85,4
219,Barnsley,25,6,15,70,48,22,81,5
219,Wycombe,24,8,14,69,41,28,80,6
219,Derby County,22,14,10,78,51,27,80,7
219,Portsmouth,18,17,11,62,49,13,71,8
219,Shrewsbury,19,12,15,56,51,5,69,9
219,P'borough Utd,20,8,18,69,58,11,68,10
219,Charlton Ath,17,14,15,68,56,12,65,11
219,Fleetwood Town,15,16,15,49,46,3,61,12
219,Exeter City,15,13,18,60,62,-2,58,13
219,Lincoln City,12,22,12,44,49,-5,58,14
219,Bristol Rovers,14,13,19,60,72,-12,55,15
219,Port Vale,15,10,21,48,66,-18,55,16
219,Cheltenham,15,9,22,38,57,-19,54,17
219,MK Dons,14,8,24,44,65,-21,50,18
219,Acc'ton Stanley,12,11,23,44,76,-32,47,19
219,Oxford United,12,9,25,46,62,-16,45,20
219,Morecambe,11,11,24,45,74,-29,44,21
219,Burton Albion,11,10,25,55,88,-33,43,22
219,Cambridge Utd,9,7,30,36,83,-47,34,23
219,FG Rovers,6,9,31,34,89,-55,27,24
220,Sheffield Weds,30,11,5,88,39,49,101,1
220,Plymouth Argyle,26,13,7,82,49,33,91,2
220,Barnsley,26,10,10,74,45,29,88,3
220,Ipswich Town,24,15,7,86,46,40,87,4
220,Derby County,25,12,9,81,41,40,87,5
220,Bolton,24,12,10,65,35,30,84,6
220,Wycombe,24,7,15,71,46,25,79,7
220,Portsmouth,21,13,12,69,52,17,76,8
220,P'borough Utd,22,6,18,69,55,14,72,9
220,Charlton Ath,18,14,14,70,57,13,68,10
220,Lincoln City,15,21,10,52,45,7,66,11
220,Fleetwood Town,15,16,15,53,51,2,61,12
220,Shrewsbury,17,8,21,52,56,-4,59,13
220,Bristol Rovers,14,13,19,60,73,-13,55,14
220,Exeter City,14,12,20,58,68,-10,54,15
220,Oxford United,13,11,22,51,56,-5,50,16
220,Port Vale,13,11,22,42,66,-24,50,17
220,Acc'ton Stanley,12,12,22,38,65,-27,48,18
220,Cheltenham,12,11,23,35,61,-26,47,19
220,Morecambe,10,15,21,46,70,-24,45,20
220,Burton Albion,9,14,23,56,90,-34,41,21
220,Cambridge Utd,11,8,27,35,75,-40,41,22
220,MK Dons,10,9,27,41,75,-34,39,23
220,FG Rovers,5,10,31,33,91,-58,25,24
221,Plymouth Argyle,29,12,5,95,48,47,99,1
221,Sheffield Weds,28,12,6,81,31,50,96,2
221,Ipswich Town,26,12,8,84,41,43,90,3
221,Barnsley,26,9,11,81,44,37,87,4
221,Bolton,25,10,11,68,37,31,85,5
221,Derby County,23,13,10,72,43,29,82,6
221,Wycombe,23,9,14,68,45,23,78,7
221,P'borough Utd,24,6,16,73,54,19,78,8
221,Portsmouth,17,15,14,62,51,11,66,9
221,Port Vale,19,8,19,49,61,-12,65,10
221,Charlton Ath,17,13,16,62,59,3,64,11
221,Shrewsbury,18,9,19,46,51,-5,63,12
221,Fleetwood Town,15,13,18,48,47,1,58,13
221,Exeter City,15,12,19,54,58,-4,57,14
221,Lincoln City,12,21,13,38,48,-10,57,15
221,Cheltenham,13,12,21,32,51,-19,51,16
221,Bristol Rovers,14,9,23,60,81,-21,51,17
221,Oxford United,12,13,21,42,52,-10,49,18
221,Cambridge Utd,14,7,25,41,68,-27,49,19
221,Acc'ton Stanley,11,13,22,40,66,-26,46,20
221,MK Dons,12,9,25,40,66,-26,45,21
221,Burton Albion,10,12,24,51,88,-37,42,22
221,Morecambe,8,12,26,38,78,-40,36,23
221,FG Rovers,6,9,31,40,97,-57,27,24
222,Sheffield Weds,31,10,5,82,36,46,103,1
222,Plymouth Argyle,28,11,7,80,46,34,95,2
222,Ipswich Town,26,13,7,87,44,43,91,3
222,Barnsley,26,9,11,75,40,35,87,4
222,Bolton,25,10,11,71,38,33,85,5
222,Derby County,24,11,11,75,43,32,83,6
222,Wycombe,23,8,15,61,43,18,77,7
222,Portsmouth,19,16,11,74,55,19,73,8
222,Fleetwood Town,19,13,14,51,40,11,70,9
222,Shrewsbury,20,9,17,62,50,12,69,10
222,P'borough Utd,20,6,20,71,66,5,66,11
222,Charlton Ath,14,16,16,63,58,5,58,12
222,Exeter City,15,12,19,55,56,-1,57,13
222,Lincoln City,11,22,13,46,52,-6,55,14
222,Oxford United,14,12,20,58,60,-2,54,15
222,Burton Albion,14,10,22,51,80,-29,52,16
222,Cambridge Utd,14,8,24,40,66,-26,50,17
222,Bristol Rovers,13,10,23,61,79,-18,49,18
222,Port Vale,12,11,23,40,68,-28,47,19
222,Morecambe,11,13,22,47,78,-31,46,20
222,Cheltenham,10,13,23,36,64,-28,43,21
222,Acc'ton Stanley,9,12,25,38,80,-42,39,22
222,MK Dons,9,10,27,35,69,-34,37,23
222,FG Rovers,8,9,29,38,86,-48,33,24
223,Sheffield Weds,29,13,4,87,30,57,100,1
223,Plymouth Argyle,30,10,6,94,49,45,100,2
223,Ipswich Town,27,13,6,88,40,48,94,3
223,Barnsley,27,6,13,72,43,29,87,4
223,Bolton,24,12,10,69,39,30,84,5
223,Wycombe,23,8,15,64,43,21,77,6
223,Derby County,21,10,15,65,48,17,73,7
223,P'borough Utd,22,7,17,76,62,14,73,8
223,Portsmouth,19,16,11,62,49,13,73,9
223,Lincoln City,16,19,11,49,48,1,67,10
223,Fleetwood Town,17,14,15,58,52,6,65,11
223,Charlton Ath,15,16,15,68,58,10,61,12
223,Oxford United,15,13,18,55,57,-2,58,13
223,Exeter City,16,9,21,60,65,-5,57,14
223,Bristol Rovers,15,10,21,65,82,-17,55,15
223,Shrewsbury,15,9,22,51,60,-9,54,16
223,Burton Albion,15,8,23,59,82,-23,53,17
223,Port Vale,13,10,23,47,70,-23,49,18
223,Acc'ton Stanley,11,11,24,38,68,-30,44,19
223,Morecambe,9,16,21,46,72,-26,43,20
223,Cheltenham,12,6,28,33,66,-33,42,21
223,MK Dons,10,10,26,41,70,-29,40,22
223,Cambridge Utd,11,7,28,35,80,-45,40,23
223,FG Rovers,8,11,27,44,93,-49,35,24
224,Sheffield Weds,31,11,4,79,29,50,104,1
224,Plymouth Argyle,27,10,9,88,51,37,91,2
224,Barnsley,26,11,9,72,37,35,89,3
224,Derby County,25,12,9,77,41,36,87,4
224,Ipswich Town,21,17,8,77,48,29,80,5
224,Bolton,22,12,12,64,36,28,78,6
224,Wycombe,23,9,14,68,46,22,78,7
224,P'borough Utd,23,5,18,80,64,16,74,8
224,Shrewsbury,19,9,18,54,50,4,66,9
224,Portsmouth,17,15,14,58,57,1,66,10
224,Lincoln City,14,19,13,46,46,0,61,11
224,Charlton Ath,14,17,15,63,57,6,59,12
224,Exeter City,16,10,20,60,60,0,58,13
224,Burton Albion,15,13,18,68,85,-17,58,14
224,Bristol Rovers,15,11,20,60,73,-13,56,15
224,Fleetwood Town,12,19,15,45,43,2,55,16
224,Port Vale,13,12,21,47,65,-18,51,17
224,MK Dons,14,9,23,46,64,-18,51,18
224,Oxford United,12,12,22,50,58,-8,48,19
224,Acc'ton Stanley,10,15,21,36,69,-33,45,20
224,Cambridge Utd,12,8,26,38,73,-35,44,21
224,Cheltenham,11,8,27,33,68,-35,41,22
224,FG Rovers,9,10,27,37,85,-48,37,23
224,Morecambe,7,14,25,39,80,-41,35,24
225,Plymouth Argyle,28,12,6,87,48,39,96,1
225,Ipswich Town,26,14,6,86,40,46,92,2
225,Derby County,26,12,8,77,36,41,90,3
225,Sheffield Weds,26,11,9,81,36,45,89,4
225,Wycombe,27,6,13,78,46,32,87,5
225,P'borough Utd,27,4,15,87,50,37,85,6
225,Bolton,25,10,11,68,38,30,85,7
225,Barnsley,24,9,13,70,43,27,81,8
225,Shrewsbury,19,10,17,52,52,0,67,9
225,Portsmouth,16,17,13,61,58,3,65,10
225,Fleetwood Town,17,13,16,54,47,7,64,11
225,Lincoln City,12,21,13,41,46,-5,57,12
225,Charlton Ath,14,14,18,62,63,-1,56,13
225,Exeter City,14,14,18,67,70,-3,56,14
225,Bristol Rovers,15,11,20,67,76,-9,56,15
225,Oxford United,14,12,20,43,55,-12,54,16
225,Cheltenham,14,8,24,38,65,-27,50,17
225,Port Vale,12,11,23,39,66,-27,47,18
225,Morecambe,11,12,23,48,75,-27,45,19
225,Acc'ton Stanley,9,17,20,40,73,-33,44,20
225,Burton Albion,10,12,24,51,88,-37,42,21
225,Cambridge Utd,11,9,26,40,80,-40,42,22
225,MK Dons,9,10,27,39,69,-30,37,23
225,FG Rovers,6,11,29,34,90,-56,29,24
226,Sheffield Weds,30,11,5,79,28,51,101,1
226,Plymouth Argyle,29,11,6,85,52,33,98,2
226,Ipswich Town,26,15,5,89,43,46,93,3
226,Derby County,24,12,10,79,40,39,84,4
226,Bolton,23,11,12,65,41,24,80,5
226,Barnsley,23,10,13,66,41,25,79,6
226,Wycombe,22,11,13,61,45,16,77,7
226,Portsmouth,20,15,11,63,51,12,75,8
226,P'borough Utd,22,7,17,78,57,21,73,9
226,Shrewsbury,17,13,16,50,49,1,64,10
226,Fleetwood Town,15,17,14,51,48,3,62,11
226,Charlton Ath,14,15,17,63,64,-1,57,12
226,Acc'ton Stanley,15,11,20,41,68,-27,56,13
226,Exeter City,14,12,20,58,63,-5,54,14
226,Bristol Rovers,14,12,20,61,75,-14,54,15
226,Port Vale,15,9,22,49,67,-18,54,16
226,Lincoln City,9,24,13,41,49,-8,51,17
226,Oxford United,13,10,23,45,59,-14,49,18
226,Burton Albion,12,10,24,61,88,-27,46,19
226,Cheltenham,12,9,25,34,65,-31,45,20
226,Morecambe,10,14,22,48,73,-25,44,21
226,MK Dons,11,10,25,45,67,-22,43,22
226,Cambridge Utd,12,7,27,41,75,-34,43,23
226,FG Rovers,7,10,29,38,83,-45,31,24
227,Sheffield Weds,33,9,4,89,28,61,108,1
227,Plymouth Argyle,26,10,10,77,53,24,88,2
227,Derby County,24,13,9,75,38,37,85,3
227,Bolton,23,12,11,65,33,32,81,4
227,Ipswich Town,21,18,7,79,48,31,81,5
227,Wycombe,22,12,12,62,38,24,78,6
227,Barnsley,23,9,14,62,42,20,78,7
227,Portsmouth,18,17,11,69,55,14,71,8
227,Shrewsbury,20,10,16,57,47,10,70,9
227,Lincoln City,16,21,9,49,40,9,69,10
227,P'borough Utd,20,4,22,69,61,8,64,11
227,Exeter City,16,12,18,55,56,-1,60,12
227,Fleetwood Town,14,17,15,46,43,3,59,13
227,Bristol Rovers,16,11,19,64,74,-10,59,14
227,Charlton Ath,14,16,16,58,57,1,58,15
227,Port Vale,15,11,20,47,65,-18,56,16
227,Oxford United,13,12,21,48,57,-9,51,17
227,MK Dons,15,6,25,41,70,-29,51,18
227,Acc'ton Stanley,13,10,23,46,70,-24,49,19
227,Burton Albion,12,11,23,57,85,-28,47,20
227,Morecambe,10,15,21,48,72,-24,45,21
227,Cheltenham,11,9,26,33,68,-35,42,22
227,Cambridge Utd,9,9,28,34,70,-36,36,23
227,FG Rovers,6,10,30,32,92,-60,28,24
228,Sheffield Weds,28,12,6,80,32,48,96,1
228,Plymouth Argyle,26,13,7,86,52,34,91,2
228,Bolton,25,10,11,68,35,33,85,3
228,Barnsley,25,8,13,74,44,30,83,4
228,Wycombe,25,8,13,66,39,27,83,5
228,Ipswich Town,23,13,10,84,50,34,82,6
228,Derby County,22,12,12,77,43,34,78,7
228,P'borough Utd,23,4,19,77,65,12,73,8
228,Portsmouth,17,17,12,64,49,15,68,9
228,Exeter City,17,14,15,63,59,4,65,10
228,Shrewsbury,19,7,20,53,55,-2,64,11
228,Fleetwood Town,16,14,16,50,47,3,62,12
228,Bristol Rovers,17,9,20,65,78,-13,60,13
228,Charlton Ath,15,14,17,65,65,0,59,14
228,Lincoln City,11,23,12,44,48,-4,56,15
228,Port Vale,16,8,22,47,68,-21,56,16
228,Oxford United,14,13,19,52,58,-6,55,17
228,MK Dons,16,7,23,53,68,-15,55,18
228,Morecambe,13,14,19,54,69,-15,53,19
228,Burton Albion,10,12,24,52,96,-44,42,20
228,Acc'ton Stanley,10,11,25,41,79,-38,41,21
228,FG Rovers,9,12,25,39,80,-41,39,22
228,Cambridge Utd,11,5,30,36,79,-43,38,23
228,Cheltenham,9,10,27,37,69,-32,37,24
229,Barnsley,29,8,9,84,37,47,95,1
229,Sheffield Weds,27,12,7,91,43,48,93,2
229,Bolton,28,8,10,77,34,43,92,3
229,Derby County,26,11,9,77,38,39,89,4
229,Plymouth Argyle,26,11,9,81,48,33,89,5
229,Wycombe,27,7,12,70,41,29,88,6
229,Ipswich Town,23,15,8,82,44,38,84,7
229,Portsmouth,22,12,12,67,50,17,78,8
229,P'borough Utd,21,7,18,75,57,18,70,9
229,Lincoln City,16,19,11,48,49,-1,67,10
229,Shrewsbury,17,12,17,55,54,1,63,11
229,Port Vale,17,11,18,54,62,-8,62,12
229,Exeter City,16,11,19,60,68,-8,59,13
229,Charlton Ath,14,15,17,66,65,1,57,14
229,Fleetwood Town,13,16,17,51,52,-1,55,15
229,Bristol Rovers,13,12,21,65,82,-17,51,16
229,Acc'ton Stanley,13,10,23,39,77,-38,49,17
229,Oxford United,11,12,23,44,64,-20,45,18
229,MK Dons,12,9,25,45,73,-28,45,19
229,Cheltenham,10,12,24,46,75,-29,42,20
229,Burton Albion,10,12,24,52,88,-36,42,21
229,Cambridge Utd,10,10,26,33,66,-33,40,22
229,Morecambe,9,10,27,42,76,-34,37,23
229,FG Rovers,5,12,29,32,93,-61,27,24
230,Sheffield Weds,30,11,5,86,34,52,101,1
230,Plymouth Argyle,28,11,7,84,50,34,95,2
230,Barnsley,28,8,10,76,40,36,92,3
230,Bolton,26,11,9,74,35,39,89,4
230,Ipswich Town,23,16,7,81,47,34,85,5
230,Wycombe,23,10,13,62,43,19,79,6
230,Derby County,22,11,13,67,46,21,77,7
230,P'borough Utd,22,6,18,74,53,21,72,8
230,Portsmouth,18,17,11,62,52,10,71,9
230,Shrewsbury,19,10,17,52,48,4,67,10
230,Lincoln City,15,22,9,53,50,3,67,11
230,Charlton Ath,17,14,15,73,58,15,65,12
230,Fleetwood Town,15,15,16,50,44,6,60,13
230,Bristol Rovers,16,10,20,67,79,-12,58,14
230,Port Vale,15,9,22,47,66,-19,54,15
230,Exeter City,13,12,21,50,64,-14,51,16
230,Oxford United,12,12,22,46,60,-14,48,17
230,Burton Albion,12,12,22,57,79,-22,48,18
230,Cheltenham,12,10,24,33,61,-28,46,19
230,MK Dons,12,9,25,40,66,-26,45,20
230,Acc'ton Stanley,10,13,23,36,67,-31,43,21
230,Cambridge Utd,10,8,28,32,77,-45,38,22
230,Morecambe,8,12,26,43,78,-35,36,23
230,FG Rovers,7,9,30,35,83,-48,30,24
231,Sheffield Weds,31,12,3,87,28,59,105,1
231,Plymouth Argyle,27,11,8,84,55,29,92,2
231,Ipswich Town,26,13,7,83,38,45,91,3
231,Barnsley,27,8,11,79,45,34,89,4
231,Derby County,25,10,11,78,44,34,85,5
231,Bolton,24,12,10,76,41,35,84,6
231,Wycombe,24,8,14,74,45,29,80,7
231,P'borough Utd,24,5,17,87,57,30,77,8
231,Portsmouth,21,14,11,68,52,16,77,9
231,Shrewsbury,21,7,18,56,50,6,70,10
231,Fleetwood Town,15,17,14,54,48,6,62,11
231,Exeter City,17,10,19,61,60,1,61,12
231,Charlton Ath,15,15,16,67,61,6,60,13
231,Lincoln City,11,21,14,40,52,-12,54,14
231,Port Vale,13,12,21,46,69,-23,51,15
231,Oxford United,12,14,20,49,57,-8,50,16
231,Bristol Rovers,13,11,22,62,82,-20,50,17
231,Burton Albion,13,9,24,56,90,-34,48,18
231,Cheltenham,12,8,26,34,63,-29,44,19
231,Cambridge Utd,11,9,26,39,73,-34,42,20
231,Morecambe,9,14,23,45,75,-30,41,21
231,MK Dons,10,11,25,40,73,-33,41,22
231,Acc'ton Stanley,8,12,26,32,87,-55,36,23
231,FG Rovers,6,11,29,32,84,-52,29,24
232,Plymouth Argyle,30,8,8,98,51,47,98,1
232,Sheffield Weds,28,13,5,88,37,51,97,2
232,Barnsley,27,9,10,83,47,36,90,3
232,Derby County,25,12,9,73,43,30,87,4
232,Bolton,25,11,10,72,32,40,86,5
232,Ipswich Town,23,15,8,80,44,36,84,6
232,Wycombe,24,9,13,66,41,25,81,7
232,Portsmouth,19,14,13,70,53,17,71,8
232,Shrewsbury,20,8,18,56,53,3,68,9
232,P'borough Utd,20,6,20,71,59,12,66,10
232,Charlton Ath,17,15,14,66,56,10,66,11
232,Lincoln City,15,21,10,46,44,2,66,12
232,Fleetwood Town,15,18,13,47,40,7,63,13
232,Exeter City,14,15,17,58,59,-1,57,14
232,Oxford United,13,13,20,49,58,-9,52,15
232,Port Vale,15,7,24,46,63,-17,52,16
232,Bristol Rovers,14,10,22,59,84,-25,52,17
232,Cambridge Utd,14,6,26,39,79,-40,48,18
232,MK Dons,13,8,25,47,71,-24,47,19
232,Burton Albion,12,9,25,50,91,-41,45,20
232,Acc'ton Stanley,10,14,22,37,71,-34,44,21
232,Cheltenham,11,7,28,35,69,-34,40,22
232,Morecambe,7,12,27,39,80,-41,33,23
232,FG Rovers,6,10,30,37,87,-50,28,24
233,Sheffield Weds,33,10,3,86,26,60,109,1
233,Plymouth Argyle,27,11,8,87,59,28,92,2
233,Barnsley,27,10,9,78,40,38,91,3
233,Ipswich Town,24,14,8,80,42,38,86,4
233,Bolton,25,9,12,69,37,32,84,5
233,Derby County,22,15,9,70,38,32,81,6
233,Wycombe,23,8,15,67,45,22,77,7
233,P'borough Utd,23,5,18,79,54,25,74,8
233,Portsmouth,18,15,13,62,50,12,69,9
233,Shrewsbury,18,9,19,52,60,-8,63,10
233,Charlton Ath,17,11,18,65,61,4,62,11
233,Fleetwood Town,15,17,14,45,41,4,62,12
233,Lincoln City,12,24,10,47,45,2,60,13
233,Exeter City,13,16,17,57,60,-3,55,14
233,Port Vale,15,8,23,50,66,-16,53,15
233,Cheltenham,14,10,22,36,60,-24,52,16
233,Bristol Rovers,13,10,23,57,82,-25,49,17
233,Burton Albion,12,10,24,53,84,-31,46,18
233,Morecambe,11,12,23,48,74,-26,45,19
233,Acc'ton Stanley,11,12,23,38,75,-37,45,20
233,Oxford United,11,11,24,45,59,-14,44,21
233,Cambridge Utd,12,8,26,38,71,-33,44,22
233,MK Dons,11,10,25,41,71,-30,43,23
233,FG Rovers,7,11,28,35,85,-50,32,24
234,Sheffield Weds,30,12,4,82,28,54,102,1
234,Ipswich Town,26,13,7,94,46,48,91,2
234,Derby County,26,10,10,84,44,40,88,3
234,Plymouth Argyle,25,13,8,80,54,26,88,4
234,Barnsley,25,11,10,75,39,36,86,5
234,Wycombe,24,9,13,71,45,26,81,6
234,P'borough Utd,24,7,15,73,50,23,79,7
234,Bolton,21,12,13,59,38,21,75,8
234,Portsmouth,19,16,11,65,49,16,73,9
234,Shrewsbury,21,9,16,60,52,8,72,10
234,Charlton Ath,18,14,14,68,55,13,68,11
234,Lincoln City,12,21,13,38,44,-6,57,12
234,Fleetwood Town,13,17,16,51,50,1,56,13
234,Exeter City,14,14,18,62,68,-6,56,14
234,Oxford United,13,13,20,45,60,-15,52,15
234,Burton Albion,13,11,22,55,89,-34,50,16
234,Bristol Rovers,13,10,23,58,81,-23,49,17
234,Port Vale,12,12,22,42,62,-20,48,18
234,MK Dons,13,9,24,41,62,-21,48,19
234,Cheltenham,11,10,25,34,64,-30,43,20
234,Morecambe,8,16,22,41,72,-31,40,21
234,Acc'ton Stanley,8,14,24,34,73,-39,38,22
234,FG Rovers,8,12,26,42,86,-44,36,23
234,Cambridge Utd,9,7,30,37,80,-43,34,24
235,Sheffield Weds,29,13,4,82,28,54,100,1
235,Ipswich Town,25,17,4,91,39,52,92,2
235,Plymouth Argyle,25,13,8,82,57,25,88,3
235,Barnsley,26,8,12,74,45,29,86,4
235,Bolton,24,9,13,63,38,25,81,5
235,Wycombe,23,11,12,71,45,26,80,6
235,P'borough Utd,24,8,14,73,50,23,80,7
235,Derby County,21,16,9,66,40,26,79,8
235,Portsmouth,19,17,10,70,50,20,74,9
235,Shrewsbury,21,9,16,62,50,12,72,10
235,Fleetwood Town,15,14,17,52,47,5,59,11
235,Lincoln City,11,24,11,39,42,-3,57,12
235,Charlton Ath,14,15,17,67,73,-6,57,13
235,Port Vale,15,11,20,49,66,-17,56,14
235,Exeter City,15,10,21,62,68,-6,55,15
235,Bristol Rovers,15,9,22,67,78,-11,54,16
235,Cheltenham,12,11,23,36,63,-27,47,17
235,Cambridge Utd,12,10,24,42,70,-28,46,18
235,Acc'ton Stanley,11,13,22,40,72,-32,46,19
235,Oxford United,11,11,24,50,66,-16,44,20
235,Morecambe,10,13,23,46,81,-35,43,21
235,MK Dons,11,9,26,35,69,-34,42,22
235,Burton Albion,10,11,25,56,88,-32,41,23
235,FG Rovers,7,10,29,39,89,-50,31,24
236,Sheffield Weds,30,11,5,81,30,51,101,1
236,Plymouth Argyle,29,9,8,90,52,38,96,2
236,Barnsley,26,11,9,75,39,36,89,3
236,Derby County,25,12,9,73,41,32,87,4
236,Ipswich Town,22,18,6,78,43,35,84,5
236,Bolton,23,11,12,65,39,26,80,6
236,P'borough Utd,23,6,17,80,61,19,75,7
236,Wycombe,21,10,15,62,51,11,73,8
236,Portsmouth,20,12,14,63,52,11,72,9
236,Shrewsbury,19,9,18,56,52,4,66,10
236,Fleetwood Town,14,19,13,52,49,3,61,11
236,Exeter City,16,13,17,60,59,1,61,12
236,Charlton Ath,15,13,18,64,59,5,58,13
236,Lincoln City,12,22,12,52,49,3,58,14
236,Bristol Rovers,16,9,21,69,81,-12,57,15
236,Burton Albion,14,11,21,58,83,-25,53,16
236,Port Vale,15,8,23,46,72,-26,53,17
236,Cheltenham,12,12,22,35,59,-24,48,18
236,Oxford United,12,11,23,48,69,-21,47,19
236,Cambridge Utd,12,10,24,40,69,-29,46,20
236,MK Dons,12,9,25,44,65,-21,45,21
236,Morecambe,8,14,24,39,74,-35,38,22
236,Acc'ton Stanley,7,14,25,32,70,-38,35,23
236,FG Rovers,7,10,29,35,79,-44,31,24
237,Sheffield Weds,31,10,5,89,34,55,103,1
237,Ipswich Town,27,13,6,89,44,45,94,2
237,Plymouth Argyle,26,11,9,79,55,24,89,3
237,Bolton,23,13,10,68,34,34,82,4
237,Derby County,24,10,12,73,43,30,82,5
237,Barnsley,23,11,12,66,42,24,80,6
237,Wycombe,23,7,16,68,47,21,76,7
237,Portsmouth,20,14,12,70,54,16,74,8
237,Shrewsbury,21,7,18,56,50,6,70,9
237,P'borough Utd,20,6,20,72,66,6,66,10
237,Charlton Ath,16,15,15,69,65,4,63,11
237,Exeter City,17,11,18,60,62,-2,62,12
237,Bristol Rovers,16,11,19,68,76,-8,59,13
237,Oxford United,15,12,19,56,57,-1,57,14
237,Fleetwood Town,13,17,16,51,52,-1,56,15
237,Lincoln City,11,21,14,47,56,-9,54,16
237,Port Vale,15,9,22,48,67,-19,54,17
237,Burton Albion,13,11,22,55,82,-27,50,18
237,Acc'ton Stanley,10,14,22,39,68,-29,44,19
237,Cheltenham,11,11,24,38,67,-29,44,20
237,MK Dons,11,10,25,43,66,-23,43,21
237,Morecambe,10,12,24,47,76,-29,42,22
237,FG Rovers,9,11,26,37,80,-43,38,23
237,Cambridge Utd,10,7,29,39,84,-45,37,24
238,Sheffield Weds,29,13,4,97,33,64,100,1
238,Barnsley,27,9,10,79,46,33,90,2
238,Plymouth Argyle,27,8,11,93,52,41,89,3
238,Derby County,25,12,9,78,44,34,87,4
238,Ipswich Town,23,17,6,84,49,35,86,5
238,Bolton,23,11,12,69,40,29,80,6
238,Wycombe,21,10,15,57,43,14,73,7
238,P'borough Utd,20,9,17,73,55,18,69,8
238,Portsmouth,19,12,15,68,58,10,69,9
238,Exeter City,18,11,17,62,62,0,65,10
238,Port Vale,18,9,19,51,61,-10,63,11
238,Fleetwood Town,16,14,16,57,49,8,62,12
238,Shrewsbury,17,11,18,52,60,-8,62,13
238,Charlton Ath,15,13,18,65,65,0,58,14
238,Lincoln City,12,21,13,45,53,-8,57,15
238,Oxford United,13,14,19,46,53,-7,53,16
238,Bristol Rovers,14,10,22,68,82,-14,52,17
238,Burton Albion,13,13,20,54,86,-32,52,18
238,Acc'ton Stanley,12,13,21,38,69,-31,49,19
238,Cheltenham,12,12,22,35,57,-22,48,20
238,MK Dons,11,9,26,46,75,-29,42,21
238,Morecambe,8,15,23,48,76,-28,39,22
238,Cambridge Utd,10,8,28,33,73,-40,38,23
238,FG Rovers,6,12,28,32,89,-57,30,24
239,Sheffield Weds,29,11,6,80,36,44,98,1
239,Plymouth Argyle,29,9,8,80,46,34,96,2
239,Derby County,25,12,9,73,37,36,87,3
239,Barnsley,25,10,11,70,43,27,85,4
239,P'borough Utd,26,4,16,82,54,28,82,5
239,Ipswich Town,22,15,9,81,50,31,81,6
239,Wycombe,25,6,15,64,41,23,81,7
239,Bolton,21,13,12,61,40,21,76,8
239,Shrewsbury,22,7,17,63,50,13,73,9
239,Portsmouth,19,15,12,62,47,15,72,10
239,Charlton Ath,18,12,16,66,58,8,66,11
239,Fleetwood Town,15,16,15,49,44,5,61,12
239,Lincoln City,13,21,12,42,44,-2,60,13
239,Exeter City,16,11,19,61,65,-4,59,14
239,Port Vale,16,9,21,46,65,-19,57,15
239,Bristol Rovers,14,9,23,59,80,-21,51,16
239,Oxford United,13,10,23,50,61,-11,49,17
239,Cheltenham,12,10,24,35,60,-25,46,18
239,Morecambe,11,12,23,48,73,-25,45,19
239,MK Dons,12,9,25,39,64,-25,45,20
239,Burton Albion,11,10,25,50,84,-34,43,21
239,Acc'ton Stanley,8,16,22,36,70,-34,40,22
239,Cambridge Utd,11,7,28,34,71,-37,40,23
239,FG Rovers,6,12,28,31,79,-48,30,24
240,Sheffield Weds,32,11,3,82,28,54,107,1
240,Plymouth Argyle,28,12,6,90,48,42,96,2
240,Ipswich Town,26,12,8,86,47,39,90,3
240,Derby County,25,13,8,77,39,38,88,4
240,Barnsley,23,11,12,65,40,25,80,5
240,Wycombe,24,7,15,73,50,23,79,6
240,Bolton,21,12,13,63,39,24,75,7
240,P'borough Utd,21,10,15,84,61,23,73,8
240,Fleetwood Town,20,13,13,57,44,13,73,9
240,Portsmouth,18,15,13,60,55,5,69,10
240,Shrewsbury,17,9,20,52,56,-4,60,11
240,Exeter City,15,13,18,58,63,-5,58,12
240,Lincoln City,12,20,14,40,50,-10,56,13
240,Charlton Ath,12,19,15,55,57,-2,55,14
240,Bristol Rovers,14,11,21,67,79,-12,53,15
240,Port Vale,14,11,21,44,65,-21,53,16
240,Acc'ton Stanley,13,12,21,45,69,-24,51,17
240,Oxford United,11,14,21,43,55,-12,47,18
240,Cambridge Utd,12,10,24,41,70,-29,46,19
240,Cheltenham,13,7,26,34,64,-30,46,20
240,Morecambe,10,15,21,41,70,-29,45,21
240,Burton Albion,11,11,24,56,89,-33,44,22
240,MK Dons,10,9,27,40,68,-28,39,23
240,FG Rovers,6,11,29,34,81,-47,29,24
241,Sheffield Weds,31,9,6,83,31,52,102,1
241,Plymouth Argyle,28,12,6,87,48,39,96,2
241,Bolton,26,10,10,76,36,40,88,3
241,Ipswich Town,24,14,8,84,46,38,86,4
241,Derby County,24,11,11,79,49,30,83,5
241,Barnsley,23,8,15,62,42,20,77,6
241,Shrewsbury,22,10,14,60,48,12,76,7
241,Wycombe,22,8,16,59,46,13,74,8
241,P'borough Utd,22,7,17,71,57,14,73,9
241,Portsmouth,17,19,10,62,51,11,70,10
241,Port Vale,19,9,18,54,61,-7,66,11
241,Fleetwood Town,15,14,17,47,48,-1,59,12
241,Charlton Ath,14,14,18,57,58,-1,56,13
241,Lincoln City,11,21,14,40,46,-6,54,14
241,Bristol Rovers,14,11,21,67,78,-11,53,15
241,Burton Albion,14,11,21,62,81,-19,53,16
241,Exeter City,12,13,21,50,63,-13,49,17
241,Oxford United,12,12,22,50,64,-14,48,18
241,MK Dons,12,11,23,38,64,-26,47,19
241,Cheltenham,12,10,24,34,59,-25,46,20
241,Morecambe,11,12,23,46,74,-28,45,21
241,Cambridge Utd,12,9,25,39,69,-30,45,22
241,Acc'ton Stanley,9,12,25,36,73,-37,39,23
241,FG Rovers,7,11,28,35,86,-51,32,24
242,Sheffield Weds,30,12,4,85,32,53,102,1
242,Plymouth Argyle,29,10,7,83,49,34,97,2
242,Ipswich Town,27,14,5,100,44,56,95,3
242,Barnsley,27,6,13,79,44,35,87,4
242,Bolton,24,11,11,66,38,28,83,5
242,Derby County,23,14,9,67,40,27,83,6
242,Wycombe,23,10,13,65,45,20,79,7
242,Portsmouth,20,18,8,73,46,27,78,8
242,P'borough Utd,23,5,18,74,61,13,74,9
242,Charlton Ath,16,15,15,60,56,4,63,10
242,Fleetwood Town,16,13,17,54,53,1,61,11
242,Lincoln City,13,21,12,52,49,3,60,12
242,Shrewsbury,16,12,18,51,53,-2,60,13
242,Port Vale,13,14,19,44,62,-18,53,14
242,Acc'ton Stanley,12,16,18,44,64,-20,52,15
242,Exeter City,12,13,21,60,74,-14,49,16
242,Oxford United,11,14,21,42,53,-11,47,17
242,Morecambe,10,16,20,48,76,-28,46,18
242,Bristol Rovers,11,12,23,64,85,-21,45,19
242,Burton Albion,11,11,24,54,87,-33,44,20
242,MK Dons,12,7,27,48,75,-27,43,21
242,Cheltenham,12,7,27,34,70,-36,43,22
242,FG Rovers,7,13,26,33,79,-46,34,23
242,Cambridge Utd,8,8,30,40,85,-45,32,24
243,Sheffield Weds,29,12,5,88,30,58,99,1
243,Plymouth Argyle,29,10,7,86,51,35,97,2
243,Derby County,27,9,10,78,37,41,90,3
243,Ipswich Town,24,13,9,81,42,39,85,4
243,Bolton,24,11,11,67,35,32,83,5
243,P'borough Utd,24,6,16,76,51,25,78,6
243,Wycombe,23,9,14,62,39,23,78,7
243,Barnsley,22,9,15,67,47,20,75,8
243,Portsmouth,18,15,13,60,49,11,69,9
243,Shrewsbury,19,10,17,52,50,2,67,10
243,Lincoln City,14,22,10,47,43,4,64,11
243,Bristol Rovers,18,9,19,65,76,-11,63,12
243,Charlton Ath,16,14,16,70,61,9,62,13
243,Fleetwood Town,14,17,15,49,45,4,59,14
243,Port Vale,16,8,22,51,74,-23,56,15
243,Exeter City,13,13,20,56,67,-11,52,16
243,Morecambe,13,11,22,46,67,-21,50,17
243,Oxford United,11,14,21,43,57,-14,47,18
243,Burton Albion,12,10,24,53,88,-35,46,19
243,Acc'ton Stanley,11,13,22,37,72,-35,46,20
243,Cheltenham,11,11,24,35,64,-29,44,21
243,MK Dons,10,10,26,38,70,-32,40,22
243,Cambridge Utd,10,5,31,42,86,-44,35,23
243,FG Rovers,8,11,27,38,86,-48,35,24
244,Sheffield Weds,30,11,5,86,30,56,101,1
244,Plymouth Argyle,28,10,8,98,49,49,94,2
244,Ipswich Town,23,16,7,88,50,38,85,3
244,Wycombe,26,6,14,70,42,28,84,4
244,Barnsley,24,11,11,69,40,29,83,5
244,P'borough Utd,26,5,15,83,55,28,83,6
244,Derby County,22,13,11,75,46,29,79,7
244,Bolton,23,10,13,61,36,25,79,8
244,Portsmouth,19,15,12,65,51,14,72,9
244,Shrewsbury,19,8,19,55,55,0,65,10
244,Fleetwood Town,16,14,16,49,46,3,62,11
244,Charlton Ath,14,16,16,64,65,-1,58,12
244,Lincoln City,11,24,11,45,45,0,57,13
244,Exeter City,14,12,20,57,59,-2,54,14
244,Port Vale,14,12,20,48,63,-15,54,15
244,Oxford United,12,14,20,44,55,-11,50,16
244,Acc'ton Stanley,12,14,20,45,72,-27,50,17
244,MK Dons,14,7,25,46,65,-19,49,18
244,Bristol Rovers,13,10,23,57,82,-25,49,19
244,Cheltenham,12,12,22,36,62,-26,48,20
244,Morecambe,12,11,23,47,78,-31,47,21
244,Burton Albion,11,11,24,48,104,-56,44,22
244,Cambridge Utd,9,9,28,32,69,-37,36,23
244,FG Rovers,6,13,27,36,85,-49,31,24
245,Sheffield Weds,30,13,3,84,28,56,103,1
245,Plymouth Argyle,27,11,8,83,52,31,92,2
245,Derby County,27,9,10,80,44,36,90,3
245,Ipswich Town,24,14,8,81,43,38,86,4
245,Barnsley,25,8,13,73,45,28,83,5
245,Bolton,24,10,12,66,37,29,82,6
245,Wycombe,24,7,15,70,46,24,79,7
245,P'borough Utd,23,8,15,78,53,25,77,8
245,Portsmouth,18,13,15,67,55,12,67,9
245,Charlton Ath,16,15,15,66,55,11,63,10
245,Fleetwood Town,16,15,15,51,48,3,63,11
245,Shrewsbury,17,12,17,53,54,-1,63,12
245,Port Vale,17,9,20,56,66,-10,60,13
245,Exeter City,16,11,19,57,64,-7,59,14
245,Lincoln City,10,23,13,40,52,-12,53,15
245,Burton Albion,14,10,22,60,87,-27,52,16
245,Cheltenham,13,10,23,38,58,-20,49,17
245,Bristol Rovers,13,9,24,59,91,-32,48,18
245,Oxford United,12,10,24,49,64,-15,46,19
245,MK Dons,12,8,26,42,71,-29,44,20
245,Morecambe,9,16,21,45,70,-25,43,21
245,Cambridge Utd,10,9,27,33,70,-37,39,22
245,FG Rovers,9,12,25,38,77,-39,39,23
245,Acc'ton Stanley,9,12,25,32,71,-39,39,24
246,Sheffield Weds,29,13,4,80,27,53,100,1
246,Plymouth Argyle,28,10,8,92,50,42,94,2
246,Bolton,25,12,9,72,36,36,87,3
246,Barnsley,24,9,13,67,51,16,81,4
246,Derby County,22,12,12,71,47,24,78,5
246,Ipswich Town,21,14,11,79,48,31,77,6
246,Wycombe,23,7,16,64,46,18,76,7
246,Shrewsbury,22,9,15,60,46,14,75,8
246,Portsmouth,19,15,12,65,51,14,72,9
246,P'borough Utd,20,8,18,76,58,18,68,10
246,Charlton Ath,16,16,14,60,51,9,64,11
246,Lincoln City,14,21,11,43,42,1,63,12
246,Fleetwood Town,14,16,16,51,46,5,58,13
246,Port Vale,16,10,20,52,64,-12,58,14
246,Exeter City,14,14,18,60,66,-6,56,15
246,Bristol Rovers,14,12,20,61,76,-15,54,16
246,Cheltenham,15,8,23,39,59,-20,53,17
246,Burton Albion,13,9,24,61,94,-33,48,18
246,Acc'ton Stanley,11,14,21,37,65,-28,47,19
246,MK Dons,12,7,27,41,77,-36,43,20
246,Oxford United,10,12,24,46,62,-16,42,21
246,Cambridge Utd,10,12,24,36,73,-37,42,22
246,Morecambe,7,17,22,43,73,-30,38,23
246,FG Rovers,9,11,26,36,84,-48,38,24
247,Plymouth Argyle,31,9,6,98,44,54,102,1
247,Sheffield Weds,29,11,6,86,34,52,98,2
247,Ipswich Town,24,15,7,82,43,39,87,3
247,Derby County,24,10,12,76,47,29,82,4
247,Bolton,23,12,11,67,38,29,81,5
247,Barnsley,23,10,13,69,46,23,79,6
247,Wycombe,24,7,15,61,42,19,79,7
247,P'borough Utd,23,6,17,74,57,17,75,8
247,Portsmouth,19,14,13,63,53,10,71,9
247,Shrewsbury,21,8,17,56,48,8,71,10
247,Lincoln City,15,21,10,50,44,6,66,11
247,Charlton Ath,17,13,16,73,66,7,64,12
247,Port Vale,18,9,19,53,69,-16,63,13
247,Exeter City,16,11,19,55,58,-3,59,14
247,Fleetwood Town,14,16,16,44,44,0,58,15
247,Bristol Rovers,15,11,20,64,77,-13,56,16
247,Morecambe,11,13,22,45,72,-27,46,17
247,Cambridge Utd,13,7,26,38,73,-35,46,18
247,Oxford United,11,12,23,54,69,-15,45,19
247,MK Dons,12,9,25,43,66,-23,45,20
247,Burton Albion,11,9,26,53,85,-32,42,21
247,Acc'ton Stanley,10,12,24,40,73,-33,42,22
247,Cheltenham,11,7,28,36,69,-33,40,23
247,FG Rovers,6,10,30,40,103,-63,28,24
248,Plymouth Argyle,28,10,8,93,50,43,94,1
248,Sheffield Weds,27,13,6,79,36,43,94,2
248,Barnsley,28,8,10,82,45,37,92,3
248,Derby County,23,15,8,74,43,31,84,4
248,Bolton,25,9,12,67,38,29,84,5
248,Ipswich Town,22,16,8,84,47,37,82,6
248,P'borough Utd,24,3,19,83,59,24,75,7
248,Wycombe,22,9,15,59,43,16,75,8
248,Portsmouth,19,15,12,60,51,9,72,9
248,Charlton Ath,17,14,15,63,57,6,65,10
248,Bristol Rovers,17,11,18,62,68,-6,62,11
248,Exeter City,16,13,17,66,66,0,61,12
248,Lincoln City,13,21,12,52,52,0,60,13
248,Shrewsbury,16,10,20,50,59,-9,58,14
248,Fleetwood Town,13,14,19,45,48,-3,53,15
248,Acc'ton Stanley,13,14,19,39,67,-28,53,16
248,MK Dons,15,7,24,52,65,-13,52,17
248,Oxford United,11,15,20,41,52,-11,48,18
248,Cheltenham,12,11,23,36,61,-25,47,19
248,Burton Albion,13,8,25,57,89,-32,47,20
248,Port Vale,12,10,24,42,71,-29,46,21
248,Morecambe,10,12,24,46,72,-26,42,22
248,Cambridge Utd,10,8,28,36,75,-39,38,23
248,FG Rovers,7,12,27,32,86,-54,33,24
249,Sheffield Weds,30,11,5,80,28,52,101,1
249,Plymouth Argyle,29,10,7,85,47,38,97,2
249,Barnsley,28,8,10,74,38,36,92,3
249,Bolton,25,11,10,68,39,29,86,4
249,Ipswich Town,24,13,9,83,46,37,85,5
249,Wycombe,25,8,13,64,43,21,83,6
249,Derby County,23,13,10,67,45,22,82,7
249,Portsmouth,19,16,11,67,49,18,73,8
249,P'borough Utd,21,9,16,77,63,14,72,9
249,Exeter City,17,12,17,62,58,4,63,10
249,Shrewsbury,18,8,20,54,53,1,62,11
249,Charlton Ath,15,14,17,63,66,-3,59,12
249,Port Vale,17,8,21,51,65,-14,59,13
249,Bristol Rovers,15,10,21,62,74,-12,55,14
249,Fleetwood Town,12,18,16,44,48,-4,54,15
249,Lincoln City,10,22,14,43,52,-9,52,16
249,Oxford United,14,9,23,46,61,-15,51,17
249,Burton Albion,14,8,24,64,85,-21,50,18
249,Morecambe,11,13,22,48,71,-23,46,19
249,Cheltenham,12,10,24,37,62,-25,46,20
249,Cambridge Utd,12,8,26,41,73,-32,44,21
249,MK Dons,11,9,26,42,72,-30,42,22
249,Acc'ton Stanley,9,12,25,39,71,-32,39,23
249,FG Rovers,6,10,30,35,87,-52,28,24
250,Sheffield Weds,29,13,4,84,32,52,100,1
250,Plymouth Argyle,29,10,7,88,46,42,97,2
250,Ipswich Town,26,15,5,78,35,43,93,3
250,Barnsley,27,7,12,70,42,28,88,4
250,Derby County,24,13,9,73,41,32,85,5
250,Wycombe,24,8,14,70,42,28,80,6
250,Bolton,23,11,12,66,39,27,80,7
250,Portsmouth,19,16,11,67,47,20,73,8
250,P'borough Utd,20,8,18,71,58,13,68,9
250,Shrewsbury,18,11,17,51,48,3,65,10
250,Charlton Ath,16,14,16,64,58,6,62,11
250,Lincoln City,14,20,12,51,53,-2,62,12
250,Fleetwood Town,13,20,13,50,49,1,59,13
250,Exeter City,13,15,18,57,59,-2,54,14
250,Burton Albion,15,9,22,56,88,-32,54,15
250,Bristol Rovers,13,13,20,66,77,-11,52,16
250,Port Vale,14,9,23,47,76,-29,51,17
250,Cheltenham,12,10,24,37,62,-25,46,18
250,Cambridge Utd,12,8,26,42,73,-31,44,19
250,Oxford United,10,13,23,44,62,-18,43,20
250,Morecambe,10,13,23,45,74,-29,43,21
250,MK Dons,11,9,26,42,70,-28,42,22
250,Acc'ton Stanley,10,11,25,36,76,-40,41,23
250,FG Rovers,7,10,29,36,84,-48,31,24
251,Sheffield Weds,31,12,3,92,31,61,105,1
251,Plymouth Argyle,28,11,7,85,47,38,95,2
251,Ipswich Town,26,14,6,87,45,42,92,3
251,Bolton,25,11,10,68,35,33,86,4
251,Derby County,23,12,11,69,43,26,81,5
251,Barnsley,22,11,13,68,50,18,77,6
251,P'borough Utd,24,4,18,83,61,22,76,7
251,Wycombe,21,10,15,61,44,17,73,8
251,Fleetwood Town,18,15,13,59,41,18,69,9
251,Portsmouth,16,20,10,62,54,8,68,10
251,Bristol Rovers,17,11,18,74,73,1,62,11
251,Lincoln City,12,23,11,38,39,-1,59,12
251,Shrewsbury,16,10,20,50,57,-7,58,13
251,Charlton Ath,13,17,16,66,58,8,56,14
251,Exeter City,13,14,19,54,62,-8,53,15
251,Port Vale,13,11,22,48,72,-24,50,16
251,Cheltenham,12,12,22,34,57,-23,48,17
251,Acc'ton Stanley,11,15,20,39,67,-28,48,18
251,Burton Albion,13,9,24,56,93,-37,48,19
251,Oxford United,11,14,21,48,60,-12,47,20
251,MK Dons,13,8,25,44,65,-21,47,21
251,Morecambe,9,16,21,48,77,-29,43,22
251,Cambridge Utd,11,8,27,33,73,-40,41,23
251,FG Rovers,5,10,31,32,94,-62,25,24
252,Plymouth Argyle,30,11,5,86,46,40,101,1
252,Barnsley,27,10,9,77,37,40,91,2
252,Sheffield Weds,27,10,9,76,36,40,91,3
252,Ipswich Town,24,15,7,86,41,45,87,4
252,Bolton,24,12,10,73,34,39,84,5
252,Derby County,23,12,11,75,44,31,81,6
252,Portsmouth,20,16,10,66,46,20,76,7
252,P'borough Utd,23,6,17,74,52,22,75,8
252,Wycombe,21,10,15,70,54,16,73,9
252,Shrewsbury,21,10,15,55,42,13,73,10
252,Lincoln City,15,20,11,46,42,4,65,11
252,Charlton Ath,16,15,15,61,63,-2,63,12
252,Fleetwood Town,15,16,15,49,48,1,61,13
252,Exeter City,14,14,18,56,61,-5,56,14
252,Port Vale,14,11,21,41,57,-16,53,15
252,Bristol Rovers,13,11,22,63,93,-30,50,16
252,Acc'ton Stanley,12,13,21,41,63,-22,49,17
252,Oxford United,11,12,23,46,68,-22,45,18
252,Burton Albion,11,12,23,52,80,-28,45,19
252,MK Dons,11,11,24,46,70,-24,44,20
252,Cheltenham,11,11,24,36,65,-29,44,21
252,Cambridge Utd,11,8,27,38,76,-38,41,22
252,Morecambe,7,12,27,36,80,-44,33,23
252,FG Rovers,6,12,28,40,91,-51,30,24
253,Plymouth Argyle,32,9,5,98,49,49,105,1
253,Sheffield Weds,27,13,6,84,38,46,94,2
253,Barnsley,29,6,11,79,40,39,93,3
253,Ipswich Town,22,16,8,83,50,33,82,4
253,Bolton,24,10,12,64,35,29,82,5
253,Derby County,23,12,11,78,49,29,81,6
253,P'borough Utd,23,7,16,80,59,21,76,7
253,Wycombe,21,10,15,65,46,19,73,8
253,Charlton Ath,20,12,14,82,54,28,72,9
253,Portsmouth,18,16,12,70,55,15,70,10
253,Lincoln City,16,18,12,53,46,7,66,11
253,Fleetwood Town,17,14,15,52,46,6,65,12
253,Shrewsbury,18,8,20,55,57,-2,62,13
253,Bristol Rovers,15,10,21,60,84,-24,55,14
253,Port Vale,14,12,20,49,70,-21,54,15
253,Oxford United,14,10,22,49,57,-8,52,16
253,Exeter City,13,13,20,57,66,-9,52,17
253,Morecambe,13,10,23,45,74,-29,49,18
253,MK Dons,11,11,24,42,71,-29,44,19
253,Acc'ton Stanley,9,14,23,41,71,-30,41,20
253,Burton Albion,10,11,25,56,98,-42,41,21
253,Cheltenham,10,8,28,33,73,-40,38,22
253,FG Rovers,9,11,26,40,85,-45,38,23
253,Cambridge Utd,9,9,28,32,74,-42,36,24
254,Sheffield Weds,32,11,3,84,29,55,107,1
254,Plymouth Argyle,30,9,7,96,52,44,99,2
254,Ipswich Town,26,15,5,92,40,52,93,3
254,Barnsley,26,10,10,72,37,35,88,4
254,Derby County,23,11,12,78,47,31,80,5
254,Wycombe,22,11,13,61,39,22,77,6
254,Bolton,21,12,13,68,46,22,75,7
254,Portsmouth,20,15,11,72,51,21,75,8
254,P'borough Utd,20,8,18,72,64,8,68,9
254,Shrewsbury,20,7,19,61,60,1,67,10
254,Charlton Ath,18,12,16,68,62,6,66,11
254,Fleetwood Town,15,15,16,51,50,1,60,12
254,Exeter City,15,14,17,62,59,3,59,13
254,Bristol Rovers,16,10,20,62,74,-12,58,14
254,Port Vale,15,10,21,46,68,-22,55,15
254,Lincoln City,9,25,12,39,44,-5,52,16
254,MK Dons,13,12,21,43,60,-17,51,17
254,Oxford United,12,14,20,50,61,-11,50,18
254,Cheltenham,12,11,23,35,58,-23,47,19
254,Burton Albion,10,12,24,46,86,-40,42,20
254,Cambridge Utd,11,7,28,35,75,-40,40,21
254,Morecambe,9,12,25,45,80,-35,39,22
254,Acc'ton Stanley,8,12,26,33,71,-38,36,23
254,FG Rovers,6,11,29,34,92,-58,29,24
255,Sheffield Weds,29,11,6,88,40,48,98,1
255,Plymouth Argyle,30,8,8,85,46,39,98,2
255,Barnsley,28,7,11,79,41,38,91,3
255,Derby County,23,12,11,68,41,27,81,4
255,Bolton,23,11,12,65,35,30,80,5
255,Wycombe,24,7,15,61,45,16,79,6
255,P'borough Utd,23,7,16,81,58,23,76,7
255,Portsmouth,20,16,10,64,47,17,76,8
255,Ipswich Town,19,18,9,80,49,31,75,9
255,Lincoln City,14,22,10,50,45,5,64,10
255,Port Vale,18,10,18,51,57,-6,64,11
255,Shrewsbury,17,12,17,57,57,0,63,12
255,Fleetwood Town,15,15,16,51,49,2,60,13
255,Exeter City,16,12,18,65,66,-1,60,14
255,Bristol Rovers,17,9,20,64,74,-10,60,15
255,Charlton Ath,15,13,18,58,60,-2,58,16
255,Cheltenham,14,10,22,35,55,-20,52,17
255,Oxford United,14,9,23,50,62,-12,51,18
255,MK Dons,12,7,27,40,67,-27,43,19
255,Burton Albion,11,10,25,50,89,-39,43,20
255,Cambridge Utd,10,11,25,34,71,-37,41,21
255,Acc'ton Stanley,9,12,25,39,72,-33,39,22
255,Morecambe,7,15,24,38,77,-39,36,23
255,FG Rovers,7,10,29,32,82,-50,31,24
256,Sheffield Weds,30,11,5,85,36,49,101,1
256,Barnsley,31,6,9,83,36,47,99,2
256,Derby County,27,10,9,80,40,40,91,3
256,Plymouth Argyle,27,10,9,81,50,31,91,4
256,Ipswich Town,24,13,9,82,49,33,85,5
256,Wycombe,24,9,13,69,39,30,81,6
256,Bolton,23,12,11,66,39,27,81,7
256,P'borough Utd,22,7,17,78,53,25,73,8
256,Portsmouth,17,17,12,70,56,14,68,9
256,Charlton Ath,19,11,16,70,59,11,68,10
256,Exeter City,18,10,18,61,61,0,64,11
256,Shrewsbury,18,9,19,56,56,0,63,12
256,Burton Albion,16,9,21,56,80,-24,57,13
256,Fleetwood Town,13,17,16,44,43,1,56,14
256,Lincoln City,12,20,14,40,48,-8,56,15
256,Bristol Rovers,15,9,22,64,81,-17,54,16
256,Port Vale,14,11,21,50,73,-23,53,17
256,Acc'ton Stanley,12,12,22,38,68,-30,48,18
256,Cheltenham,12,10,24,32,61,-29,46,19
256,Oxford United,10,15,21,45,56,-11,45,20
256,Morecambe,8,15,23,41,76,-35,39,21
256,MK Dons,9,11,26,40,70,-30,38,22
256,Cambridge Utd,10,6,30,37,79,-42,36,23
256,FG Rovers,6,10,30,33,92,-59,28,24
257,Sheffield Weds,30,12,4,84,32,52,102,1
257,Plymouth Argyle,28,10,8,84,48,36,94,2
257,Derby County,25,11,10,78,47,31,86,3
257,Ipswich Town,23,15,8,80,39,41,84,4
257,Barnsley,24,12,10,70,40,30,84,5
257,Bolton,23,10,13,64,38,26,79,6
257,P'borough Utd,23,8,15,81,59,22,77,7
257,Wycombe,22,9,15,61,44,17,75,8
257,Portsmouth,18,17,11,64,46,18,71,9
257,Shrewsbury,18,11,17,52,47,5,65,10
257,Fleetwood Town,16,17,13,48,43,5,65,11
257,Exeter City,17,12,17,62,55,7,63,12
257,Charlton Ath,13,18,15,56,59,-3,57,13
257,Lincoln City,11,22,13,40,46,-6,55,14
257,Port Vale,14,11,21,47,64,-17,53,15
257,Bristol Rovers,13,12,21,64,80,-16,51,16
257,Oxford United,12,14,20,47,60,-13,50,17
257,Burton Albion,13,11,22,62,87,-25,50,18
257,Cheltenham,13,8,25,40,60,-20,47,19
257,Acc'ton Stanley,9,17,20,34,71,-37,44,20
257,Morecambe,9,15,22,42,70,-28,42,21
257,MK Dons,10,10,26,40,70,-30,40,22
257,FG Rovers,8,13,25,40,86,-46,37,23
257,Cambridge Utd,8,9,29,33,82,-49,33,24
258,Sheffield Weds,32,11,3,90,30,60,107,1
258,Plymouth Argyle,27,12,7,87,46,41,93,2
258,Derby County,25,11,10,76,43,33,86,3
258,Barnsley,26,8,12,71,44,27,86,4
258,Bolton,23,14,9,65,31,34,83,5
258,Ipswich Town,22,16,8,78,45,33,82,6
258,Wycombe,22,10,14,66,39,27,76,7
258,P'borough Utd,22,7,17,74,55,19,73,8
258,Portsmouth,18,16,12,65,52,13,70,9
258,Shrewsbury,18,13,15,57,49,8,67,10
258,Fleetwood Town,15,19,12,47,39,8,64,11
258,Charlton Ath,15,15,16,66,59,7,60,12
258,Lincoln City,14,18,14,45,51,-6,60,13
258,Bristol Rovers,15,13,18,63,73,-10,58,14
258,Port Vale,15,12,19,44,62,-18,57,15
258,Exeter City,14,14,18,54,58,-4,56,16
258,Oxford United,12,14,20,45,53,-8,50,17
258,Cambridge Utd,13,9,24,40,66,-26,48,18
258,Burton Albion,12,9,25,52,85,-33,45,19
258,Cheltenham,11,8,27,35,69,-34,41,20
258,Acc'ton Stanley,9,14,23,34,82,-48,41,21
258,MK Dons,10,10,26,37,73,-36,40,22
258,Morecambe,7,15,24,39,75,-36,36,23
258,FG Rovers,6,10,30,35,86,-51,28,24
259,Sheffield Weds,29,13,4,79,29,50,100,1
259,Plymouth Argyle,27,10,9,82,49,33,91,2
259,Barnsley,26,9,11,72,43,29,87,3
259,Ipswich Town,24,14,8,78,47,31,86,4
259,Derby County,24,12,10,77,44,33,84,5
259,Bolton,23,12,11,70,36,34,81,6
259,P'borough Utd,23,8,15,81,58,23,77,7
259,Wycombe,23,7,16,66,48,18,76,8
259,Portsmouth,18,17,11,65,51,14,71,9
259,Shrewsbury,18,13,15,55,52,3,67,10
259,Lincoln City,14,21,11,47,44,3,63,11
259,Exeter City,17,10,19,62,57,5,61,12
259,Fleetwood Town,15,16,15,48,44,4,61,13
259,Port Vale,15,12,19,48,61,-13,57,14
259,Bristol Rovers,15,11,20,64,77,-13,56,15
259,Charlton Ath,14,13,19,56,59,-3,55,16
259,Burton Albion,13,11,22,62,88,-26,50,17
259,Oxford United,12,13,21,45,59,-14,49,18
259,Acc'ton Stanley,12,13,21,37,65,-28,49,19
259,Morecambe,12,11,23,43,70,-27,47,20
259,Cheltenham,11,8,27,32,64,-32,41,21
259,Cambridge Utd,11,7,28,32,73,-41,40,22
259,MK Dons,9,8,29,39,73,-34,35,23
259,FG Rovers,8,9,29,35,84,-49,33,24
260,Sheffield Weds,32,9,5,95,31,64,105,1
260,Plymouth Argyle,29,11,6,98,53,45,98,2
260,Ipswich Town,23,17,6,82,38,44,86,3
260,Bolton,25,9,12,70,38,32,84,4
260,Barnsley,25,9,12,74,46,28,84,5
260,Wycombe,23,9,14,61,45,16,78,6
260,Derby County,22,11,13,76,54,22,77,7
260,Portsmouth,17,18,11,67,51,16,69,8
260,P'borough Utd,21,5,20,75,63,12,68,9
260,Shrewsbury,19,10,17,55,57,-2,67,10
260,Fleetwood Town,15,18,13,51,41,10,63,11
260,Lincoln City,14,20,12,52,51,1,62,12
260,Exeter City,15,13,18,65,65,0,58,13
260,Charlton Ath,14,15,17,63,64,-1,57,14
260,Bristol Rovers,15,8,23,67,91,-24,53,15
260,Oxford United,14,10,22,51,58,-7,52,16
260,Acc'ton Stanley,12,16,18,44,67,-23,52,17
260,Port Vale,14,9,23,47,67,-20,51,18
260,Morecambe,10,14,22,47,77,-30,44,19
260,Cambridge Utd,11,11,24,41,74,-33,44,20
260,Cheltenham,11,10,25,34,65,-31,43,21
260,MK Dons,11,9,26,47,71,-24,42,22
260,Burton Albion,10,12,24,56,98,-42,42,23
260,FG Rovers,9,9,28,36,89,-53,36,24
261,Sheffield Weds,28,13,5,83,28,55,97,1
261,Plymouth Argyle,28,12,6,85,46,39,96,2
261,Ipswich Town,25,16,5,87,41,46,91,3
261,Derby County,25,13,8,75,37,38,88,4
261,Barnsley,23,9,14,72,47,25,78,5
261,Bolton,21,12,13,58,38,20,75,6
261,Wycombe,22,8,16,72,42,30,74,7
261,P'borough Utd,22,6,18,72,57,15,72,8
261,Portsmouth,17,18,11,62,53,9,69,9
261,Shrewsbury,20,9,17,54,53,1,69,10
261,Fleetwood Town,18,14,14,50,40,10,68,11
261,Lincoln City,15,21,10,47,43,4,66,12
261,Charlton Ath,16,14,16,59,59,0,62,13
261,Exeter City,16,12,18,61,64,-3,60,14
261,Bristol Rovers,16,9,21,63,73,-10,57,15
261,Burton Albion,14,10,22,59,88,-29,52,16
261,Port Vale,14,8,24,41,66,-25,50,17
261,MK Dons,13,10,23,43,64,-21,49,18
261,Oxford United,11,14,21,50,59,-9,47,19
261,Morecambe,10,13,23,41,71,-30,43,20
261,Cheltenham,11,10,25,34,67,-33,43,21
261,Acc'ton Stanley,10,13,23,39,77,-38,43,22
261,Cambridge Utd,9,10,27,32,70,-38,37,23
261,FG Rovers,5,12,29,30,86,-56,27,24
262,Sheffield Weds,33,9,4,84,26,58,108,1
262,Plymouth Argyle,29,9,8,95,55,40,96,2
262,Derby County,26,11,9,78,39,39,89,3
262,Barnsley,26,9,11,72,40,32,87,4
262,Bolton,26,8,12,71,37,34,86,5
262,Ipswich Town,21,18,7,79,46,33,81,6
262,Wycombe,22,10,14,70,49,21,76,7
262,Portsmouth,20,13,13,65,53,12,73,8
262,P'borough Utd,22,6,18,76,51,25,72,9
262,Fleetwood Town,16,18,12,51,43,8,66,10
262,Charlton Ath,16,13,17,62,58,4,61,11
262,Shrewsbury,18,7,21,52,51,1,61,12
262,Lincoln City,12,23,11,43,45,-2,59,13
262,Port Vale,16,9,21,48,64,-16,57,14
262,Bristol Rovers,16,9,21,60,77,-17,57,15
262,Exeter City,14,13,19,56,61,-5,55,16
262,Burton Albion,13,12,21,61,90,-29,51,17
262,Oxford United,11,12,23,44,63,-19,45,18
262,Morecambe,11,11,24,47,79,-32,44,19
262,Acc'ton Stanley,10,14,22,40,72,-32,44,20
262,MK Dons,11,8,27,44,76,-32,41,21
262,Cheltenham,10,11,25,40,72,-32,41,22
262,Cambridge Utd,10,8,28,35,77,-42,38,23
262,FG Rovers,7,11,28,35,84,-49,32,24
263,Sheffield Weds,32,11,3,85,27,58,107,1
263,Ipswich Town,27,14,5,92,43,49,95,2
263,Plymouth Argyle,28,9,9,85,51,34,93,3
263,Derby County,24,11,11,70,40,30,83,4
263,Barnsley,24,10,12,70,42,28,82,5
263,Bolton,24,10,12,65,38,27,82,6
263,Wycombe,21,12,13,58,40,18,75,7
263,Portsmouth,20,15,11,60,47,13,75,8
263,Shrewsbury,21,8,17,56,50,6,71,9
263,P'borough Utd,21,5,20,75,63,12,68,10
263,Charlton Ath,16,15,15,69,58,11,63,11
263,Fleetwood Town,14,17,15,48,45,3,59,12
263,Port Vale,14,13,19,48,62,-14,55,13
263,Exeter City,14,12,20,63,66,-3,54,14
263,Bristol Rovers,14,11,21,65,81,-16,53,15
263,Burton Albion,13,13,20,63,83,-20,52,16
263,Lincoln City,10,21,15,38,54,-16,51,17
263,Oxford United,11,13,22,43,60,-17,46,18
263,Cheltenham,12,9,25,38,70,-32,45,19
263,Morecambe,9,16,21,47,70,-23,43,20
263,Acc'ton Stanley,10,13,23,38,71,-33,43,21
263,Cambridge Utd,11,10,25,34,67,-33,43,22
263,MK Dons,10,9,27,40,73,-33,39,23
263,FG Rovers,6,15,25,35,84,-49,33,24
264,Sheffield Weds,29,11,6,81,36,45,98,1
264,Ipswich Town,27,15,4,90,41,49,96,2
264,Plymouth Argyle,29,9,8,84,50,34,96,3
264,Bolton,25,10,11,70,38,32,85,4
264,Barnsley,25,7,14,67,43,24,82,5
264,Derby County,22,13,11,70,45,25,79,6
264,Wycombe,23,9,14,64,43,21,78,7
264,Portsmouth,18,17,11,69,53,16,71,8
264,Shrewsbury,20,8,18,57,51,6,68,9
264,P'borough Utd,20,6,20,72,60,12,66,10
264,Fleetwood Town,16,15,15,54,43,11,63,11
264,Exeter City,17,10,19,63,61,2,61,12
264,Lincoln City,12,20,14,39,49,-10,56,13
264,Burton Albion,15,11,20,60,78,-18,56,14
264,Cheltenham,16,8,22,39,59,-20,56,15
264,Bristol Rovers,13,14,19,59,71,-12,53,16
264,Port Vale,14,10,22,53,69,-16,52,17
264,Charlton Ath,11,16,19,57,65,-8,49,18
264,Morecambe,11,16,19,49,68,-19,49,19
264,Acc'ton Stanley,12,12,22,36,65,-29,48,20
264,Oxford United,12,11,23,45,69,-24,47,21
264,MK Dons,12,7,27,43,73,-30,43,22
264,Cambridge Utd,10,8,28,41,76,-35,38,23
264,FG Rovers,7,9,30,30,86,-56,30,24
265,Sheffield Weds,31,12,3,84,27,57,105,1
265,Ipswich Town,26,15,5,93,42,51,93,2
265,Plymouth Argyle,26,12,8,80,46,34,90,3
265,Derby County,25,10,11,79,45,34,85,4
265,Bolton,24,12,10,70,36,34,84,5
265,Barnsley,24,10,12,67,43,24,82,6
265,Wycombe,22,9,15,65,46,19,75,7
265,Shrewsbury,19,10,17,56,51,5,67,8
265,Charlton Ath,17,15,14,69,54,15,66,9
265,Lincoln City,15,21,10,49,43,6,66,10
265,P'borough Utd,20,5,21,72,65,7,65,11
265,Portsmouth,16,16,14,61,51,10,64,12
265,Bristol Rovers,18,10,18,62,73,-11,64,13
265,Fleetwood Town,16,14,16,47,44,3,62,14
265,Exeter City,16,9,21,54,62,-8,57,15
265,Cambridge Utd,14,6,26,43,71,-28,48,16
265,Oxford United,11,14,21,48,59,-11,47,17
265,Burton Albion,13,8,25,61,94,-33,47,18
265,Cheltenham,12,10,24,40,62,-22,46,19
265,Port Vale,12,9,25,41,75,-34,45,20
265,Morecambe,10,14,22,43,73,-30,44,21
265,MK Dons,11,10,25,43,72,-29,43,22
265,Acc'ton Stanley,8,17,21,33,71,-38,41,23
265,FG Rovers,7,10,29,36,91,-55,31,24
266,Sheffield Weds,30,11,5,89,34,55,101,1
266,Plymouth Argyle,26,11,9,85,54,31,89,2
266,Wycombe,25,8,13,71,44,27,83,3
266,Derby County,24,10,12,77,45,32,82,4
266,Ipswich Town,22,14,10,78,50,28,80,5
266,P'borough Utd,23,8,15,76,55,21,77,6
266,Portsmouth,21,14,11,74,53,21,77,7
266,Barnsley,23,8,15,70,54,16,77,8
266,Bolton,21,11,14,70,44,26,74,9
266,Shrewsbury,21,9,16,54,46,8,72,10
266,Fleetwood Town,17,15,14,58,46,12,66,11
266,Lincoln City,15,19,12,45,50,-5,64,12
266,Charlton Ath,14,15,17,62,61,1,57,13
266,Burton Albion,15,11,20,64,84,-20,56,14
266,Port Vale,15,10,21,56,73,-17,55,15
266,Exeter City,14,12,20,64,69,-5,54,16
266,MK Dons,16,6,24,52,65,-13,54,17
266,Bristol Rovers,13,11,22,58,81,-23,50,18
266,Oxford United,11,15,20,52,64,-12,48,19
266,Cheltenham,12,11,23,35,62,-27,47,20
266,Morecambe,11,11,24,48,76,-28,44,21
266,Acc'ton Stanley,9,17,20,43,71,-28,44,22
266,Cambridge Utd,9,8,29,31,76,-45,35,23
266,FG Rovers,6,13,27,34,89,-55,31,24
267,Sheffield Weds,30,10,6,84,28,56,100,1
267,Plymouth Argyle,29,11,6,83,45,38,98,2
267,Ipswich Town,26,13,7,87,40,47,91,3
267,Derby County,25,11,10,78,38,40,86,4
267,Barnsley,24,9,13,66,44,22,81,5
267,P'borough Utd,24,4,18,86,58,28,76,6
267,Bolton,21,13,12,63,38,25,76,7
267,Wycombe,20,11,15,61,49,12,71,8
267,Shrewsbury,20,8,18,61,54,7,68,9
267,Portsmouth,18,14,14,58,52,6,68,10
267,Lincoln City,16,19,11,51,41,10,67,11
267,Exeter City,17,11,18,65,61,4,62,12
267,Bristol Rovers,16,13,17,65,71,-6,61,13
267,Fleetwood Town,14,17,15,43,42,1,59,14
267,Charlton Ath,13,16,17,57,59,-2,55,15
267,Port Vale,14,10,22,42,67,-25,52,16
267,Burton Albion,13,11,22,54,89,-35,50,17
267,Oxford United,12,12,22,43,61,-18,48,18
267,Cheltenham,13,9,24,34,58,-24,48,19
267,Acc'ton Stanley,10,16,20,33,63,-30,46,20
267,MK Dons,12,9,25,39,67,-28,45,21
267,Morecambe,10,13,23,42,75,-33,43,22
267,Cambridge Utd,10,9,27,33,72,-39,39,23
267,FG Rovers,6,9,31,30,86,-56,27,24
268,Sheffield Weds,31,11,4,85,30,55,104,1
268,Plymouth Argyle,30,10,6,96,45,51,100,2
268,Ipswich Town,26,14,6,86,41,45,92,3
268,Derby County,26,11,9,76,38,38,89,4
268,Barnsley,27,8,11,67,37,30,89,5
268,P'borough Utd,25,6,15,74,52,22,81,6
268,Bolton,22,12,12,63,42,21,78,7
268,Portsmouth,18,16,12,59,50,9,70,8
268,Wycombe,19,11,16,61,50,11,68,9
268,Shrewsbury,18,8,20,52,55,-3,62,10
268,Charlton Ath,14,16,16,58,55,3,58,11
268,Fleetwood Town,13,18,15,53,46,7,57,12
268,Lincoln City,12,21,13,39,46,-7,57,13
268,Bristol Rovers,14,13,19,69,83,-14,55,14
268,Port Vale,15,10,21,43,62,-19,55,15
268,Exeter City,14,12,20,56,62,-6,54,16
268,Oxford United,13,13,20,45,55,-10,52,17
268,Acc'ton Stanley,11,15,20,37,65,-28,48,18
268,Cheltenham,13,8,25,36,61,-25,47,19
268,Burton Albion,12,11,23,58,87,-29,47,20
268,MK Dons,12,8,26,42,70,-28,44,21
268,Cambridge Utd,11,8,27,32,66,-34,41,22
268,Morecambe,9,13,24,45,76,-31,40,23
268,FG Rovers,6,9,31,35,93,-58,27,24
269,Sheffield Weds,28,13,5,78,31,47,97,1
269,Ipswich Town,27,13,6,95,47,48,94,2
269,Plymouth Argyle,26,12,8,85,54,31,90,3
269,Derby County,24,12,10,77,42,35,84,4
269,Bolton,24,11,11,72,38,34,83,5
269,Wycombe,24,9,13,61,40,21,81,6
269,P'borough Utd,25,3,18,78,54,24,78,7
269,Portsmouth,21,15,10,70,50,20,78,8
269,Barnsley,22,9,15,65,46,19,75,9
269,Fleetwood Town,17,16,13,52,44,8,67,10
269,Charlton Ath,17,14,15,66,57,9,65,11
269,Shrewsbury,18,9,19,48,52,-4,63,12
269,Lincoln City,12,21,13,43,50,-7,57,13
269,Bristol Rovers,14,14,18,63,73,-10,56,14
269,Exeter City,13,12,21,52,62,-10,51,15
269,Port Vale,14,9,23,48,72,-24,51,16
269,Oxford United,13,10,23,47,61,-14,49,17
269,Burton Albion,13,9,24,61,96,-35,48,18
269,Cheltenham,12,10,24,35,58,-23,46,19
269,Morecambe,11,12,23,51,81,-30,45,20
269,Acc'ton Stanley,11,12,23,40,71,-31,45,21
269,MK Dons,12,8,26,45,69,-24,44,22
269,Cambridge Utd,12,7,27,39,75,-36,43,23
269,FG Rovers,8,8,30,35,83,-48,32,24
270,Sheffield Weds,32,9,5,90,30,60,105,1
270,Plymouth Argyle,31,10,5,98,47,51,103,2
270,Ipswich Town,25,15,6,91,44,47,90,3
270,Barnsley,27,8,11,79,40,39,89,4
270,Bolton,26,8,12,73,35,38,86,5
270,Derby County,21,15,10,73,41,32,78,6
270,P'borough Utd,23,9,14,74,52,22,78,7
270,Wycombe,22,8,16,64,46,18,74,8
270,Portsmouth,17,16,13,59,54,5,67,9
270,Shrewsbury,19,10,17,55,59,-4,67,10
270,Fleetwood Town,15,16,15,55,47,8,61,11
270,Charlton Ath,15,16,15,69,68,1,61,12
270,Lincoln City,13,19,14,41,50,-9,58,13
270,Bristol Rovers,14,11,21,58,80,-22,53,14
270,Oxford United,13,13,20,47,58,-11,52,15
270,Port Vale,14,10,22,47,71,-24,52,16
270,Exeter City,13,11,22,56,67,-11,50,17
270,Acc'ton Stanley,11,15,20,39,73,-34,48,18
270,Burton Albion,12,10,24,54,86,-32,46,19
270,Cambridge Utd,12,9,25,42,69,-27,45,20
270,Cheltenham,12,9,25,35,70,-35,45,21
270,Morecambe,9,15,22,48,75,-27,42,22
270,MK Dons,8,11,27,38,71,-33,35,23
270,FG Rovers,7,9,30,37,89,-52,30,24
271,Sheffield Weds,31,10,5,93,37,56,103,1
271,Plymouth Argyle,29,9,8,89,48,41,96,2
271,Ipswich Town,24,15,7,87,43,44,87,3
271,Wycombe,26,8,12,67,36,31,86,4
271,Portsmouth,24,13,9,67,44,23,85,5
271,Bolton,23,10,13,60,37,23,79,6
271,Derby County,23,10,13,71,49,22,79,7
271,Barnsley,23,8,15,65,44,21,77,8
271,Fleetwood Town,18,15,13,53,41,12,69,9
271,P'borough Utd,20,6,20,66,58,8,66,10
271,Shrewsbury,18,9,19,57,59,-2,63,11
271,Charlton Ath,15,15,16,62,59,3,60,12
271,Lincoln City,13,21,12,42,49,-7,60,13
271,Exeter City,16,10,20,54,62,-8,58,14
271,Burton Albion,15,12,19,64,83,-19,57,15
271,Bristol Rovers,15,10,21,63,81,-18,55,16
271,Port Vale,13,11,22,45,67,-22,50,17
271,Oxford United,12,13,21,45,55,-10,49,18
271,Morecambe,12,12,22,46,66,-20,48,19
271,MK Dons,11,11,24,43,67,-24,44,20
271,Acc'ton Stanley,9,15,22,36,66,-30,42,21
271,Cheltenham,10,11,25,34,64,-30,41,22
271,Cambridge Utd,11,7,28,37,78,-41,40,23
271,FG Rovers,6,9,31,30,83,-53,27,24
272,Sheffield Weds,29,12,5,87,34,53,99,1
272,Plymouth Argyle,29,12,5,97,48,49,99,2
272,Ipswich Town,26,12,8,89,39,50,90,3
272,Barnsley,26,9,11,76,44,32,87,4
272,Derby County,24,11,11,73,43,30,83,5
272,Bolton,24,11,11,63,35,28,83,6
272,P'borough Utd,26,3,17,77,50,27,81,7
272,Portsmouth,19,17,10,62,47,15,74,8
272,Wycombe,21,9,16,60,49,11,72,9
272,Shrewsbury,19,10,17,50,48,2,67,10
272,Charlton Ath,17,13,16,69,61,8,64,11
272,Lincoln City,14,21,11,45,46,-1,63,12
272,Fleetwood Town,14,15,17,47,47,0,57,13
272,Port Vale,15,9,22,45,63,-18,54,14
272,Exeter City,13,12,21,53,65,-12,51,15
272,Cheltenham,14,9,23,33,58,-25,51,16
272,Burton Albion,13,10,23,49,83,-34,49,17
272,Morecambe,11,14,21,42,64,-22,47,18
272,MK Dons,13,7,26,44,73,-29,46,19
272,Oxford United,10,15,21,47,62,-15,45,20
272,Acc'ton Stanley,10,15,21,41,67,-26,45,21
272,Bristol Rovers,11,8,27,58,91,-33,41,22
272,Cambridge Utd,10,8,28,32,73,-41,38,23
272,FG Rovers,7,12,27,34,83,-49,33,24
273,Sheffield Weds,30,10,6,87,29,58,100,1
273,Plymouth Argyle,30,10,6,88,48,40,100,2
273,Ipswich Town,25,16,5,85,42,43,91,3
273,Barnsley,27,6,13,70,42,28,87,4
273,Derby County,25,10,11,76,43,33,85,5
273,Bolton,21,14,11,63,31,32,77,6
273,P'borough Utd,23,6,17,79,57,22,75,7
273,Wycombe,20,13,13,66,44,22,73,8
273,Portsmouth,19,16,11,65,52,13,73,9
273,Shrewsbury,18,13,15,55,48,7,67,10
273,Bristol Rovers,17,12,17,70,70,0,63,11
273,Fleetwood Town,15,17,14,49,43,6,62,12
273,Oxford United,16,11,19,51,50,1,59,13
273,Charlton Ath,14,15,17,64,60,4,57,14
273,Lincoln City,12,19,15,46,53,-7,55,15
273,Exeter City,13,12,21,53,67,-14,51,16
273,Cheltenham,14,9,23,38,61,-23,51,17
273,Burton Albion,13,11,22,60,89,-29,50,18
273,Port Vale,13,9,24,42,73,-31,48,19
273,Acc'ton Stanley,11,13,22,41,73,-32,46,20
273,MK Dons,11,9,26,44,73,-29,42,21
273,Cambridge Utd,10,9,27,39,78,-39,39,22
273,Morecambe,8,14,24,43,86,-43,38,23
273,FG Rovers,5,10,31,28,90,-62,25,24
274,Sheffield Weds,31,11,4,89,29,60,104,1
274,Ipswich Town,28,13,5,90,39,51,97,2
274,Barnsley,30,5,11,81,38,43,95,3
274,Bolton,26,9,11,67,32,35,87,4
274,Plymouth Argyle,26,9,11,78,55,23,87,5
274,Derby County,24,13,9,78,41,37,85,6
274,Wycombe,25,7,14,74,41,33,82,7
274,P'borough Utd,21,6,19,75,62,13,69,8
274,Portsmouth,16,18,12,58,50,8,66,9
274,Shrewsbury,18,10,18,53,53,0,64,10
274,Fleetwood Town,15,17,14,46,41,5,62,11
274,Lincoln City,12,24,10,48,45,3,60,12
274,Bristol Rovers,17,9,20,69,78,-9,60,13
274,Charlton Ath,15,13,18,66,64,2,58,14
274,Exeter City,16,10,20,57,61,-4,58,15
274,Port Vale,16,10,20,50,69,-19,58,16
274,Oxford United,13,10,23,45,62,-17,49,17
274,Burton Albion,12,10,24,58,99,-41,46,18
274,Cheltenham,12,9,25,29,60,-31,45,19
274,MK Dons,11,9,26,43,74,-31,42,20
274,Morecambe,10,11,25,43,79,-36,41,21
274,Cambridge Utd,11,7,28,35,69,-34,40,22
274,Acc'ton Stanley,9,13,24,34,70,-36,40,23
274,FG Rovers,6,11,29,33,88,-55,29,24
275,Plymouth Argyle,31,8,7,91,50,41,101,1
275,Sheffield Weds,28,13,5,83,32,51,97,2
275,Ipswich Town,25,15,6,84,41,43,90,3
275,Derby County,23,13,10,76,44,32,82,4
275,Barnsley,23,11,12,74,47,27,80,5
275,Bolton,22,13,11,65,35,30,79,6
275,Wycombe,22,11,13,64,45,19,77,7
275,Portsmouth,20,13,13,66,48,18,73,8
275,Shrewsbury,19,13,14,52,45,7,70,9
275,P'borough Utd,20,9,17,72,63,9,69,10
275,Charlton Ath,15,15,16,60,57,3,60,11
275,Fleetwood Town,13,18,15,46,47,-1,57,12
275,Lincoln City,12,21,13,47,50,-3,57,13
275,Bristol Rovers,16,9,21,69,77,-8,57,14
275,Exeter City,14,14,18,59,62,-3,56,15
275,Port Vale,15,7,24,43,69,-26,52,16
275,Burton Albion,14,9,23,59,81,-22,51,17
275,Oxford United,13,10,23,50,66,-16,49,18
275,Cheltenham,12,13,21,35,55,-20,49,19
275,MK Dons,13,9,24,47,64,-17,48,20
275,Acc'ton Stanley,11,13,22,39,73,-34,46,21
275,Morecambe,11,10,25,49,87,-38,43,22
275,Cambridge Utd,10,9,27,36,77,-41,39,23
275,FG Rovers,6,12,28,35,86,-51,30,24
276,Sheffield Weds,33,9,4,96,28,68,108,1
276,Ipswich Town,26,13,7,89,39,50,91,2
276,Barnsley,27,9,10,74,39,35,90,3
276,Plymouth Argyle,27,9,10,83,50,33,90,4
276,Derby County,25,11,10,83,48,35,86,5
276,Bolton,22,13,11,65,35,30,79,6
276,Wycombe,22,12,12,67,37,30,78,7
276,P'borough Utd,24,4,18,83,69,14,76,8
276,Portsmouth,17,17,12,59,47,12,68,9
276,Shrewsbury,19,8,19,60,60,0,65,10
276,Charlton Ath,16,12,18,67,64,3,60,11
276,Fleetwood Town,13,20,13,55,47,8,59,12
276,Lincoln City,12,23,11,44,47,-3,59,13
276,Oxford United,15,11,20,50,58,-8,56,14
276,Exeter City,13,14,19,62,72,-10,53,15
276,Bristol Rovers,14,11,21,61,83,-22,53,16
276,Burton Albion,14,10,22,60,89,-29,52,17
276,MK Dons,14,8,24,43,64,-21,50,18
276,Port Vale,13,11,22,44,68,-24,50,19
276,Cheltenham,13,7,26,42,68,-26,46,20
276,Cambridge Utd,11,9,26,36,79,-43,42,21
276,Morecambe,9,14,23,44,79,-35,41,22
276,Acc'ton Stanley,9,13,24,40,77,-37,40,23
276,FG Rovers,5,10,31,32,92,-60,25,24
277,Sheffield Weds,30,10,6,81,33,48,100,1
277,Plymouth Argyle,28,12,6,86,51,35,96,2
277,Derby County,28,10,8,81,33,48,94,3
277,Bolton,24,12,10,64,31,33,84,4
277,Barnsley,24,10,12,76,50,26,82,5
277,Ipswich Town,21,16,9,83,50,33,79,6
277,Wycombe,24,7,15,69,44,25,79,7
277,P'borough Utd,23,6,17,70,57,13,75,8
277,Charlton Ath,19,13,14,69,59,10,70,9
277,Fleetwood Town,17,17,12,57,43,14,68,10
277,Portsmouth,18,14,14,64,54,10,68,11
277,Shrewsbury,18,8,20,50,55,-5,62,12
277,Exeter City,14,15,17,51,58,-7,57,13
277,Lincoln City,10,25,11,41,46,-5,55,14
277,Bristol Rovers,14,12,20,68,85,-17,54,15
277,Port Vale,14,10,22,48,65,-17,52,16
277,Oxford United,13,11,22,48,59,-11,50,17
277,Burton Albion,12,12,22,59,86,-27,48,18
277,MK Dons,12,8,26,44,70,-26,44,19
277,Morecambe,10,13,23,44,69,-25,43,20
277,Cambridge Utd,11,10,25,37,71,-34,43,21
277,Acc'ton Stanley,9,14,23,35,75,-40,41,22
277,Cheltenham,9,11,26,32,63,-31,38,23
277,FG Rovers,6,12,28,35,85,-50,30,24
278,Sheffield Weds,28,12,6,78,30,48,96,1
278,Bolton,26,11,9,71,34,37,89,2
278,Plymouth Argyle,26,11,9,80,52,28,89,3
278,Barnsley,24,12,10,71,40,31,84,4
278,Ipswich Town,23,12,11,83,44,39,81,5
278,Derby County,22,15,9,69,38,31,81,6
278,P'borough Utd,24,8,14,78,52,26,80,7
278,Wycombe,23,8,15,59,43,16,77,8
278,Shrewsbury,21,9,16,60,52,8,72,9
278,Portsmouth,18,16,12,65,49,16,70,10
278,Fleetwood Town,16,18,12,47,39,8,66,11
278,Charlton Ath,16,14,16,71,61,10,62,12
278,Port Vale,17,11,18,51,61,-10,62,13
278,Lincoln City,14,18,14,47,50,-3,60,14
278,Exeter City,15,13,18,55,57,-2,58,15
278,Oxford United,13,14,19,50,57,-7,53,16
278,Bristol Rovers,13,13,20,59,77,-18,52,17
278,Cambridge Utd,13,9,24,42,73,-31,48,18
278,MK Dons,10,14,22,42,64,-22,44,19
278,Cheltenham,11,10,25,32,59,-27,43,20
278,Burton Albion,10,10,26,56,96,-40,40,21
278,Morecambe,9,12,25,41,74,-33,39,22
278,Acc'ton Stanley,8,14,24,31,79,-48,38,23
278,FG Rovers,5,10,31,32,89,-57,25,24
279,Sheffield Weds,29,12,5,74,27,47,99,1
279,Plymouth Argyle,29,10,7,87,48,39,97,2
279,Ipswich Town,25,15,6,84,44,40,90,3
279,Barnsley,24,10,12,71,42,29,82,4
279,Bolton,23,10,13,63,37,26,79,5
279,Derby County,23,10,13,73,49,24,79,6
279,Wycombe,22,10,14,53,37,16,76,7
279,P'borough Utd,23,6,17,72,55,17,75,8
279,Portsmouth,18,16,12,63,54,9,70,9
279,Exeter City,17,14,15,65,57,8,65,10
279,Lincoln City,15,20,11,46,46,0,65,11
279,Shrewsbury,18,10,18,53,49,4,64,12
279,Charlton Ath,16,15,15,66,57,9,63,13
279,Fleetwood Town,15,17,14,48,42,6,62,14
279,Bristol Rovers,14,11,21,64,79,-15,53,15
279,Port Vale,14,10,22,45,71,-26,52,16
279,Cheltenham,13,10,23,39,58,-19,49,17
279,Burton Albion,11,14,21,54,79,-25,47,18
279,Oxford United,12,10,24,45,59,-14,46,19
279,Cambridge Utd,11,10,25,40,76,-36,43,20
279,Morecambe,10,11,25,47,78,-31,41,21
279,MK Dons,10,10,26,41,71,-30,40,22
279,Acc'ton Stanley,8,16,22,38,70,-32,40,23
279,FG Rovers,9,9,28,30,76,-46,36,24
280,Plymouth Argyle,31,9,6,90,43,47,102,1
280,Sheffield Weds,29,11,6,87,31,56,98,2
280,Derby County,27,11,8,79,41,38,92,3
280,Barnsley,27,9,10,82,37,45,90,4
280,Ipswich Town,25,15,6,82,41,41,90,5
280,Bolton,23,12,11,63,34,29,81,6
280,Portsmouth,21,12,13,65,52,13,75,7
280,Shrewsbury,22,9,15,56,50,6,75,8
280,Wycombe,21,11,14,63,48,15,74,9
280,P'borough Utd,22,4,20,74,60,14,70,10
280,Fleetwood Town,16,14,16,49,44,5,62,11
280,Charlton Ath,14,16,16,60,54,6,58,12
280,Port Vale,15,10,21,45,61,-16,55,13
280,Exeter City,14,12,20,57,66,-9,54,14
280,Lincoln City,11,19,16,40,53,-13,52,15
280,Bristol Rovers,13,12,21,66,80,-14,51,16
280,Oxford United,13,11,22,51,64,-13,50,17
280,Cambridge Utd,14,6,26,36,69,-33,48,18
280,Burton Albion,11,13,22,47,81,-34,46,19
280,MK Dons,12,8,26,41,65,-24,44,20
280,Morecambe,8,17,21,46,74,-28,41,21
280,Acc'ton Stanley,9,14,23,36,72,-36,41,22
280,Cheltenham,10,9,27,30,67,-37,39,23
280,FG Rovers,6,12,28,35,93,-58,30,24
281,Sheffield Weds,29,12,5,84,35,49,99,1
281,Plymouth Argyle,29,11,6,90,52,38,98,2
281,Ipswich Town,25,15,6,81,39,42,90,3
281,Barnsley,26,7,13,74,42,32,85,4
281,Derby County,24,12,10,75,39,36,84,5
281,Portsmouth,23,13,10,67,47,20,82,6
281,Wycombe,23,10,13,62,44,18,79,7
281,Bolton,21,13,12,61,39,22,76,8
281,P'borough Utd,21,6,19,79,58,21,69,9
281,Shrewsbury,20,8,18,58,50,8,68,10
281,Fleetwood Town,17,15,14,56,46,10,66,11
281,Charlton Ath,17,11,18,72,64,8,62,12
281,Lincoln City,13,21,12,44,46,-2,60,13
281,Exeter City,15,12,19,61,61,0,57,14
281,Burton Albion,15,9,22,56,80,-24,54,15
281,Oxford United,14,11,21,49,59,-10,53,16
281,Port Vale,15,8,23,49,72,-23,53,17
281,Bristol Rovers,12,12,22,62,95,-33,48,18
281,Cheltenham,11,12,23,35,59,-24,45,19
281,Acc'ton Stanley,10,12,24,36,70,-34,42,20
281,Cambridge Utd,11,9,26,37,72,-35,42,21
281,MK Dons,11,8,27,44,72,-28,41,22
281,Morecambe,9,12,25,40,76,-36,39,23
281,FG Rovers,6,11,29,33,88,-55,29,24
282,Sheffield Weds,30,11,5,87,30,57,101,1
282,Plymouth Argyle,29,9,8,77,49,28,96,2
282,Derby County,25,12,9,73,40,33,87,3
282,Ipswich Town,23,16,7,86,43,43,85,4
282,Barnsley,26,7,13,74,41,33,85,5
282,Bolton,22,14,10,65,35,30,80,6
282,P'borough Utd,24,3,19,70,57,13,75,7
282,Wycombe,19,12,15,54,46,8,69,8
282,Portsmouth,18,14,14,58,51,7,68,9
282,Exeter City,18,10,18,61,58,3,64,10
282,Fleetwood Town,15,16,15,50,46,4,61,11
282,Lincoln City,13,22,11,45,47,-2,61,12
282,Burton Albion,17,8,21,63,86,-23,59,13
282,Bristol Rovers,15,13,18,62,68,-6,58,14
282,Charlton Ath,14,15,17,60,58,2,57,15
282,Shrewsbury,16,9,21,46,51,-5,57,16
282,Port Vale,14,11,21,49,68,-19,53,17
282,Oxford United,11,14,21,48,60,-12,47,18
282,Cheltenham,12,11,23,39,63,-24,47,19
282,Acc'ton Stanley,11,14,21,36,60,-24,47,20
282,MK Dons,11,10,25,44,69,-25,43,21
282,Morecambe,9,16,21,45,73,-28,43,22
282,Cambridge Utd,11,8,27,37,73,-36,41,23
282,FG Rovers,6,11,29,31,88,-57,29,24
283,Sheffield Weds,30,11,5,83,31,52,101,1
283,Plymouth Argyle,27,10,9,90,49,41,91,2
283,Barnsley,28,6,12,78,41,37,90,3
283,Bolton,26,10,10,73,36,37,88,4
283,Ipswich Town,22,17,7,80,44,36,83,5
283,Derby County,23,14,9,80,45,35,83,6
283,Wycombe,23,8,15,64,41,23,77,7
283,Fleetwood Town,21,12,13,60,43,17,75,8
283,Charlton Ath,19,12,15,62,56,6,69,9
283,Bristol Rovers,19,11,16,75,73,2,68,10
283,Shrewsbury,19,10,17,56,53,3,67,11
283,Portsmouth,16,15,15,66,64,2,63,12
283,P'borough Utd,19,5,22,69,71,-2,62,13
283,Lincoln City,13,20,13,49,53,-4,59,14
283,Exeter City,15,12,19,57,64,-7,57,15
283,Oxford United,14,13,19,52,54,-2,55,16
283,Port Vale,14,10,22,46,64,-18,52,17
283,Cambridge Utd,12,8,26,36,67,-31,44,18
283,Acc'ton Stanley,10,14,22,39,77,-38,44,19
283,Burton Albion,11,10,25,53,87,-34,43,20
283,MK Dons,11,9,26,43,68,-25,42,21
283,Cheltenham,11,8,27,36,69,-33,41,22
283,Morecambe,8,15,23,46,81,-35,39,23
283,FG Rovers,6,10,30,29,91,-62,28,24
284,Sheffield Weds,33,10,3,84,29,55,109,1
284,Barnsley,26,8,12,69,44,25,86,2
284,Plymouth Argyle,24,14,8,80,59,21,86,3
284,Ipswich Town,23,15,8,86,46,40,84,4
284,Wycombe,26,6,14,63,40,23,84,5
284,Derby County,24,10,12,80,43,37,82,6
284,Bolton,24,10,12,67,32,35,82,7
284,P'borough Utd,20,8,18,64,51,13,68,8
284,Shrewsbury,20,8,18,56,52,4,68,9
284,Lincoln City,15,20,11,44,41,3,65,10
284,Fleetwood Town,16,16,14,55,43,12,64,11
284,Bristol Rovers,17,12,17,66,68,-2,63,12
284,Oxford United,15,13,18,49,52,-3,58,13
284,Port Vale,16,10,20,45,62,-17,58,14
284,Portsmouth,14,15,17,51,59,-8,57,15
284,Charlton Ath,14,13,19,58,59,-1,55,16
284,Exeter City,12,13,21,59,68,-9,49,17
284,Cheltenham,13,9,24,36,57,-21,48,18
284,Acc'ton Stanley,11,14,21,37,67,-30,47,19
284,Burton Albion,12,11,23,53,86,-33,47,20
284,Morecambe,10,12,24,39,71,-32,42,21
284,MK Dons,11,7,28,40,72,-32,40,22
284,FG Rovers,9,12,25,38,80,-42,39,23
284,Cambridge Utd,10,8,28,32,70,-38,38,24
285,Sheffield Weds,30,11,5,80,30,50,101,1
285,Plymouth Argyle,27,11,8,83,51,32,92,2
285,Ipswich Town,25,15,6,86,42,44,90,3
285,Derby County,26,12,8,73,38,35,90,4
285,Bolton,26,10,10,70,33,37,88,5
285,Wycombe,26,6,14,67,43,24,84,6
285,Barnsley,24,11,11,66,40,26,83,7
285,Charlton Ath,19,15,12,74,54,20,72,8
285,Portsmouth,18,17,11,70,48,22,71,9
285,P'borough Utd,20,11,15,71,56,15,71,10
285,Shrewsbury,17,15,14,51,45,6,66,11
285,Fleetwood Town,15,14,17,51,49,2,59,12
285,Port Vale,16,10,20,45,61,-16,58,13
285,Exeter City,15,10,21,54,64,-10,55,14
285,Lincoln City,11,21,14,42,46,-4,54,15
285,Oxford United,12,13,21,51,61,-10,49,16
285,Morecambe,11,13,22,46,70,-24,46,17
285,MK Dons,12,9,25,41,65,-24,45,18
285,Bristol Rovers,12,9,25,56,84,-28,45,19
285,Cheltenham,11,10,25,31,66,-35,43,20
285,Acc'ton Stanley,8,17,21,32,63,-31,41,21
285,Burton Albion,10,10,26,51,94,-43,40,22
285,Cambridge Utd,9,9,28,33,70,-37,36,23
285,FG Rovers,6,13,27,32,83,-51,31,24
286,Sheffield Weds,29,11,6,86,35,51,98,1
286,Barnsley,29,7,10,78,39,39,94,2
286,Plymouth Argyle,27,11,8,86,52,34,92,3
286,Derby County,23,15,8,69,36,33,84,4
286,Ipswich Town,23,15,8,80,50,30,84,5
286,Bolton,23,11,12,72,40,32,80,6
286,Wycombe,23,10,13,63,41,22,79,7
286,P'borough Utd,23,9,14,75,47,28,78,8
286,Shrewsbury,20,9,17,54,49,5,69,9
286,Portsmouth,17,17,12,65,49,16,68,10
286,Bristol Rovers,17,10,19,72,74,-2,61,11
286,Exeter City,15,14,17,59,59,0,59,12
286,Fleetwood Town,15,14,17,54,54,0,59,13
286,Charlton Ath,13,17,16,61,61,0,56,14
286,Lincoln City,12,20,14,38,49,-11,56,15
286,Port Vale,15,10,21,47,64,-17,55,16
286,Cheltenham,13,9,24,35,62,-27,48,17
286,Oxford United,10,16,20,41,53,-12,46,18
286,Acc'ton Stanley,10,16,20,40,69,-29,46,19
286,MK Dons,12,9,25,47,70,-23,45,20
286,Burton Albion,12,8,26,52,87,-35,44,21
286,Cambridge Utd,11,10,25,39,67,-28,43,22
286,Morecambe,9,13,24,39,77,-38,40,23
286,FG Rovers,6,9,31,32,100,-68,27,24
287,Sheffield Weds,30,10,6,79,32,47,100,1
287,Plymouth Argyle,29,11,6,89,45,44,98,2
287,Ipswich Town,25,15,6,83,41,42,90,3
287,Wycombe,28,6,12,81,41,40,90,4
287,Barnsley,24,10,12,76,50,26,82,5
287,Derby County,23,11,12,75,44,31,80,6
287,Bolton,23,11,12,69,40,29,80,7
287,Portsmouth,20,15,11,65,51,14,75,8
287,P'borough Utd,21,9,16,73,60,13,72,9
287,Charlton Ath,16,14,16,62,58,4,62,10
287,Shrewsbury,18,7,21,55,57,-2,61,11
287,Exeter City,16,10,20,57,56,1,58,12
287,Oxford United,15,13,18,56,57,-1,58,13
287,Fleetwood Town,14,15,17,49,54,-5,57,14
287,Lincoln City,12,21,13,41,50,-9,57,15
287,Morecambe,12,15,19,49,66,-17,51,16
287,Bristol Rovers,13,12,21,61,80,-19,51,17
287,Port Vale,13,11,22,42,63,-21,50,18
287,Burton Albion,12,13,21,52,78,-26,49,19
287,Acc'ton Stanley,9,16,21,36,66,-30,43,20
287,Cheltenham,10,11,25,32,70,-38,41,21
287,MK Dons,11,7,28,41,73,-32,40,22
287,Cambridge Utd,10,9,27,36,78,-42,39,23
287,FG Rovers,6,12,28,36,85,-49,30,24
288,Sheffield Weds,31,10,5,84,31,53,103,1
288,Barnsley,30,6,10,83,39,44,96,2
288,Plymouth Argyle,29,9,8,83,49,34,96,3
288,Bolton,25,11,10,71,34,37,86,4
288,Derby County,24,11,11,80,50,30,83,5
288,Ipswich Town,21,18,7,78,46,32,81,6
288,P'borough Utd,23,7,16,76,60,16,76,7
288,Wycombe,21,12,13,64,43,21,75,8
288,Portsmouth,19,13,14,67,57,10,70,9
288,Port Vale,18,11,17,46,57,-11,65,10
288,Fleetwood Town,15,19,12,54,46,8,64,11
288,Charlton Ath,16,15,15,61,54,7,63,12
288,Shrewsbury,17,9,20,57,58,-1,60,13
288,Exeter City,15,12,19,57,59,-2,57,14
288,Lincoln City,11,22,13,39,47,-8,55,15
288,Bristol Rovers,15,9,22,62,82,-20,54,16
288,Oxford United,12,12,22,49,64,-15,48,17
288,Burton Albion,12,9,25,53,83,-30,45,18
288,Cheltenham,11,10,25,34,60,-26,43,19
288,Cambridge Utd,11,10,25,35,67,-32,43,20
288,Morecambe,9,15,22,46,78,-32,42,21
288,Acc'ton Stanley,10,12,24,34,70,-36,42,22
288,MK Dons,11,8,27,39,67,-28,41,23
288,FG Rovers,5,12,29,34,85,-51,27,24
289,Sheffield Weds,30,13,3,79,29,50,103,1
289,Plymouth Argyle,26,14,6,81,45,36,92,2
289,Derby County,26,11,9,79,42,37,89,3
289,Barnsley,23,12,11,68,41,27,81,4
289,Ipswich Town,21,15,10,83,52,31,78,5
289,Bolton,22,12,12,70,40,30,78,6
289,Port Vale,22,8,16,52,55,-3,74,7
289,P'borough Utd,21,10,15,72,56,16,73,8
289,Wycombe,21,9,16,69,46,23,72,9
289,Portsmouth,18,15,13,58,51,7,69,10
289,Fleetwood Town,16,15,15,52,46,6,63,11
289,Shrewsbury,17,12,17,50,51,-1,63,12
289,Charlton Ath,15,15,16,64,60,4,60,13
289,Lincoln City,12,23,11,45,48,-3,59,14
289,Exeter City,15,11,20,56,63,-7,56,15
289,Morecambe,12,17,17,53,67,-14,53,16
289,Bristol Rovers,14,10,22,67,83,-16,52,17
289,Oxford United,12,13,21,48,63,-15,49,18
289,Cheltenham,13,10,23,35,57,-22,49,19
289,Burton Albion,11,12,23,55,83,-28,45,20
289,MK Dons,11,8,27,44,72,-28,41,21
289,Acc'ton Stanley,9,14,23,37,73,-36,41,22
289,Cambridge Utd,10,6,30,38,77,-39,36,23
289,FG Rovers,7,11,28,32,87,-55,32,24
290,Sheffield Weds,32,9,5,92,30,62,105,1
290,Plymouth Argyle,29,11,6,87,49,38,98,2
290,Ipswich Town,23,18,5,82,42,40,87,3
290,Bolton,25,9,12,69,36,33,84,4
290,Barnsley,23,13,10,73,49,24,82,5
290,Derby County,22,12,12,72,48,24,78,6
290,Wycombe,22,9,15,63,43,20,75,7
290,P'borough Utd,22,6,18,75,63,12,72,8
290,Portsmouth,17,17,12,55,48,7,68,9
290,Shrewsbury,17,13,16,57,50,7,64,10
290,Exeter City,15,14,17,68,66,2,59,11
290,Port Vale,16,11,19,48,64,-16,59,12
290,Charlton Ath,15,13,18,61,59,2,58,13
290,Lincoln City,12,22,12,52,50,2,58,14
290,Oxford United,15,12,19,51,53,-2,57,15
290,Fleetwood Town,13,17,16,53,52,1,56,16
290,Bristol Rovers,13,15,18,65,81,-16,54,17
290,Cheltenham,13,9,24,39,67,-28,48,18
290,Morecambe,11,13,22,48,74,-26,46,19
290,MK Dons,12,9,25,43,65,-22,45,20
290,Acc'ton Stanley,11,12,23,40,79,-39,45,21
290,Burton Albion,10,14,22,48,86,-38,44,22
290,Cambridge Utd,10,9,27,35,72,-37,39,23
290,FG Rovers,5,11,30,32,82,-50,26,24
291,Plymouth Argyle,31,10,5,96,48,48,103,1
291,Sheffield Weds,27,12,7,74,32,42,93,2
291,Ipswich Town,25,13,8,86,50,36,88,3
291,Bolton,24,12,10,73,33,40,84,4
291,P'borough Utd,26,6,14,79,51,28,84,5
291,Barnsley,25,6,15,68,46,22,81,6
291,Derby County,22,13,11,66,42,24,79,7
291,Wycombe,23,7,16,62,45,17,76,8
291,Portsmouth,18,16,12,65,50,15,70,9
291,Lincoln City,15,21,10,51,43,8,66,10
291,Shrewsbury,17,9,20,51,51,0,60,11
291,Charlton Ath,15,14,17,56,58,-2,59,12
291,Exeter City,16,11,19,59,63,-4,59,13
291,Fleetwood Town,14,16,16,47,44,3,58,14
291,Oxford United,14,13,19,51,57,-6,55,15
291,Bristol Rovers,14,10,22,61,74,-13,52,16
291,Port Vale,14,10,22,47,65,-18,52,17
291,Burton Albion,13,11,22,56,83,-27,50,18
291,MK Dons,13,8,25,42,64,-22,47,19
291,Cambridge Utd,12,10,24,36,74,-38,46,20
291,Cheltenham,12,9,25,44,66,-22,45,21
291,Acc'ton Stanley,11,12,23,41,71,-30,45,22
291,Morecambe,9,13,24,44,84,-40,40,23
291,FG Rovers,7,8,31,34,95,-61,29,24
292,Ipswich Town,28,14,4,86,40,46,98,1
292,Plymouth Argyle,29,9,8,86,46,40,96,2
292,Sheffield Weds,27,11,8,78,37,41,92,3
292,Barnsley,27,9,10,75,38,37,90,4
292,Derby County,25,11,10,77,42,35,86,5
292,Bolton,23,11,12,69,36,33,80,6
292,P'borough Utd,23,7,16,78,55,23,76,7
292,Wycombe,22,9,15,67,45,22,75,8
292,Portsmouth,18,16,12,65,54,11,70,9
292,Shrewsbury,18,10,18,55,50,5,64,10
292,Fleetwood Town,15,15,16,49,47,2,60,11
292,Charlton Ath,14,15,17,69,62,7,57,12
292,Lincoln City,12,21,13,37,49,-12,57,13
292,MK Dons,16,8,22,53,63,-10,56,14
292,Exeter City,14,13,19,61,64,-3,55,15
292,Port Vale,15,9,22,45,66,-21,54,16
292,Bristol Rovers,13,11,22,58,77,-19,50,17
292,Burton Albion,12,11,23,54,92,-38,47,18
292,Oxford United,11,13,22,45,59,-14,46,19
292,Acc'ton Stanley,10,14,22,35,72,-37,44,20
292,Cambridge Utd,11,10,25,40,72,-32,43,21
292,Cheltenham,11,10,25,33,66,-33,43,22
292,Morecambe,9,15,22,43,78,-35,42,23
292,FG Rovers,7,12,27,36,84,-48,33,24
293,Sheffield Weds,30,11,5,81,31,50,101,1
293,Plymouth Argyle,29,11,6,93,48,45,98,2
293,Ipswich Town,25,16,5,88,41,47,91,3
293,Barnsley,27,7,12,75,43,32,88,4
293,Bolton,24,13,9,65,33,32,85,5
293,Derby County,23,12,11,73,46,27,81,6
293,Portsmouth,21,14,11,71,46,25,77,7
293,P'borough Utd,24,4,18,78,55,23,76,8
293,Wycombe,20,9,17,61,46,15,69,9
293,Fleetwood Town,17,16,13,50,41,9,67,10
293,Shrewsbury,18,10,18,53,52,1,64,11
293,Lincoln City,14,20,12,45,41,4,62,12
293,Charlton Ath,15,16,15,67,62,5,61,13
293,Exeter City,14,11,21,59,66,-7,53,14
293,Port Vale,14,11,21,46,66,-20,53,15
293,Bristol Rovers,14,9,23,60,81,-21,51,16
293,MK Dons,14,8,24,49,64,-15,50,17
293,Oxford United,12,11,23,53,68,-15,47,18
293,Cheltenham,12,9,25,33,67,-34,45,19
293,Burton Albion,11,10,25,52,97,-45,43,20
293,Morecambe,10,12,24,44,76,-32,42,21
293,Cambridge Utd,11,9,26,35,70,-35,42,22
293,Acc'ton Stanley,10,12,24,38,77,-39,42,23
293,FG Rovers,8,9,29,41,93,-52,33,24
294,Sheffield Weds,31,12,3,80,30,50,105,1
294,Plymouth Argyle,28,12,6,87,53,34,96,2
294,Ipswich Town,24,15,7,81,45,36,87,3
294,Derby County,24,12,10,74,42,32,84,4
294,Bolton,22,13,11,67,33,34,79,5
294,Wycombe,22,9,15,71,53,18,75,6
294,Barnsley,20,12,14,65,45,20,72,7
294,Shrewsbury,21,8,17,56,48,8,71,8
294,Portsmouth,18,15,13,61,50,11,69,9
294,Lincoln City,16,20,10,52,46,6,68,10
294,P'borough Utd,21,4,21,69,63,6,67,11
294,Bristol Rovers,19,9,18,68,69,-1,66,12
294,Exeter City,17,12,17,60,56,4,63,13
294,Charlton Ath,16,14,16,69,58,11,62,14
294,Fleetwood Town,14,16,16,46,48,-2,58,15
294,Port Vale,14,11,21,47,66,-19,53,16
294,Oxford United,11,15,20,43,55,-12,48,17
294,Cambridge Utd,13,9,24,43,71,-28,48,18
294,Burton Albion,12,9,25,52,89,-37,45,19
294,MK Dons,11,10,25,45,70,-25,43,20
294,Morecambe,9,13,24,43,76,-33,40,21
294,Cheltenham,10,9,27,32,64,-32,39,22
294,Acc'ton Stanley,8,15,23,34,70,-36,39,23
294,FG Rovers,6,16,24,35,80,-45,34,24
295,Sheffield Weds,28,14,4,81,34,47,98,1
295,Plymouth Argyle,29,10,7,86,49,37,97,2
295,Barnsley,28,8,10,76,41,35,92,3
295,Ipswich Town,25,14,7,81,44,37,89,4
295,Derby County,26,10,10,80,47,33,88,5
295,Bolton,25,11,10,71,33,38,86,6
295,Portsmouth,21,13,12,64,47,17,76,7
295,Wycombe,21,8,17,58,47,11,71,8
295,P'borough Utd,20,8,18,71,63,8,68,9
295,Charlton Ath,15,16,15,67,57,10,61,10
295,Shrewsbury,16,13,17,55,55,0,61,11
295,Lincoln City,12,22,12,50,48,2,58,12
295,Oxford United,16,10,20,52,55,-3,58,13
295,Exeter City,15,12,19,52,55,-3,57,14
295,Bristol Rovers,14,14,18,60,70,-10,56,15
295,Fleetwood Town,13,15,18,48,50,-2,54,16
295,Cambridge Utd,15,7,24,47,73,-26,52,17
295,Port Vale,14,9,23,48,71,-23,51,18
295,Acc'ton Stanley,13,11,22,44,68,-24,50,19
295,Burton Albion,11,12,23,54,84,-30,45,20
295,Morecambe,11,12,23,46,76,-30,45,21
295,Cheltenham,11,10,25,35,66,-31,43,22
295,MK Dons,9,8,29,36,76,-40,35,23
295,FG Rovers,5,11,30,38,91,-53,26,24
296,Sheffield Weds,32,11,3,87,27,60,107,1
296,Plymouth Argyle,28,11,7,84,47,37,95,2
296,Bolton,26,9,11,68,35,33,87,3
296,Derby County,24,13,9,68,36,32,85,4
296,Barnsley,24,11,11,74,44,30,83,5
296,Ipswich Town,22,15,9,76,45,31,81,6
296,Wycombe,23,10,13,64,41,23,79,7
296,P'borough Utd,24,6,16,79,52,27,78,8
296,Portsmouth,19,15,12,60,50,10,72,9
296,Shrewsbury,19,8,19,49,45,4,65,10
296,Exeter City,17,11,18,57,61,-4,62,11
296,Bristol Rovers,17,10,19,69,73,-4,61,12
296,Lincoln City,12,22,12,42,48,-6,58,13
296,Fleetwood Town,14,15,17,46,43,3,57,14
296,Port Vale,14,14,18,43,58,-15,56,15
296,Burton Albion,14,10,22,59,84,-25,52,16
296,Charlton Ath,13,12,21,58,76,-18,51,17
296,Oxford United,12,13,21,43,55,-12,49,18
296,Acc'ton Stanley,10,16,20,38,65,-27,46,19
296,Cheltenham,11,9,26,32,64,-32,42,20
296,Morecambe,9,14,23,43,71,-28,41,21
296,MK Dons,8,12,26,35,65,-30,36,22
296,Cambridge Utd,9,8,29,32,77,-45,35,23
296,FG Rovers,7,13,26,38,82,-44,34,24
297,Barnsley,28,9,9,72,36,36,93,1
297,Sheffield Weds,25,15,6,80,35,45,90,2
297,Ipswich Town,23,17,6,88,47,41,86,3
297,Derby County,25,11,10,77,41,36,86,4
297,Bolton,24,10,12,71,41,30,82,5
297,Plymouth Argyle,24,10,12,77,57,20,82,6
297,Wycombe,24,9,13,69,41,28,81,7
297,P'borough Utd,22,6,18,76,65,11,72,8
297,Shrewsbury,20,9,17,61,54,7,69,9
297,Portsmouth,17,17,12,58,46,12,68,10
297,Fleetwood Town,14,18,14,55,46,9,60,11
297,Charlton Ath,15,15,16,61,60,1,60,12
297,Lincoln City,12,24,10,43,44,-1,60,13
297,Port Vale,15,13,18,51,63,-12,58,14
297,Exeter City,14,15,17,57,60,-3,57,15
297,Oxford United,13,12,21,48,60,-12,51,16
297,Bristol Rovers,13,11,22,59,77,-18,50,17
297,Acc'ton Stanley,11,14,21,36,72,-36,47,18
297,MK Dons,12,10,24,46,69,-23,46,19
297,Burton Albion,10,15,21,54,84,-30,45,20
297,Morecambe,10,14,22,47,72,-25,44,21
297,Cheltenham,11,10,25,35,66,-31,43,22
297,Cambridge Utd,11,8,27,35,71,-36,41,23
297,FG Rovers,8,10,28,38,87,-49,34,24
298,Sheffield Weds,30,11,5,86,31,55,101,1
298,Plymouth Argyle,28,11,7,86,50,36,95,2
298,Ipswich Town,25,15,6,88,42,46,90,3
298,Barnsley,27,8,11,72,39,33,89,4
298,Wycombe,23,12,11,65,38,27,81,5
298,Derby County,23,11,12,72,42,30,80,6
298,Bolton,23,11,12,68,38,30,80,7
298,Portsmouth,19,15,12,65,55,10,72,8
298,P'borough Utd,20,8,18,72,58,14,68,9
298,Shrewsbury,18,13,15,55,55,0,67,10
298,Exeter City,17,13,16,63,56,7,64,11
298,Lincoln City,13,20,13,44,45,-1,59,12
298,Charlton Ath,14,14,18,59,62,-3,56,13
298,Oxford United,14,12,20,51,60,-9,54,14
298,Bristol Rovers,15,9,22,60,82,-22,54,15
298,Fleetwood Town,12,14,20,46,54,-8,50,16
298,Port Vale,14,8,24,45,69,-24,50,17
298,Burton Albion,13,10,23,56,85,-29,49,18
298,Cambridge Utd,11,12,23,35,68,-33,45,19
298,Morecambe,10,14,22,46,67,-21,44,20
298,Acc'ton Stanley,10,14,22,40,74,-34,44,21
298,Cheltenham,11,10,25,30,61,-31,43,22
298,MK Dons,10,11,25,41,70,-29,41,23
298,FG Rovers,9,10,27,42,86,-44,37,24
299,Sheffield Weds,30,11,5,83,26,57,101,1
299,Ipswich Town,25,15,6,83,39,44,90,2
299,Derby County,25,13,8,80,38,42,88,3
299,Bolton,25,11,10,70,34,36,86,4
299,Wycombe,25,9,12,72,37,35,84,5
299,Plymouth Argyle,24,12,10,80,54,26,84,6
299,Barnsley,24,11,11,69,43,26,83,7
299,P'borough Utd,23,4,19,74,59,15,73,8
299,Portsmouth,19,15,12,70,48,22,72,9
299,Charlton Ath,18,14,14,68,58,10,68,10
299,Fleetwood Town,15,19,12,50,45,5,64,11
299,Lincoln City,13,23,10,43,42,1,62,12
299,Shrewsbury,16,12,18,50,50,0,60,13
299,Exeter City,14,13,19,57,66,-9,55,14
299,Bristol Rovers,14,12,20,62,80,-18,54,15
299,Port Vale,14,11,21,43,64,-21,53,16
299,Cambridge Utd,14,6,26,38,71,-33,48,17
299,Oxford United,11,14,21,44,57,-13,47,18
299,Acc'ton Stanley,12,11,23,40,78,-38,47,19
299,Burton Albion,12,10,24,56,90,-34,46,20
299,Morecambe,10,13,23,43,67,-24,43,21
299,Cheltenham,11,9,26,32,64,-32,42,22
299,MK Dons,9,8,29,35,72,-37,35,23
299,FG Rovers,6,10,30,34,94,-60,28,24
300,Sheffield Weds,31,10,5,83,32,51,103,1
300,Plymouth Argyle,28,11,7,89,48,41,95,2
300,Bolton,25,11,10,71,37,34,86,3
300,Ipswich Town,23,16,7,84,45,39,85,4
300,Barnsley,25,10,11,67,37,30,85,5
300,Derby County,23,14,9,78,42,36,83,6
300,Wycombe,23,10,13,65,41,24,79,7
300,P'borough Utd,21,8,17,71,59,12,71,8
300,Shrewsbury,20,10,16,60,53,7,70,9
300,Charlton Ath,18,13,15,76,56,20,67,10
300,Portsmouth,16,19,11,59,50,9,67,11
300,Fleetwood Town,15,16,15,51,46,5,61,12
300,Exeter City,15,15,16,59,59,0,60,13
300,Bristol Rovers,14,12,20,63,81,-18,54,14
300,Port Vale,14,11,21,43,65,-22,53,15
300,Lincoln City,10,22,14,41,47,-6,52,16
300,Oxford United,13,12,21,47,60,-13,51,17
300,Burton Albion,12,12,22,60,88,-28,48,18
300,Cheltenham,11,12,23,32,63,-31,45,19
300,Cambridge Utd,12,7,27,40,75,-35,43,20
300,MK Dons,11,9,26,42,74,-32,42,21
300,Acc'ton Stanley,9,15,22,33,65,-32,42,22
300,Morecambe,9,13,24,44,81,-37,40,23
300,FG Rovers,5,10,31,31,85,-54,25,24
301,Sheffield Weds,31,11,4,89,32,57,104,1
301,Plymouth Argyle,29,11,6,90,50,40,98,2
301,Derby County,26,11,9,74,41,33,89,3
301,Bolton,25,11,10,73,34,39,86,4
301,Ipswich Town,23,16,7,80,40,40,85,5
301,Barnsley,23,12,11,71,44,27,81,6
301,P'borough Utd,23,7,16,77,56,21,76,7
301,Wycombe,22,8,16,55,43,12,74,8
301,Portsmouth,18,14,14,64,54,10,68,9
301,Fleetwood Town,16,16,14,50,46,4,64,10
301,Port Vale,18,10,18,56,59,-3,64,11
301,Charlton Ath,17,11,18,67,62,5,62,12
301,Shrewsbury,17,11,18,54,54,0,62,13
301,Exeter City,16,13,17,58,57,1,61,14
301,Lincoln City,11,22,13,45,50,-5,55,15
301,Bristol Rovers,15,10,21,60,76,-16,55,16
301,Burton Albion,15,9,22,53,78,-25,54,17
301,Morecambe,11,12,23,44,69,-25,45,18
301,Oxford United,10,12,24,46,67,-21,42,19
301,Acc'ton Stanley,10,12,24,36,75,-39,42,20
301,MK Dons,10,10,26,39,66,-27,40,21
301,Cambridge Utd,10,8,28,34,77,-43,38,22
301,Cheltenham,9,10,27,29,67,-38,37,23
301,FG Rovers,8,11,27,39,86,-47,35,24
302,Sheffield Weds,29,12,5,81,32,49,99,1
302,Ipswich Town,24,17,5,85,43,42,89,2
302,Barnsley,27,6,13,72,43,29,87,3
302,Plymouth Argyle,25,12,9,82,55,27,87,4
302,Derby County,24,13,9,74,39,35,85,5
302,Bolton,24,10,12,69,41,28,82,6
302,Wycombe,23,8,15,69,45,24,77,7
302,P'borough Utd,23,7,16,77,56,21,76,8
302,Portsmouth,18,15,13,64,50,14,69,9
302,Charlton Ath,18,13,15,77,59,18,67,10
302,Shrewsbury,19,10,17,59,55,4,67,11
302,Fleetwood Town,15,16,15,51,50,1,61,12
302,Lincoln City,12,23,11,47,47,0,59,13
302,Port Vale,15,10,21,44,67,-23,55,14
302,Burton Albion,15,9,22,58,85,-27,54,15
302,Exeter City,14,11,21,58,71,-13,53,16
302,Cheltenham,15,8,23,40,58,-18,53,17
302,Bristol Rovers,14,9,23,61,81,-20,51,18
302,Oxford United,12,12,22,42,59,-17,48,19
302,Acc'ton Stanley,11,14,21,41,70,-29,47,20
302,MK Dons,13,7,26,47,66,-19,46,21
302,Morecambe,9,11,26,44,81,-37,38,22
302,Cambridge Utd,10,8,28,35,72,-37,38,23
302,FG Rovers,7,11,28,33,85,-52,32,24
303,Sheffield Weds,30,13,3,90,30,60,103,1
303,Plymouth Argyle,25,15,6,76,50,26,90,2
303,Bolton,24,11,11,68,36,32,83,3
303,Ipswich Town,23,13,10,86,44,42,82,4
303,Derby County,23,11,12,73,47,26,80,5
303,Barnsley,23,8,15,67,46,21,77,6
303,Wycombe,21,11,14,63,45,18,74,7
303,Shrewsbury,21,11,14,60,46,14,74,8
303,P'borough Utd,22,7,17,75,58,17,73,9
303,Portsmouth,16,17,13,55,51,4,65,10
303,Lincoln City,13,24,9,46,48,-2,63,11
303,Charlton Ath,15,15,16,62,59,3,60,12
303,Exeter City,15,13,18,58,63,-5,58,13
303,Fleetwood Town,14,15,17,49,48,1,57,14
303,Cheltenham,16,8,22,40,60,-20,56,15
303,Port Vale,14,13,19,50,58,-8,55,16
303,Bristol Rovers,13,12,21,60,77,-17,51,17
303,Burton Albion,12,15,19,57,82,-25,51,18
303,Oxford United,12,13,21,45,62,-17,49,19
303,Cambridge Utd,11,12,23,41,69,-28,45,20
303,Acc'ton Stanley,9,16,21,39,75,-36,43,21
303,Morecambe,9,15,22,45,76,-31,42,22
303,MK Dons,10,10,26,42,71,-29,40,23
303,FG Rovers,6,12,28,33,79,-46,30,24
304,Sheffield Weds,29,11,6,78,30,48,98,1
304,Plymouth Argyle,30,8,8,86,48,38,98,2
304,Ipswich Town,27,13,6,93,47,46,94,3
304,Barnsley,27,5,14,76,44,32,86,4
304,Derby County,24,12,10,70,40,30,84,5
304,Bolton,25,8,13,70,37,33,83,6
304,Portsmouth,22,14,10,65,46,19,80,7
304,P'borough Utd,25,4,17,84,55,29,79,8
304,Wycombe,19,11,16,57,45,12,68,9
304,Shrewsbury,20,8,18,56,54,2,68,10
304,Lincoln City,13,24,9,45,43,2,63,11
304,Fleetwood Town,16,14,16,54,49,5,62,12
304,Exeter City,16,12,18,63,63,0,60,13
304,Port Vale,16,10,20,49,60,-11,58,14
304,Charlton Ath,13,15,18,58,64,-6,54,15
304,Bristol Rovers,14,12,20,58,71,-13,54,16
304,Oxford United,14,11,21,51,64,-13,53,17
304,Cambridge Utd,14,8,24,43,70,-27,50,18
304,MK Dons,11,10,25,44,69,-25,43,19
304,Morecambe,10,13,23,46,75,-29,43,20
304,Burton Albion,11,10,25,54,93,-39,43,21
304,Cheltenham,9,10,27,33,67,-34,37,22
304,Acc'ton Stanley,9,10,27,38,84,-46,37,23
304,FG Rovers,7,9,30,36,89,-53,30,24
305,Sheffield Weds,31,11,4,94,31,63,104,1
305,Plymouth Argyle,28,11,7,92,54,38,95,2
305,Ipswich Town,26,15,5,81,36,45,93,3
305,Barnsley,26,8,12,74,45,29,86,4
305,Wycombe,24,7,15,61,44,17,79,5
305,Derby County,21,12,13,69,43,26,75,6
305,Bolton,20,15,11,58,37,21,75,7
305,Portsmouth,19,14,13,63,53,10,71,8
305,P'borough Utd,21,7,18,75,58,17,70,9
305,Shrewsbury,19,9,18,52,49,3,66,10
305,Port Vale,17,10,19,51,64,-13,61,11
305,Lincoln City,13,21,12,41,42,-1,60,12
305,Bristol Rovers,16,11,19,62,75,-13,59,13
305,Charlton Ath,15,12,19,58,60,-2,57,14
305,Exeter City,14,12,20,57,63,-6,54,15
305,Fleetwood Town,13,14,19,45,49,-4,53,16
305,Oxford United,13,11,22,49,58,-9,50,17
305,Cheltenham,13,10,23,38,61,-23,49,18
305,Burton Albion,12,13,21,56,80,-24,49,19
305,Morecambe,11,14,21,47,72,-25,47,20
305,Acc'ton Stanley,11,14,21,41,73,-32,47,21
305,MK Dons,12,9,25,41,68,-27,45,22
305,Cambridge Utd,11,9,26,39,73,-34,42,23
305,FG Rovers,7,9,30,32,88,-56,30,24
306,Sheffield Weds,29,11,6,79,38,41,98,1
306,Plymouth Argyle,27,12,7,93,58,35,93,2
306,Bolton,26,8,12,74,39,35,86,3
306,Ipswich Town,23,14,9,73,42,31,83,4
306,Derby County,24,11,11,69,38,31,83,5
306,Barnsley,25,8,13,71,43,28,83,6
306,P'borough Utd,24,7,15,79,58,21,79,7
306,Wycombe,23,8,15,70,45,25,77,8
306,Portsmouth,20,13,13,60,52,8,73,9
306,Fleetwood Town,17,16,13,53,42,11,67,10
306,Shrewsbury,20,7,19,55,51,4,67,11
306,Oxford United,17,10,19,58,55,3,61,12
306,Charlton Ath,16,12,18,63,58,5,60,13
306,Bristol Rovers,16,11,19,63,75,-12,59,14
306,Lincoln City,11,23,12,41,49,-8,56,15
306,Port Vale,14,10,22,44,61,-17,52,16
306,Cheltenham,13,13,20,35,54,-19,52,17
306,Exeter City,13,12,21,56,62,-6,51,18
306,Burton Albion,13,11,22,55,83,-28,50,19
306,Morecambe,10,12,24,44,75,-31,42,20
306,Acc'ton Stanley,9,14,23,35,69,-34,41,21
306,MK Dons,10,10,26,41,70,-29,40,22
306,Cambridge Utd,10,5,31,33,78,-45,35,23
306,FG Rovers,8,10,28,37,86,-49,34,24
307,Sheffield Weds,30,12,4,81,28,53,102,1
307,Plymouth Argyle,29,10,7,81,48,33,97,2
307,Derby County,27,11,8,81,34,47,92,3
307,Ipswich Town,24,16,6,79,42,37,88,4
307,Barnsley,26,10,10,77,40,37,88,5
307,Portsmouth,21,16,9,69,47,22,79,6
307,Bolton,22,9,15,61,41,20,75,7
307,P'borough Utd,23,3,20,84,61,23,72,8
307,Shrewsbury,21,7,18,54,50,4,70,9
307,Wycombe,20,9,17,61,49,12,69,10
307,Fleetwood Town,16,16,14,46,43,3,64,11
307,Lincoln City,14,21,11,46,47,-1,63,12
307,Charlton Ath,15,16,15,72,66,6,61,13
307,Port Vale,16,10,20,54,63,-9,58,14
307,Exeter City,14,14,18,58,60,-2,56,15
307,Bristol Rovers,12,11,23,57,86,-29,47,16
307,Burton Albion,11,13,22,53,83,-30,46,17
307,Oxford United,11,11,24,47,65,-18,44,18
307,MK Dons,11,11,24,44,72,-28,44,19
307,Morecambe,9,15,22,39,67,-28,42,20
307,Acc'ton Stanley,10,12,24,41,73,-32,42,21
307,Cheltenham,11,9,26,33,66,-33,42,22
307,Cambridge Utd,11,8,27,39,75,-36,41,23
307,FG Rovers,8,10,28,36,87,-51,34,24
308,Sheffield Weds,30,12,4,80,33,47,102,1
308,Plymouth Argyle,29,10,7,82,49,33,97,2
308,Ipswich Town,24,17,5,85,42,43,89,3
308,Barnsley,27,8,11,81,41,40,89,4
308,Portsmouth,21,17,8,72,46,26,80,5
308,Bolton,22,12,12,74,42,32,78,6
308,Derby County,22,11,13,70,45,25,77,7
308,P'borough Utd,24,5,17,80,58,22,77,8
308,Wycombe,22,10,14,58,40,18,76,9
308,Lincoln City,15,21,10,48,40,8,66,10
308,Shrewsbury,19,7,20,58,57,1,64,11
308,Fleetwood Town,14,16,16,47,46,1,58,12
308,Charlton Ath,14,15,17,63,60,3,57,13
308,Bristol Rovers,15,11,20,61,75,-14,56,14
308,Exeter City,14,9,23,56,66,-10,51,15
308,Port Vale,13,11,22,45,71,-26,50,16
308,Acc'ton Stanley,12,14,20,44,70,-26,50,17
308,MK Dons,12,11,23,47,68,-21,47,18
308,Burton Albion,12,11,23,59,86,-27,47,19
308,Oxford United,11,12,23,46,68,-22,45,20
308,Cheltenham,11,11,24,37,69,-32,44,21
308,Cambridge Utd,10,10,26,36,76,-40,40,22
308,Morecambe,8,15,23,45,78,-33,39,23
308,FG Rovers,8,10,28,40,88,-48,34,24
309,Sheffield Weds,33,10,3,88,26,62,109,1
309,Plymouth Argyle,29,11,6,85,47,38,98,2
309,Ipswich Town,26,13,7,85,40,45,91,3
309,Bolton,26,9,11,73,39,34,87,4
309,Derby County,25,10,11,84,50,34,85,5
309,Barnsley,24,8,14,70,48,22,80,6
309,P'borough Utd,25,5,16,77,57,20,80,7
309,Wycombe,21,11,14,57,40,17,74,8
309,Portsmouth,20,14,12,69,57,12,74,9
309,Charlton Ath,18,14,14,63,51,12,68,10
309,Shrewsbury,18,9,19,56,53,3,63,11
309,Exeter City,15,13,18,60,64,-4,58,12
309,Fleetwood Town,13,17,16,48,48,0,56,13
309,Lincoln City,11,21,14,42,50,-8,54,14
309,Port Vale,14,12,20,44,59,-15,54,15
309,Burton Albion,14,9,23,55,88,-33,51,16
309,Bristol Rovers,12,13,21,61,81,-20,49,17
309,Oxford United,12,12,22,48,63,-15,48,18
309,Cheltenham,13,9,24,39,60,-21,48,19
309,MK Dons,12,7,27,47,72,-25,43,20
309,Cambridge Utd,12,7,27,43,74,-31,43,21
309,Morecambe,9,13,24,48,76,-28,40,22
309,Acc'ton Stanley,9,12,25,31,77,-46,39,23
309,FG Rovers,7,9,30,36,89,-53,30,24
310,Sheffield Weds,32,9,5,94,32,62,105,1
310,Plymouth Argyle,26,13,7,91,56,35,91,2
310,Ipswich Town,25,13,8,84,45,39,88,3
310,Bolton,25,11,10,70,36,34,86,4
310,Barnsley,25,10,11,66,36,30,85,5
310,Derby County,24,12,10,79,49,30,84,6
310,Wycombe,24,9,13,65,41,24,81,7
310,P'borough Utd,23,5,18,68,57,11,74,8
310,Portsmouth,19,15,12,69,52,17,72,9
310,Shrewsbury,20,9,17,59,47,12,69,10
310,Fleetwood Town,14,16,16,54,51,3,58,11
310,Bristol Rovers,15,13,18,65,78,-13,58,12
310,Charlton Ath,13,17,16,60,59,1,56,13
310,Exeter City,14,14,18,54,59,-5,56,14
310,Lincoln City,11,23,12,38,45,-7,56,15
310,Oxford United,14,13,19,49,55,-6,55,16
310,Port Vale,12,15,19,50,72,-22,51,17
310,Burton Albion,11,14,21,57,85,-28,47,18
310,Cambridge Utd,12,8,26,38,70,-32,44,19
310,Acc'ton Stanley,10,13,23,40,75,-35,43,20
310,MK Dons,10,11,25,39,67,-28,41,21
310,Cheltenham,11,7,28,34,72,-38,40,22
310,Morecambe,8,14,24,42,72,-30,38,23
310,FG Rovers,7,10,29,39,93,-54,31,24
311,Sheffield Weds,29,11,6,82,36,46,98,1
311,Derby County,26,11,9,78,41,37,89,2
311,Bolton,26,11,9,66,32,34,89,3
311,Ipswich Town,24,16,6,81,42,39,88,4
311,Plymouth Argyle,26,10,10,85,54,31,88,5
311,Wycombe,26,7,13,70,37,33,85,6
311,P'borough Utd,26,5,15,83,51,32,83,7
311,Barnsley,22,11,13,65,45,20,77,8
311,Fleetwood Town,16,17,13,50,43,7,65,9
311,Charlton Ath,17,14,15,67,62,5,65,10
311,Portsmouth,15,17,14,60,53,7,62,11
311,Lincoln City,14,20,12,47,48,-1,62,12
311,Shrewsbury,18,7,21,49,54,-5,61,13
311,Bristol Rovers,16,11,19,66,71,-5,59,14
311,Port Vale,15,9,22,48,68,-20,54,15
311,MK Dons,15,7,24,53,70,-17,52,16
311,Exeter City,13,10,23,57,68,-11,49,17
311,Morecambe,12,13,21,50,76,-26,49,18
311,Oxford United,11,13,22,46,59,-13,46,19
311,Burton Albion,12,10,24,60,91,-31,46,20
311,Cambridge Utd,11,9,26,38,70,-32,42,21
311,Acc'ton Stanley,10,12,24,33,70,-37,42,22
311,Cheltenham,10,11,25,33,66,-33,41,23
311,FG Rovers,6,10,30,29,89,-60,28,24
312,Sheffield Weds,30,12,4,88,32,56,102,1
312,Plymouth Argyle,28,11,7,86,48,38,95,2
312,Derby County,25,13,8,78,40,38,88,3
312,Barnsley,26,7,13,76,48,28,85,4
312,Ipswich Town,23,15,8,82,47,35,84,5
312,Bolton,24,11,11,71,40,31,83,6
312,Wycombe,24,8,14,64,41,23,80,7
312,P'borough Utd,24,4,18,74,58,16,76,8
312,Portsmouth,21,13,12,66,51,15,76,9
312,Shrewsbury,20,7,19,59,55,4,67,10
312,Charlton Ath,15,15,16,64,61,3,60,11
312,Exeter City,16,12,18,65,66,-1,60,12
312,Fleetwood Town,14,17,15,49,48,1,59,13
312,Bristol Rovers,16,9,21,65,76,-11,57,14
312,Oxford United,13,14,19,49,58,-9,53,15
312,Port Vale,14,10,22,41,65,-24,52,16
312,Cheltenham,14,9,23,36,60,-24,51,17
312,Lincoln City,10,20,16,43,52,-9,50,18
312,Burton Albion,13,10,23,53,83,-30,49,19
312,Morecambe,12,11,23,48,75,-27,47,20
312,Acc'ton Stanley,12,11,23,46,74,-28,47,21
312,MK Dons,9,8,29,39,77,-38,35,22
312,Cambridge Utd,9,8,29,34,73,-39,35,23
312,FG Rovers,7,11,28,37,85,-48,32,24
313,Sheffield Weds,30,12,4,89,32,57,102,1
313,Ipswich Town,26,14,6,91,42,49,92,2
313,Plymouth Argyle,27,11,8,88,51,37,92,3
313,Barnsley,26,10,10,79,47,32,88,4
313,Derby County,24,13,9,79,44,35,85,5
313,Bolton,24,11,11,69,39,30,83,6
313,Wycombe,22,12,12,70,48,22,78,7
313,Shrewsbury,20,13,13,59,44,15,73,8
313,Portsmouth,18,17,11,68,57,11,71,9
313,P'borough Utd,20,7,19,74,63,11,67,10
313,Fleetwood Town,16,13,17,51,49,2,61,11
313,Charlton Ath,14,17,15,66,67,-1,59,12
313,Lincoln City,12,23,11,41,44,-3,59,13
313,Port Vale,16,9,21,45,62,-17,57,14
313,Exeter City,15,10,21,62,73,-11,55,15
313,Bristol Rovers,13,11,22,61,83,-22,50,16
313,Burton Albion,12,10,24,52,86,-34,46,17
313,Oxford United,11,12,23,49,67,-18,45,18
313,MK Dons,11,11,24,44,71,-27,44,19
313,Acc'ton Stanley,10,14,22,42,70,-28,44,20
313,Cambridge Utd,11,11,24,39,68,-29,44,21
313,Cheltenham,12,8,26,38,67,-29,44,22
313,Morecambe,9,15,22,46,78,-32,42,23
313,FG Rovers,6,10,30,31,81,-50,28,24
314,Sheffield Weds,31,12,3,87,27,60,105,1
314,Plymouth Argyle,28,10,8,88,50,38,94,2
314,Ipswich Town,26,15,5,85,40,45,93,3
314,Bolton,26,9,11,66,31,35,87,4
314,Wycombe,26,6,14,74,44,30,84,5
314,Derby County,23,13,10,73,40,33,82,6
314,Barnsley,23,10,13,70,46,24,79,7
314,Portsmouth,18,17,11,69,53,16,71,8
314,Shrewsbury,18,10,18,54,49,5,64,9
314,P'borough Utd,18,9,19,70,72,-2,63,10
314,Lincoln City,13,22,11,46,48,-2,61,11
314,Exeter City,15,13,18,60,66,-6,58,12
314,Oxford United,14,14,18,52,54,-2,56,13
314,Port Vale,16,8,22,48,72,-24,56,14
314,Charlton Ath,13,13,20,56,62,-6,52,15
314,Bristol Rovers,14,10,22,63,83,-20,52,16
314,Fleetwood Town,12,15,19,43,46,-3,51,17
314,Acc'ton Stanley,13,12,21,46,67,-21,51,18
314,Cheltenham,13,10,23,37,64,-27,49,19
314,Cambridge Utd,13,9,24,41,69,-28,48,20
314,Morecambe,12,11,23,47,75,-28,47,21
314,MK Dons,11,9,26,42,66,-24,42,22
314,Burton Albion,10,10,26,50,93,-43,40,23
314,FG Rovers,7,11,28,36,86,-50,32,24
315,Sheffield Weds,28,12,6,79,31,48,96,1
315,Plymouth Argyle,26,12,8,87,50,37,90,2
315,Barnsley,27,8,11,72,43,29,89,3
315,Bolton,26,10,10,66,33,33,88,4
315,Ipswich Town,24,13,9,80,42,38,85,5
315,Derby County,23,12,11,75,44,31,81,6
315,Wycombe,24,9,13,63,38,25,81,7
315,P'borough Utd,24,7,15,83,60,23,79,8
315,Charlton Ath,19,13,14,73,53,20,70,9
315,Portsmouth,17,18,11,61,48,13,69,10
315,Shrewsbury,19,9,18,55,48,7,66,11
315,Fleetwood Town,16,16,14,54,49,5,64,12
315,Exeter City,16,11,19,61,60,1,59,13
315,Lincoln City,11,24,11,42,44,-2,57,14
315,Port Vale,15,8,23,52,69,-17,53,15
315,Bristol Rovers,14,11,21,67,86,-19,53,16
315,Cheltenham,14,9,23,35,59,-24,51,17
315,Burton Albion,13,12,21,58,90,-32,51,18
315,Oxford United,11,12,23,44,60,-16,45,19
315,MK Dons,12,9,25,43,67,-24,45,20
315,Acc'ton Stanley,10,12,24,37,71,-34,42,21
315,Cambridge Utd,11,7,28,41,81,-40,40,22
315,Morecambe,8,12,26,37,79,-42,36,23
315,FG Rovers,6,10,30,34,94,-60,28,24
316,Sheffield Weds,26,15,5,75,29,46,93,1
316,Plymouth Argyle,27,11,8,81,48,33,92,2
316,Derby County,25,13,8,74,36,38,88,3
316,Barnsley,25,10,11,74,37,37,85,4
316,Bolton,25,10,11,71,36,35,85,5
316,Wycombe,24,11,11,70,38,32,83,6
316,Ipswich Town,20,18,8,73,44,29,78,7
316,P'borough Utd,23,7,16,81,57,24,76,8
316,Portsmouth,20,16,10,65,47,18,76,9
316,Port Vale,19,9,18,56,56,0,66,10
316,Charlton Ath,17,13,16,67,57,10,64,11
316,Lincoln City,13,22,11,48,49,-1,61,12
316,Shrewsbury,17,10,19,50,56,-6,61,13
316,Fleetwood Town,13,16,17,49,45,4,55,14
316,Oxford United,13,14,19,54,61,-7,53,15
316,Cheltenham,13,11,22,43,61,-18,50,16
316,Bristol Rovers,13,11,22,57,83,-26,50,17
316,Exeter City,13,10,23,51,71,-20,49,18
316,MK Dons,13,9,24,44,70,-26,48,19
316,Acc'ton Stanley,11,14,21,44,73,-29,47,20
316,Burton Albion,12,10,24,56,90,-34,46,21
316,Morecambe,10,11,25,43,80,-37,41,22
316,Cambridge Utd,10,7,29,32,76,-44,37,23
316,FG Rovers,5,12,29,32,90,-58,27,24
317,Sheffield Weds,29,12,5,83,32,51,99,1
317,Plymouth Argyle,28,12,6,84,48,36,96,2
317,Ipswich Town,25,14,7,85,45,40,89,3
317,Barnsley,26,10,10,73,39,34,88,4
317,Bolton,25,10,11,72,38,34,85,5
317,Derby County,22,13,11,71,40,31,79,6
317,Wycombe,23,8,15,64,39,25,77,7
317,Shrewsbury,21,9,16,60,46,14,72,8
317,P'borough Utd,21,7,18,77,61,16,70,9
317,Lincoln City,16,20,10,52,46,6,68,10
317,Portsmouth,17,15,14,57,55,2,66,11
317,Charlton Ath,15,17,14,63,60,3,62,12
317,Fleetwood Town,13,20,13,51,46,5,59,13
317,Exeter City,16,11,19,65,64,1,59,14
317,Oxford United,15,10,21,50,57,-7,55,15
317,Bristol Rovers,13,16,17,63,76,-13,55,16
317,Port Vale,13,11,22,43,70,-27,50,17
317,MK Dons,11,12,23,41,65,-24,45,18
317,Cambridge Utd,12,9,25,39,73,-34,45,19
317,Burton Albion,11,12,23,52,87,-35,45,20
317,Cheltenham,11,9,26,37,67,-30,42,21
317,Acc'ton Stanley,8,15,23,39,78,-39,39,22
317,Morecambe,8,11,27,41,77,-36,35,23
317,FG Rovers,6,11,29,34,87,-53,29,24
318,Sheffield Weds,30,11,5,82,29,53,101,1
318,Plymouth Argyle,30,10,6,94,49,45,100,2
318,Derby County,27,10,9,79,38,41,91,3
318,Bolton,25,11,10,68,33,35,86,4
318,Ipswich Town,22,17,7,81,45,36,83,5
318,Wycombe,24,10,12,69,39,30,82,6
318,Barnsley,23,9,14,69,51,18,78,7
318,Shrewsbury,23,7,16,60,43,17,76,8
318,Portsmouth,18,16,12,64,53,11,70,9
318,P'borough Utd,19,10,17,69,56,13,67,10
318,Charlton Ath,15,18,13,66,58,8,63,11
318,Lincoln City,11,24,11,40,43,-3,57,12
318,Oxford United,15,11,20,52,55,-3,56,13
318,Exeter City,14,14,18,58,63,-5,56,14
318,Fleetwood Town,12,18,16,42,44,-2,54,15
318,Port Vale,13,11,22,47,73,-26,50,16
318,Burton Albion,12,13,21,56,78,-22,49,17
318,Bristol Rovers,11,14,21,61,80,-19,47,18
318,Cheltenham,12,10,24,34,61,-27,46,19
318,MK Dons,11,11,24,43,72,-29,44,20
318,Cambridge Utd,9,12,25,32,72,-40,39,21
318,Morecambe,8,14,24,41,78,-37,38,22
318,Acc'ton Stanley,8,13,25,31,78,-47,37,23
318,FG Rovers,7,12,27,33,80,-47,33,24
319,Sheffield Weds,27,15,4,76,30,46,96,1
319,Plymouth Argyle,28,10,8,78,46,32,94,2
319,Barnsley,27,7,12,72,42,30,88,3
319,Ipswich Town,24,14,8,88,43,45,86,4
319,Bolton,24,10,12,66,35,31,82,5
319,Derby County,23,13,10,69,39,30,82,6
319,P'borough Utd,23,6,17,81,54,27,75,7
319,Wycombe,19,12,15,54,46,8,69,8
319,Portsmouth,18,13,15,61,55,6,67,9
319,Shrewsbury,19,8,19,54,56,-2,65,10
319,Charlton Ath,17,13,16,78,64,14,64,11
319,Fleetwood Town,16,15,15,50,43,7,63,12
319,Lincoln City,13,21,12,42,44,-2,60,13
319,Port Vale,16,10,20,50,65,-15,58,14
319,Bristol Rovers,14,13,19,64,78,-14,55,15
319,Cheltenham,14,12,20,36,56,-20,54,16
319,Exeter City,13,12,21,51,60,-9,51,17
319,Oxford United,13,11,22,51,63,-12,50,18
319,Cambridge Utd,14,7,25,41,70,-29,49,19
319,Acc'ton Stanley,12,12,22,42,68,-26,48,20
319,Burton Albion,12,11,23,54,83,-29,47,21
319,MK Dons,11,11,24,43,63,-20,44,22
319,Morecambe,8,13,25,43,84,-41,37,23
319,FG Rovers,8,9,29,35,92,-57,33,24
320,Sheffield Weds,32,11,3,87,25,62,107,1
320,Ipswich Town,25,14,7,90,44,46,89,2
320,Derby County,26,10,10,79,38,41,88,3
320,Plymouth Argyle,25,11,10,85,53,32,86,4
320,Barnsley,25,9,12,73,41,32,84,5
320,Wycombe,24,9,13,68,38,30,81,6
320,Bolton,23,12,11,67,38,29,81,7
320,P'borough Utd,25,4,17,83,58,25,79,8
320,Portsmouth,18,15,13,58,48,10,69,9
320,Charlton Ath,18,13,15,69,65,4,67,10
320,Shrewsbury,19,8,19,51,58,-7,65,11
320,Fleetwood Town,15,18,13,49,43,6,63,12
320,Lincoln City,12,21,13,43,55,-12,57,13
320,Exeter City,15,11,20,61,68,-7,56,14
320,Bristol Rovers,15,9,22,66,91,-25,54,15
320,Port Vale,14,9,23,45,65,-20,51,16
320,Oxford United,13,11,22,47,64,-17,50,17
320,Burton Albion,12,9,25,56,89,-33,45,18
320,Acc'ton Stanley,11,12,23,35,69,-34,45,19
320,MK Dons,10,13,23,44,70,-26,43,20
320,Morecambe,9,14,23,44,70,-26,41,21
320,Cheltenham,10,11,25,29,64,-35,41,22
320,Cambridge Utd,10,9,27,37,71,-34,39,23
320,FG Rovers,10,9,27,39,80,-41,39,24
321,Ipswich Town,28,14,4,90,36,54,98,1
321,Sheffield Weds,29,10,7,84,35,49,97,2
321,Barnsley,29,8,9,72,37,35,95,3
321,Plymouth Argyle,27,13,6,84,47,37,94,4
321,Bolton,23,11,12,65,36,29,80,5
321,Derby County,22,12,12,71,46,25,78,6
321,Wycombe,24,6,16,67,48,19,78,7
321,P'borough Utd,24,4,18,77,56,21,76,8
321,Portsmouth,17,19,10,63,51,12,70,9
321,Charlton Ath,17,15,14,62,51,11,66,10
321,Shrewsbury,19,8,19,57,50,7,65,11
321,Lincoln City,13,20,13,47,52,-5,59,12
321,Fleetwood Town,13,18,15,48,42,6,57,13
321,Exeter City,16,9,21,56,65,-9,57,14
321,Bristol Rovers,15,12,19,63,79,-16,57,15
321,Oxford United,14,11,21,47,60,-13,53,16
321,Port Vale,14,8,24,44,72,-28,50,17
321,Burton Albion,13,10,23,58,87,-29,49,18
321,Cambridge Utd,13,8,25,39,70,-31,47,19
321,Acc'ton Stanley,10,14,22,40,69,-29,44,20
321,Cheltenham,10,9,27,29,62,-33,39,21
321,MK Dons,10,8,28,40,73,-33,38,22
321,Morecambe,8,14,24,42,76,-34,38,23
321,FG Rovers,8,11,27,35,80,-45,35,24
322,Sheffield Weds,31,12,3,88,27,61,105,1
322,Ipswich Town,26,14,6,84,41,43,92,2
322,Plymouth Argyle,26,13,7,84,52,32,91,3
322,Barnsley,27,9,10,70,35,35,90,4
322,Derby County,25,12,9,78,40,38,87,5
322,Bolton,25,10,11,70,37,33,85,6
322,Wycombe,22,8,16,60,46,14,74,7
322,P'borough Utd,22,5,19,74,58,16,71,8
322,Portsmouth,16,18,12,58,47,11,66,9
322,Shrewsbury,18,9,19,52,57,-5,63,10
322,Charlton Ath,16,14,16,71,61,10,62,11
322,Fleetwood Town,15,16,15,52,50,2,61,12
322,Bristol Rovers,16,11,19,64,77,-13,59,13
322,Lincoln City,10,24,12,41,46,-5,54,14
322,Port Vale,14,12,20,45,65,-20,54,15
322,Exeter City,13,13,20,56,64,-8,52,16
322,Oxford United,13,11,22,46,58,-12,50,17
322,Burton Albion,12,12,22,58,84,-26,48,18
322,Acc'ton Stanley,11,15,20,40,68,-28,48,19
322,Morecambe,12,11,23,44,76,-32,47,20
322,Cheltenham,10,12,24,36,65,-29,42,21
322,MK Dons,9,11,26,39,65,-26,38,22
322,Cambridge Utd,10,8,28,41,81,-40,38,23
322,FG Rovers,8,10,28,34,85,-51,34,24
323,Plymouth Argyle,30,10,6,94,46,48,100,1
323,Sheffield Weds,28,12,6,78,31,47,96,2
323,Ipswich Town,26,14,6,95,44,51,92,3
323,Barnsley,27,8,11,74,36,38,89,4
323,Derby County,23,14,9,72,41,31,83,5
323,Bolton,22,13,11,65,35,30,79,6
323,P'borough Utd,24,7,15,80,53,27,79,7
323,Wycombe,23,7,16,61,48,13,76,8
323,Portsmouth,19,16,11,61,46,15,73,9
323,Charlton Ath,16,15,15,63,56,7,63,10
323,Fleetwood Town,14,17,15,50,47,3,59,11
323,Lincoln City,13,20,13,42,45,-3,59,12
323,Shrewsbury,17,7,22,48,58,-10,58,13
323,Morecambe,14,13,19,48,67,-19,55,14
323,Port Vale,15,9,22,48,73,-25,54,15
323,Exeter City,13,13,20,57,62,-5,52,16
323,Bristol Rovers,13,12,21,61,77,-16,51,17
323,Oxford United,12,13,21,41,55,-14,49,18
323,Acc'ton Stanley,12,11,23,40,77,-37,47,19
323,Cambridge Utd,13,7,26,38,69,-31,46,20
323,Cheltenham,13,7,26,34,68,-34,46,21
323,Burton Albion,11,11,24,52,84,-32,44,22
323,MK Dons,9,10,27,40,72,-32,37,23
323,FG Rovers,7,10,29,34,86,-52,31,24
324,Sheffield Weds,30,9,7,81,33,48,99,1
324,Plymouth Argyle,29,11,6,102,50,52,98,2
324,Derby County,27,11,8,72,38,34,92,3
324,Bolton,26,10,10,78,40,38,88,4
324,Barnsley,26,10,10,73,40,33,88,5
324,Ipswich Town,23,14,9,87,52,35,83,6
324,Wycombe,21,11,14,62,46,16,74,7
324,P'borough Utd,20,7,19,69,59,10,67,8
324,Charlton Ath,18,12,16,79,68,11,66,9
324,Portsmouth,16,18,12,60,50,10,66,10
324,Shrewsbury,19,6,21,66,56,10,63,11
324,Exeter City,17,12,17,61,59,2,63,12
324,Port Vale,17,11,18,49,62,-13,62,13
324,Fleetwood Town,15,16,15,50,44,6,61,14
324,Lincoln City,13,20,13,44,49,-5,59,15
324,Bristol Rovers,15,10,21,70,88,-18,55,16
324,Burton Albion,14,8,24,62,89,-27,50,17
324,Cheltenham,13,9,24,40,64,-24,48,18
324,Oxford United,10,14,22,44,62,-18,44,19
324,MK Dons,11,11,24,42,68,-26,44,20
324,Morecambe,10,12,24,44,88,-44,42,21
324,Acc'ton Stanley,8,15,23,32,66,-34,39,22
324,Cambridge Utd,10,8,28,37,77,-40,38,23
324,FG Rovers,6,11,29,31,87,-56,29,24
325,Sheffield Weds,30,10,6,84,35,49,100,1
325,Plymouth Argyle,29,10,7,89,46,43,97,2
325,Ipswich Town,27,14,5,94,46,48,95,3
325,Bolton,24,12,10,74,35,39,84,4
325,Barnsley,25,8,13,71,46,25,83,5
325,Wycombe,25,7,14,71,44,27,82,6
325,Derby County,22,13,11,67,36,31,79,7
325,Portsmouth,20,14,12,66,51,15,74,8
325,P'borough Utd,21,7,18,70,57,13,70,9
325,Fleetwood Town,16,16,14,55,50,5,64,10
325,Shrewsbury,18,10,18,59,57,2,64,11
325,Exeter City,16,12,18,64,60,4,60,12
325,Charlton Ath,15,14,17,54,58,-4,59,13
325,Oxford United,15,13,18,48,54,-6,58,14
325,Port Vale,16,10,20,54,63,-9,58,15
325,Bristol Rovers,16,10,20,64,78,-14,58,16
325,Lincoln City,11,22,13,39,47,-8,55,17
325,Burton Albion,14,10,22,60,83,-23,52,18
325,Acc'ton Stanley,9,15,22,40,72,-32,42,19
325,MK Dons,11,8,27,40,68,-28,41,20
325,Cheltenham,11,7,28,30,66,-36,40,21
325,Morecambe,9,13,24,38,75,-37,40,22
325,Cambridge Utd,9,10,27,33,77,-44,37,23
325,FG Rovers,5,11,30,32,92,-60,26,24
326,Sheffield Weds,28,15,3,81,31,50,99,1
326,Plymouth Argyle,29,12,5,89,49,40,99,2
326,Barnsley,27,8,11,70,39,31,89,3
326,Ipswich Town,23,17,6,80,43,37,86,4
326,Derby County,22,15,9,76,39,37,81,5
326,Bolton,22,13,11,66,38,28,79,6
326,P'borough Utd,24,6,16,80,63,17,78,7
326,Wycombe,22,9,15,66,45,21,75,8
326,Charlton Ath,17,14,15,66,57,9,65,9
326,Shrewsbury,18,11,17,56,54,2,65,10
326,Fleetwood Town,15,16,15,51,47,4,61,11
326,Portsmouth,13,21,12,56,51,5,60,12
326,Port Vale,15,13,18,49,61,-12,58,13
326,Lincoln City,11,20,15,44,49,-5,53,14
326,Bristol Rovers,13,12,21,69,89,-20,51,15
326,Acc'ton Stanley,13,12,21,40,64,-24,51,16
326,Exeter City,12,14,20,55,64,-9,50,17
326,Cheltenham,14,8,24,41,65,-24,50,18
326,Morecambe,12,12,22,46,73,-27,48,19
326,Oxford United,10,17,19,46,57,-11,47,20
326,Burton Albion,10,13,23,52,84,-32,43,21
326,MK Dons,10,12,24,42,67,-25,42,22
326,Cambridge Utd,11,9,26,39,72,-33,42,23
326,FG Rovers,7,9,30,31,90,-59,30,24
327,Plymouth Argyle,30,9,7,83,48,35,99,1
327,Sheffield Weds,29,11,6,80,33,47,98,2
327,Bolton,26,10,10,76,34,42,88,3
327,Barnsley,26,9,11,79,43,36,87,4
327,Derby County,24,12,10,76,46,30,84,5
327,Wycombe,25,7,14,65,40,25,82,6
327,P'borough Utd,25,6,15,87,59,28,81,7
327,Ipswich Town,22,13,11,81,45,36,79,8
327,Portsmouth,19,16,11,63,49,14,73,9
327,Fleetwood Town,17,14,15,52,42,10,65,10
327,Shrewsbury,19,8,19,52,52,0,65,11
327,Charlton Ath,15,12,19,60,62,-2,57,12
327,Bristol Rovers,16,9,21,60,74,-14,57,13
327,Lincoln City,11,22,13,40,47,-7,55,14
327,Port Vale,15,10,21,44,59,-15,55,15
327,Oxford United,14,12,20,48,61,-13,54,16
327,Burton Albion,14,10,22,63,94,-31,52,17
327,Exeter City,12,15,19,54,63,-9,51,18
327,Cheltenham,14,9,23,34,59,-25,51,19
327,Cambridge Utd,12,7,27,39,81,-42,43,20
327,Morecambe,9,12,25,43,74,-31,39,21
327,Acc'ton Stanley,9,12,25,38,73,-35,39,22
327,MK Dons,9,10,27,36,72,-36,37,23
327,FG Rovers,8,9,29,38,81,-43,33,24
328,Plymouth Argyle,30,9,7,97,46,51,99,1
328,Sheffield Weds,26,14,6,76,34,42,92,2
328,Barnsley,26,9,11,73,48,25,87,3
328,Ipswich Town,23,17,6,89,42,47,86,4
328,Bolton,23,11,12,65,37,28,80,5
328,Derby County,21,15,10,66,39,27,78,6
328,Wycombe,21,11,14,59,42,17,74,7
328,Portsmouth,19,15,12,62,53,9,72,8
328,Charlton Ath,18,13,15,68,56,12,67,9
328,P'borough Utd,19,9,18,71,59,12,66,10
328,Shrewsbury,19,9,18,49,47,2,66,11
328,Fleetwood Town,15,18,13,51,43,8,63,12
328,Lincoln City,12,22,12,43,50,-7,58,13
328,Exeter City,14,12,20,54,62,-8,54,14
328,Bristol Rovers,13,15,18,60,79,-19,54,15
328,Oxford United,12,15,19,54,63,-9,51,16
328,Cheltenham,13,11,22,35,54,-19,50,17
328,MK Dons,13,10,23,48,68,-20,49,18
328,Port Vale,12,13,21,48,71,-23,49,19
328,Acc'ton Stanley,11,14,21,41,71,-30,47,20
328,Morecambe,9,16,21,46,74,-28,43,21
328,Burton Albion,9,16,21,53,86,-33,43,22
328,Cambridge Utd,10,10,26,37,71,-34,40,23
328,FG Rovers,6,12,28,33,83,-50,30,24
329,Sheffield Weds,32,8,6,87,29,58,104,1
329,Plymouth Argyle,29,10,7,83,48,35,97,2
329,Barnsley,29,8,9,73,35,38,95,3
329,Ipswich Town,24,14,8,81,42,39,86,4
329,Bolton,25,11,10,69,36,33,86,5
329,Derby County,23,12,11,72,45,27,81,6
329,Wycombe,23,7,16,66,50,16,76,7
329,P'borough Utd,22,7,17,76,58,18,73,8
329,Portsmouth,18,17,11,65,53,12,71,9
329,Charlton Ath,19,11,16,69,58,11,68,10
329,Fleetwood Town,18,14,14,55,45,10,68,11
329,Shrewsbury,17,12,17,53,49,4,63,12
329,Exeter City,17,10,19,59,59,0,61,13
329,Bristol Rovers,14,11,21,60,76,-16,53,14
329,Lincoln City,10,21,15,39,53,-14,51,15
329,Port Vale,14,7,25,49,72,-23,49,16
329,Cheltenham,12,10,24,34,58,-24,46,17
329,Oxford United,11,12,23,47,63,-16,45,18
329,Cambridge Utd,12,9,25,37,70,-33,45,19
329,Morecambe,10,14,22,44,69,-25,44,20
329,Acc'ton Stanley,11,11,24,39,74,-35,44,21
329,Burton Albion,12,8,26,48,88,-40,44,22
329,MK Dons,10,10,26,38,65,-27,40,23
329,FG Rovers,8,10,28,33,81,-48,34,24
330,Sheffield Weds,30,12,4,86,33,53,102,1
330,Plymouth Argyle,28,9,9,80,50,30,93,2
330,Ipswich Town,26,13,7,81,40,41,91,3
330,Derby County,26,11,9,77,38,39,89,4
330,Bolton,24,12,10,69,35,34,84,5
330,Barnsley,24,10,12,71,44,27,82,6
330,Wycombe,23,9,14,64,48,16,78,7
330,Fleetwood Town,21,14,11,60,41,19,77,8
330,P'borough Utd,23,5,18,77,62,15,74,9
330,Shrewsbury,19,10,17,57,53,4,67,10
330,Portsmouth,15,17,14,55,52,3,62,11
330,Charlton Ath,15,16,15,68,62,6,61,12
330,Exeter City,14,12,20,59,62,-3,54,13
330,Oxford United,14,12,20,51,58,-7,54,14
330,Burton Albion,15,9,22,56,82,-26,54,15
330,Port Vale,14,11,21,43,60,-17,53,16
330,Lincoln City,10,21,15,42,52,-10,51,17
330,Bristol Rovers,13,11,22,60,81,-21,50,18
330,Morecambe,10,14,22,48,76,-28,44,19
330,MK Dons,11,10,25,42,69,-27,43,20
330,Cheltenham,12,7,27,33,61,-28,43,21
330,Acc'ton Stanley,9,15,22,34,69,-35,42,22
330,Cambridge Utd,9,9,28,37,75,-38,36,23
330,FG Rovers,6,13,27,35,82,-47,31,24
331,Plymouth Argyle,31,9,6,87,46,41,102,1
331,Sheffield Weds,30,11,5,87,30,57,101,2
331,Barnsley,25,9,12,72,43,29,84,3
331,Ipswich Town,22,17,7,79,44,35,83,4
331,Derby County,24,10,12,72,41,31,82,5
331,Wycombe,25,6,15,64,41,23,81,6
331,P'borough Utd,25,5,16,76,49,27,80,7
331,Bolton,23,10,13,68,41,27,79,8
331,Portsmouth,19,15,12,65,55,10,72,9
331,Exeter City,16,13,17,61,64,-3,61,10
331,Bristol Rovers,17,10,19,65,75,-10,61,11
331,Fleetwood Town,14,17,15,50,48,2,59,12
331,Lincoln City,14,17,15,50,53,-3,59,13
331,Shrewsbury,16,11,19,47,52,-5,59,14
331,Charlton Ath,13,17,16,57,56,1,56,15
331,Port Vale,14,10,22,49,68,-19,52,16
331,Burton Albion,13,11,22,59,85,-26,50,17
331,Oxford United,12,11,23,45,66,-21,47,18
331,Cheltenham,13,7,26,38,66,-28,46,19
331,MK Dons,11,12,23,41,63,-22,45,20
331,Morecambe,10,15,21,46,69,-23,45,21
331,Cambridge Utd,11,10,25,45,80,-35,43,22
331,Acc'ton Stanley,7,16,23,35,71,-36,37,23
331,FG Rovers,7,11,28,34,86,-52,32,24
332,Sheffield Weds,28,13,5,81,38,43,97,1
332,Bolton,25,10,11,66,35,31,85,2
332,Plymouth Argyle,24,13,9,79,53,26,85,3
332,Wycombe,26,6,14,66,39,27,84,4
332,Derby County,22,15,9,71,43,28,81,5
332,Barnsley,22,13,11,72,46,26,79,6
332,Ipswich Town,21,14,11,75,48,27,77,7
332,Portsmouth,20,14,12,66,54,12,74,8
332,P'borough Utd,22,5,19,71,66,5,71,9
332,Shrewsbury,19,9,18,60,54,6,66,10
332,Lincoln City,13,25,8,54,51,3,64,11
332,Fleetwood Town,16,15,15,55,48,7,63,12
332,Exeter City,16,14,16,57,52,5,62,13
332,Charlton Ath,17,11,18,61,58,3,62,14
332,Bristol Rovers,17,8,21,69,77,-8,59,15
332,Oxford United,14,15,17,49,51,-2,57,16
332,Port Vale,15,8,23,47,64,-17,53,17
332,MK Dons,14,7,25,46,69,-23,49,18
332,Burton Albion,12,10,24,60,95,-35,46,19
332,Cambridge Utd,13,6,27,40,69,-29,45,20
332,Morecambe,9,16,21,45,71,-26,43,21
332,Acc'ton Stanley,9,15,22,41,69,-28,42,22
332,Cheltenham,11,8,27,35,66,-31,41,23
332,FG Rovers,7,10,29,34,84,-50,31,24
333,Sheffield Weds,31,11,4,82,26,56,104,1
333,Plymouth Argyle,29,12,5,90,47,43,99,2
333,Ipswich Town,24,16,6,84,48,36,88,3
333,P'borough Utd,26,5,15,84,53,31,83,4
333,Bolton,24,9,13,67,38,29,81,5
333,Wycombe,24,8,14,65,45,20,80,6
333,Derby County,21,12,13,71,46,25,75,7
333,Portsmouth,19,16,11,64,52,12,73,8
333,Barnsley,21,9,16,68,51,17,72,9
333,Fleetwood Town,17,16,13,54,43,11,67,10
333,Shrewsbury,18,11,17,55,51,4,65,11
333,Exeter City,16,12,18,66,65,1,60,12
333,Charlton Ath,15,14,17,64,61,3,59,13
333,Port Vale,14,13,19,48,65,-17,55,14
333,Lincoln City,11,21,14,39,48,-9,54,15
333,Bristol Rovers,14,10,22,56,79,-23,52,16
333,MK Dons,13,10,23,45,67,-22,49,17
333,Oxford United,10,17,19,46,58,-12,47,18
333,Burton Albion,11,13,22,63,88,-25,46,19
333,Cheltenham,11,10,25,32,59,-27,43,20
333,Acc'ton Stanley,9,15,22,38,70,-32,42,21
333,FG Rovers,10,11,25,39,78,-39,41,22
333,Morecambe,7,16,23,41,79,-38,37,23
333,Cambridge Utd,10,7,29,38,82,-44,37,24
334,Sheffield Weds,28,10,8,83,38,45,94,1
334,Plymouth Argyle,27,12,7,87,55,32,93,2
334,Barnsley,28,7,11,78,42,36,91,3
334,Ipswich Town,25,14,7,86,44,42,89,4
334,Bolton,24,11,11,64,32,32,83,5
334,P'borough Utd,26,4,16,88,58,30,82,6
334,Derby County,22,15,9,74,42,32,81,7
334,Wycombe,24,9,13,76,45,31,81,8
334,Portsmouth,22,15,9,64,44,20,81,9
334,Fleetwood Town,15,18,13,50,45,5,63,10
334,Charlton Ath,16,14,16,67,59,8,62,11
334,Shrewsbury,16,10,20,46,51,-5,58,12
334,Bristol Rovers,15,10,21,62,78,-16,55,13
334,Burton Albion,14,12,20,59,79,-20,54,14
334,Exeter City,14,11,21,57,70,-13,53,15
334,Oxford United,14,11,21,48,65,-17,53,16
334,Lincoln City,10,20,16,39,51,-12,50,17
334,Cheltenham,13,11,22,35,62,-27,50,18
334,Morecambe,11,14,21,50,77,-27,47,19
334,Port Vale,13,7,26,46,71,-25,46,20
334,Acc'ton Stanley,11,13,22,46,78,-32,46,21
334,MK Dons,10,8,28,41,70,-29,38,22
334,Cambridge Utd,10,6,30,31,74,-43,36,23
334,FG Rovers,7,12,27,33,80,-47,33,24
335,Sheffield Weds,31,11,4,83,28,55,104,1
335,Plymouth Argyle,29,10,7,88,51,37,97,2
335,Ipswich Town,24,15,7,94,47,47,87,3
335,Barnsley,26,8,12,74,45,29,86,4
335,Bolton,24,10,12,68,39,29,82,5
335,Wycombe,24,9,13,64,42,22,81,6
335,P'borough Utd,25,5,16,82,54,28,80,7
335,Derby County,21,15,10,67,44,23,78,8
335,Portsmouth,17,18,11,62,50,12,69,9
335,Shrewsbury,20,9,17,61,52,9,69,10
335,Charlton Ath,16,15,15,70,61,9,63,11
335,Lincoln City,14,20,12,45,45,0,62,12
335,Fleetwood Town,14,16,16,53,50,3,58,13
335,Oxford United,15,12,19,51,52,-1,57,14
335,Exeter City,15,9,22,64,75,-11,54,15
335,Bristol Rovers,14,12,20,63,74,-11,54,16
335,Port Vale,13,9,24,42,73,-31,48,17
335,Cheltenham,12,11,23,30,59,-29,47,18
335,Cambridge Utd,12,11,23,43,73,-30,47,19
335,Burton Albion,11,11,24,54,85,-31,44,20
335,MK Dons,10,12,24,41,69,-28,42,21
335,Morecambe,9,12,25,46,82,-36,39,22
335,Acc'ton Stanley,8,13,25,33,76,-43,37,23
335,FG Rovers,5,13,28,37,89,-52,28,24
336,Sheffield Weds,30,9,7,87,38,49,99,1
336,Plymouth Argyle,27,12,7,83,50,33,93,2
336,Barnsley,28,6,12,80,42,38,90,3
336,Bolton,26,9,11,71,37,34,87,4
336,Derby County,24,13,9,74,39,35,85,5
336,Ipswich Town,22,13,11,81,51,30,79,6
336,Portsmouth,20,15,11,59,50,9,75,7
336,P'borough Utd,22,8,16,76,59,17,74,8
336,Wycombe,21,9,16,58,43,15,72,9
336,Fleetwood Town,17,14,15,55,52,3,65,10
336,Exeter City,18,10,18,61,58,3,64,11
336,Shrewsbury,17,11,18,52,53,-1,62,12
336,Lincoln City,14,19,13,45,48,-3,61,13
336,Charlton Ath,15,13,18,62,61,1,58,14
336,Bristol Rovers,15,12,19,63,74,-11,57,15
336,Acc'ton Stanley,13,13,20,50,74,-24,52,16
336,Cheltenham,14,9,23,46,62,-16,51,17
336,Port Vale,12,12,22,46,73,-27,48,18
336,Burton Albion,10,16,20,57,80,-23,46,19
336,Oxford United,11,12,23,46,64,-18,45,20
336,Morecambe,10,13,23,49,71,-22,43,21
336,MK Dons,11,10,25,40,66,-26,43,22
336,Cambridge Utd,9,13,24,37,73,-36,40,23
336,FG Rovers,6,9,31,31,91,-60,27,24
337,Plymouth Argyle,30,10,6,101,49,52,100,1
337,Sheffield Weds,29,12,5,82,34,48,99,2
337,Ipswich Town,24,16,6,85,46,39,88,3
337,Derby County,25,11,10,69,38,31,86,4
337,Bolton,23,12,11,64,37,27,81,5
337,Wycombe,23,9,14,60,41,19,78,6
337,Barnsley,23,8,15,65,44,21,77,7
337,Portsmouth,20,14,12,70,53,17,74,8
337,Fleetwood Town,18,14,14,55,42,13,68,9
337,P'borough Utd,20,8,18,64,52,12,68,10
337,Shrewsbury,19,10,17,53,46,7,67,11
337,Charlton Ath,17,15,14,65,55,10,66,12
337,Bristol Rovers,17,11,18,65,75,-10,62,13
337,Lincoln City,14,19,13,45,48,-3,61,14
337,Exeter City,16,10,20,59,59,0,58,15
337,Port Vale,14,11,21,51,72,-21,53,16
337,Oxford United,12,15,19,46,55,-9,51,17
337,Acc'ton Stanley,13,12,21,40,71,-31,51,18
337,Burton Albion,13,9,24,60,89,-29,48,19
337,Cheltenham,10,10,26,32,70,-38,40,20
337,Morecambe,9,12,25,43,72,-29,39,21
337,MK Dons,9,8,29,41,78,-37,35,22
337,Cambridge Utd,8,11,27,31,74,-43,35,23
337,FG Rovers,8,9,29,37,83,-46,33,24
338,Sheffield Weds,32,10,4,92,32,60,106,1
338,Plymouth Argyle,28,11,7,87,50,37,95,2
338,Barnsley,28,8,10,85,43,42,92,3
338,Ipswich Town,24,17,5,84,43,41,89,4
338,Bolton,24,12,10,70,38,32,84,5
338,Derby County,24,11,11,68,39,29,83,6
338,P'borough Utd,25,4,17,80,55,25,79,7
338,Wycombe,22,9,15,59,45,14,75,8
338,Portsmouth,20,14,12,69,49,20,74,9
338,Fleetwood Town,18,16,12,55,43,12,70,10
338,Shrewsbury,17,7,22,49,55,-6,58,11
338,Port Vale,16,10,20,46,59,-13,58,12
338,Charlton Ath,13,15,18,65,68,-3,54,13
338,Lincoln City,11,21,14,45,54,-9,54,14
338,Oxford United,13,13,20,45,56,-11,52,15
338,Exeter City,14,9,23,49,67,-18,51,16
338,Acc'ton Stanley,12,15,19,43,65,-22,51,17
338,Bristol Rovers,12,11,23,60,93,-33,47,18
338,Cheltenham,12,10,24,40,59,-19,46,19
338,Morecambe,10,16,20,47,70,-23,46,20
338,Burton Albion,11,11,24,52,81,-29,44,21
338,MK Dons,11,9,26,46,72,-26,42,22
338,Cambridge Utd,10,9,27,36,72,-36,39,23
338,FG Rovers,6,10,30,34,98,-64,28,24
339,Sheffield Weds,28,13,5,80,34,46,97,1
339,Plymouth Argyle,29,10,7,88,52,36,97,2
339,Ipswich Town,24,16,6,92,49,43,88,3
339,Derby County,25,11,10,76,42,34,86,4
339,Barnsley,25,11,10,75,42,33,86,5
339,Bolton,24,9,13,72,42,30,81,6
339,Wycombe,22,9,15,62,46,16,75,7
339,P'borough Utd,21,7,18,77,61,16,70,8
339,Portsmouth,16,19,11,56,49,7,67,9
339,Shrewsbury,19,9,18,54,52,2,66,10
339,Charlton Ath,17,12,17,69,61,8,63,11
339,Lincoln City,14,21,11,46,45,1,63,12
339,Bristol Rovers,18,9,19,66,74,-8,63,13
339,Exeter City,15,12,19,62,63,-1,57,14
339,Fleetwood Town,12,18,16,42,44,-2,54,15
339,Oxford United,14,12,20,49,57,-8,54,16
339,Port Vale,15,9,22,45,62,-17,54,17
339,Burton Albion,13,10,23,58,91,-33,49,18
339,Cheltenham,13,9,24,36,60,-24,48,19
339,Morecambe,12,11,23,48,76,-28,47,20
339,Acc'ton Stanley,9,17,20,42,75,-33,44,21
339,MK Dons,10,10,26,41,72,-31,40,22
339,Cambridge Utd,8,11,27,33,74,-41,35,23
339,FG Rovers,5,13,28,35,81,-46,28,24
340,Plymouth Argyle,31,9,6,92,49,43,102,1
340,Sheffield Weds,29,13,4,92,31,61,100,2
340,Ipswich Town,27,14,5,90,42,48,95,3
340,Barnsley,28,8,10,78,50,28,92,4
340,Derby County,24,12,10,76,43,33,84,5
340,Bolton,22,14,10,67,40,27,80,6
340,Wycombe,24,8,14,67,43,24,80,7
340,P'borough Utd,21,7,18,75,64,11,70,8
340,Portsmouth,17,17,12,59,50,9,68,9
340,Charlton Ath,17,12,17,66,63,3,63,10
340,Shrewsbury,18,8,20,60,59,1,62,11
340,Fleetwood Town,15,15,16,50,47,3,60,12
340,Port Vale,16,10,20,46,62,-16,58,13
340,Exeter City,15,12,19,65,67,-2,57,14
340,Bristol Rovers,15,12,19,63,71,-8,57,15
340,Lincoln City,12,18,16,44,54,-10,54,16
340,Cheltenham,13,10,23,44,69,-25,49,17
340,Oxford United,12,12,22,51,62,-11,48,18
340,Burton Albion,12,11,23,60,90,-30,47,19
340,Acc'ton Stanley,9,16,21,35,73,-38,43,20
340,MK Dons,10,12,24,42,66,-24,42,21
340,Morecambe,10,12,24,45,75,-30,42,22
340,Cambridge Utd,10,7,29,36,81,-45,37,23
340,FG Rovers,6,9,31,38,90,-52,27,24
341,Sheffield Weds,32,9,5,85,29,56,105,1
341,Ipswich Town,27,13,6,88,45,43,94,2
341,Plymouth Argyle,27,12,7,83,49,34,93,3
341,Barnsley,28,7,11,76,39,37,91,4
341,Bolton,24,12,10,66,33,33,84,5
341,P'borough Utd,24,6,16,77,57,20,78,6
341,Wycombe,22,8,16,69,45,24,74,7
341,Derby County,19,13,14,62,48,14,70,8
341,Portsmouth,17,14,15,63,56,7,65,9
341,Shrewsbury,19,7,20,54,54,0,64,10
341,Fleetwood Town,16,15,15,50,43,7,63,11
341,Port Vale,18,9,19,48,60,-12,63,12
341,Charlton Ath,15,15,16,65,60,5,60,13
341,Exeter City,14,14,18,52,58,-6,56,14
341,Bristol Rovers,15,10,21,60,80,-20,55,15
341,Acc'ton Stanley,14,10,22,39,66,-27,52,16
341,Oxford United,13,12,21,48,56,-8,51,17
341,Lincoln City,10,21,15,38,55,-17,51,18
341,Burton Albion,13,11,22,59,78,-19,50,19
341,Morecambe,9,17,20,44,66,-22,44,20
341,MK Dons,12,8,26,46,73,-27,44,21
341,Cheltenham,10,12,24,31,65,-34,42,22
341,Cambridge Utd,10,7,29,36,77,-41,37,23
341,FG Rovers,8,10,28,37,84,-47,34,24
342,Sheffield Weds,29,13,4,79,32,47,100,1
342,Plymouth Argyle,29,9,8,89,55,34,96,2
342,Barnsley,27,10,9,79,37,42,91,3
342,Derby County,25,10,11,75,39,36,85,4
342,Ipswich Town,22,16,8,81,46,35,82,5
342,Wycombe,24,10,12,69,40,29,82,6
342,Bolton,23,12,11,68,39,29,81,7
342,Portsmouth,20,15,11,66,46,20,75,8
342,P'borough Utd,21,7,18,69,53,16,70,9
342,Charlton Ath,19,13,14,69,54,15,70,10
342,Fleetwood Town,18,15,13,53,44,9,69,11
342,Shrewsbury,18,11,17,53,52,1,65,12
342,Port Vale,17,9,20,50,61,-11,60,13
342,Lincoln City,11,23,12,40,44,-4,56,14
342,Exeter City,14,13,19,56,63,-7,55,15
342,Oxford United,14,9,23,48,58,-10,51,16
342,Cheltenham,13,9,24,34,61,-27,48,17
342,Bristol Rovers,12,11,23,59,83,-24,47,18
342,Acc'ton Stanley,11,12,23,41,71,-30,45,19
342,Burton Albion,11,10,25,50,88,-38,43,20
342,Morecambe,9,14,23,51,79,-28,41,21
342,Cambridge Utd,11,8,27,37,78,-41,41,22
342,MK Dons,10,10,26,40,71,-31,40,23
342,FG Rovers,5,9,32,30,92,-62,24,24
343,Sheffield Weds,27,15,4,80,32,48,96,1
343,Plymouth Argyle,26,12,8,79,46,33,90,2
343,Barnsley,27,8,11,74,40,34,89,3
343,Ipswich Town,24,16,6,82,42,40,88,4
343,Bolton,26,10,10,67,34,33,88,5
343,Derby County,24,14,8,72,37,35,86,6
343,Wycombe,23,6,17,61,46,15,75,7
343,P'borough Utd,22,7,17,76,58,18,73,8
343,Shrewsbury,20,10,16,55,48,7,70,9
343,Portsmouth,16,17,13,61,55,6,65,10
343,Lincoln City,14,20,12,39,42,-3,62,11
343,Charlton Ath,16,12,18,63,60,3,60,12
343,Fleetwood Town,14,16,16,46,44,2,58,13
343,Bristol Rovers,16,9,21,66,75,-9,57,14
343,Port Vale,15,12,19,42,57,-15,57,15
343,Oxford United,14,13,19,50,55,-5,55,16
343,Exeter City,13,14,19,57,57,0,53,17
343,Cheltenham,13,9,24,36,61,-25,48,18
343,Acc'ton Stanley,11,14,21,37,68,-31,47,19
343,Burton Albion,12,10,24,53,81,-28,46,20
343,Morecambe,10,15,21,45,71,-26,45,21
343,MK Dons,11,9,26,41,70,-29,42,22
343,Cambridge Utd,9,9,28,36,81,-45,36,23
343,FG Rovers,5,11,30,33,91,-58,26,24
344,Sheffield Weds,31,12,3,90,28,62,105,1
344,Ipswich Town,27,13,6,87,40,47,94,2
344,Plymouth Argyle,27,11,8,98,55,43,92,3
344,Bolton,23,13,10,72,38,34,82,4
344,Derby County,23,13,10,70,40,30,82,5
344,Barnsley,23,10,13,75,48,27,79,6
344,Wycombe,23,8,15,67,49,18,77,7
344,Shrewsbury,22,8,16,59,49,10,74,8
344,Portsmouth,19,16,11,64,45,19,73,9
344,P'borough Utd,20,8,18,73,66,7,68,10
344,Fleetwood Town,15,17,14,48,42,6,62,11
344,Charlton Ath,15,13,18,65,63,2,58,12
344,Lincoln City,11,24,11,43,48,-5,57,13
344,Oxford United,15,11,20,48,54,-6,56,14
344,Exeter City,15,11,20,56,65,-9,56,15
344,Port Vale,14,11,21,47,71,-24,53,16
344,Bristol Rovers,13,11,22,60,84,-24,50,17
344,Burton Albion,12,12,22,61,91,-30,48,18
344,Cheltenham,12,9,25,36,65,-29,45,19
344,Acc'ton Stanley,9,17,20,39,66,-27,44,20
344,Morecambe,10,14,22,46,76,-30,44,21
344,MK Dons,11,9,26,43,70,-27,42,22
344,Cambridge Utd,8,11,27,36,77,-41,35,23
344,FG Rovers,6,14,26,37,90,-53,32,24
345,Sheffield Weds,33,10,3,87,29,58,109,1
345,Wycombe,28,6,12,79,40,39,90,2
345,Plymouth Argyle,25,14,7,76,47,29,89,3
345,Ipswich Town,24,14,8,80,39,41,86,4
345,Barnsley,24,13,9,72,46,26,85,5
345,Derby County,24,10,12,68,42,26,82,6
345,Bolton,23,8,15,61,38,23,77,7
345,P'borough Utd,21,6,19,71,58,13,69,8
345,Lincoln City,16,21,9,50,41,9,69,9
345,Portsmouth,17,18,11,61,53,8,69,10
345,Charlton Ath,18,14,14,72,59,13,68,11
345,Shrewsbury,19,9,18,53,51,2,66,12
345,Exeter City,16,12,18,59,60,-1,60,13
345,Fleetwood Town,14,16,16,47,43,4,58,14
345,Port Vale,14,13,19,46,65,-19,55,15
345,Acc'ton Stanley,12,14,20,37,63,-26,50,16
345,Bristol Rovers,13,10,23,64,84,-20,49,17
345,Cheltenham,13,9,24,37,60,-23,48,18
345,Oxford United,11,13,22,44,56,-12,46,19
345,Burton Albion,11,10,25,54,87,-33,43,20
345,Morecambe,9,12,25,41,81,-40,39,21
345,MK Dons,10,8,28,39,74,-35,38,22
345,Cambridge Utd,10,8,28,36,73,-37,38,23
345,FG Rovers,7,12,27,33,78,-45,33,24
346,Sheffield Weds,31,12,3,93,32,61,105,1
346,Ipswich Town,24,16,6,89,44,45,88,2
346,Barnsley,25,9,12,73,41,32,84,3
346,Bolton,24,11,11,76,39,37,83,4
346,Derby County,23,13,10,76,43,33,82,5
346,Plymouth Argyle,23,12,11,75,55,20,81,6
346,Wycombe,22,10,14,68,50,18,76,7
346,Portsmouth,18,17,11,66,51,15,71,8
346,Lincoln City,17,20,9,50,40,10,71,9
346,Shrewsbury,20,9,17,54,50,4,69,10
346,P'borough Utd,20,6,20,76,67,9,66,11
346,Charlton Ath,15,17,14,65,55,10,62,12
346,Burton Albion,17,9,20,56,82,-26,60,13
346,Exeter City,15,13,18,59,61,-2,58,14
346,Port Vale,16,10,20,46,63,-17,58,15
346,Bristol Rovers,14,13,19,62,76,-14,55,16
346,Fleetwood Town,12,18,16,44,47,-3,54,17
346,Morecambe,12,13,21,50,71,-21,49,18
346,Acc'ton Stanley,12,12,22,49,80,-31,48,19
346,MK Dons,11,11,24,45,75,-30,44,20
346,Oxford United,11,10,25,46,68,-22,43,21
346,Cheltenham,10,8,28,31,64,-33,38,22
346,FG Rovers,8,10,28,35,81,-46,34,23
346,Cambridge Utd,8,9,29,36,85,-49,33,24
347,Sheffield Weds,28,12,6,82,33,49,96,1
347,Plymouth Argyle,29,9,8,88,51,37,96,2
347,Ipswich Town,25,15,6,89,44,45,90,3
347,Bolton,26,10,10,76,36,40,88,4
347,Derby County,25,12,9,81,44,37,87,5
347,Barnsley,24,10,12,73,44,29,82,6
347,Wycombe,22,10,14,64,45,19,76,7
347,Portsmouth,20,14,12,64,50,14,74,8
347,P'borough Utd,22,6,18,75,55,20,72,9
347,Shrewsbury,18,12,16,53,48,5,66,10
347,Lincoln City,14,22,10,42,41,1,64,11
347,Charlton Ath,16,14,16,64,60,4,62,12
347,Bristol Rovers,15,13,18,67,76,-9,58,13
347,Fleetwood Town,13,17,16,51,51,0,56,14
347,Exeter City,15,11,20,59,68,-9,56,15
347,Oxford United,14,13,19,49,56,-7,55,16
347,Cheltenham,15,8,23,38,64,-26,53,17
347,Port Vale,13,11,22,47,66,-19,50,18
347,MK Dons,13,9,24,48,72,-24,48,19
347,Acc'ton Stanley,10,14,22,40,72,-32,44,20
347,Burton Albion,10,12,24,53,84,-31,42,21
347,Cambridge Utd,11,8,27,34,76,-42,41,22
347,Morecambe,8,12,26,43,82,-39,36,23
347,FG Rovers,5,8,33,33,95,-62,23,24
348,Sheffield Weds,31,11,4,84,29,55,104,1
348,Plymouth Argyle,28,9,9,84,50,34,93,2
348,Barnsley,28,8,10,76,38,38,92,3
348,Ipswich Town,23,17,6,82,39,43,86,4
348,Derby County,23,12,11,70,38,32,81,5
348,Bolton,22,13,11,62,34,28,79,6
348,P'borough Utd,24,6,16,75,55,20,78,7
348,Wycombe,20,8,18,54,45,9,68,8
348,Charlton Ath,18,13,15,72,59,13,67,9
348,Portsmouth,16,19,11,61,49,12,67,10
348,Bristol Rovers,18,13,15,66,66,0,67,11
348,Exeter City,18,10,18,63,60,3,64,12
348,Shrewsbury,19,7,20,53,54,-1,64,13
348,Lincoln City,13,20,13,44,44,0,59,14
348,Port Vale,16,9,21,46,61,-15,57,15
348,Fleetwood Town,12,17,17,44,48,-4,53,16
348,MK Dons,13,11,22,42,62,-20,50,17
348,Oxford United,12,13,21,42,58,-16,49,18
348,Cheltenham,12,10,24,34,64,-30,46,19
348,Cambridge Utd,11,8,27,37,70,-33,41,20
348,Acc'ton Stanley,9,14,23,36,71,-35,41,21
348,Burton Albion,9,14,23,47,90,-43,41,22
348,Morecambe,8,13,25,41,77,-36,37,23
348,FG Rovers,7,9,30,32,86,-54,30,24
349,Plymouth Argyle,29,12,5,94,53,41,99,1
349,Sheffield Weds,29,11,6,82,38,44,98,2
349,Ipswich Town,26,13,7,91,51,40,91,3
349,Bolton,26,10,10,78,38,40,88,4
349,Derby County,24,12,10,81,46,35,84,5
349,Barnsley,24,10,12,70,46,24,82,6
349,Wycombe,22,8,16,68,46,22,74,7
349,Portsmouth,19,15,12,64,53,11,72,8
349,Shrewsbury,20,11,15,59,48,11,71,9
349,Charlton Ath,18,14,14,73,62,11,68,10
349,P'borough Utd,20,6,20,72,59,13,66,11
349,Lincoln City,13,23,10,41,41,0,62,12
349,Bristol Rovers,17,11,18,70,74,-4,62,13
349,Fleetwood Town,16,12,18,49,48,1,60,14
349,Exeter City,15,11,20,60,62,-2,56,15
349,Port Vale,15,11,20,48,62,-14,56,16
349,Burton Albion,13,10,23,57,87,-30,49,17
349,Morecambe,12,11,23,50,71,-21,47,18
349,Oxford United,11,12,23,44,63,-19,45,19
349,MK Dons,11,10,25,42,70,-28,43,20
349,Cheltenham,12,7,27,39,72,-33,43,21
349,Cambridge Utd,10,8,28,34,78,-44,38,22
349,Acc'ton Stanley,8,12,26,36,87,-51,36,23
349,FG Rovers,7,10,29,33,80,-47,31,24
350,Sheffield Weds,31,10,5,88,35,53,103,1
350,Plymouth Argyle,28,10,8,84,53,31,94,2
350,Ipswich Town,25,15,6,86,44,42,90,3
350,Derby County,25,11,10,78,41,37,86,4
350,Bolton,24,10,12,67,39,28,82,5
350,Barnsley,23,11,12,75,44,31,80,6
350,P'borough Utd,24,6,16,84,62,22,78,7
350,Wycombe,23,7,16,70,48,22,76,8
350,Portsmouth,20,15,11,68,51,17,75,9
350,Charlton Ath,18,14,14,72,52,20,68,10
350,Fleetwood Town,17,14,15,55,46,9,65,11
350,Shrewsbury,18,9,19,54,52,2,63,12
350,Lincoln City,12,23,11,46,50,-4,59,13
350,Port Vale,17,8,21,54,64,-10,59,14
350,Oxford United,15,10,21,51,62,-11,55,15
350,Exeter City,14,12,20,55,59,-4,54,16
350,Bristol Rovers,14,9,23,61,83,-22,51,17
350,Cheltenham,14,7,25,40,66,-26,49,18
350,Acc'ton Stanley,11,13,22,46,78,-32,46,19
350,MK Dons,13,6,27,41,72,-31,45,20
350,Morecambe,9,14,23,41,72,-31,41,21
350,Burton Albion,11,8,27,58,100,-42,41,22
350,Cambridge Utd,9,7,30,33,85,-52,34,23
350,FG Rovers,8,9,29,33,82,-49,33,24
351,Sheffield Weds,32,11,3,92,29,63,107,1
351,Plymouth Argyle,27,13,6,83,47,36,94,2
351,Barnsley,27,8,11,78,43,35,89,3
351,Bolton,26,10,10,76,39,37,88,4
351,Ipswich Town,24,15,7,84,45,39,87,5
351,Derby County,23,13,10,71,40,31,82,6
351,Portsmouth,20,15,11,71,57,14,75,7
351,P'borough Utd,22,8,16,75,54,21,74,8
351,Wycombe,21,10,15,61,45,16,73,9
351,Shrewsbury,19,8,19,57,60,-3,65,10
351,Fleetwood Town,15,15,16,51,49,2,60,11
351,Lincoln City,13,21,12,42,45,-3,60,12
351,Charlton Ath,14,17,15,66,55,11,59,13
351,Bristol Rovers,16,10,20,67,75,-8,58,14
351,Exeter City,14,14,18,54,62,-8,56,15
351,Port Vale,15,10,21,48,62,-14,55,16
351,Oxford United,11,12,23,45,64,-19,45,17
351,Cheltenham,11,11,24,35,63,-28,44,18
351,Cambridge Utd,11,11,24,37,71,-34,44,19
351,Morecambe,10,12,24,47,81,-34,42,20
351,Burton Albion,10,12,24,51,91,-40,42,21
351,MK Dons,10,11,25,39,66,-27,41,22
351,Acc'ton Stanley,8,15,23,37,75,-38,39,23
351,FG Rovers,7,10,29,32,81,-49,31,24
352,Plymouth Argyle,31,10,5,91,50,41,103,1
352,Sheffield Weds,30,11,5,85,35,50,101,2
352,Ipswich Town,27,14,5,97,43,54,95,3
352,Bolton,26,9,11,69,36,33,87,4
352,Derby County,25,10,11,75,41,34,85,5
352,Barnsley,25,8,13,71,44,27,83,6
352,Wycombe,22,10,14,66,44,22,76,7
352,Portsmouth,19,16,11,65,52,13,73,8
352,P'borough Utd,21,6,19,76,62,14,69,9
352,Lincoln City,14,23,9,52,42,10,65,10
352,Shrewsbury,19,7,20,54,59,-5,64,11
352,Fleetwood Town,16,14,16,52,48,4,62,12
352,Charlton Ath,15,15,16,68,62,6,60,13
352,Exeter City,16,11,19,62,63,-1,59,14
352,Oxford United,14,10,22,56,64,-8,52,15
352,Acc'ton Stanley,13,13,20,45,68,-23,52,16
352,Port Vale,14,8,24,46,68,-22,50,17
352,Bristol Rovers,13,10,23,58,87,-29,49,18
352,Burton Albion,12,11,23,58,91,-33,47,19
352,Cheltenham,12,9,25,36,70,-34,45,20
352,MK Dons,11,9,26,38,65,-27,42,21
352,Cambridge Utd,11,9,26,39,75,-36,42,22
352,Morecambe,8,12,26,41,76,-35,36,23
352,FG Rovers,5,11,30,33,88,-55,26,24
353,Sheffield Weds,32,11,3,84,27,57,107,1
353,Plymouth Argyle,29,10,7,92,49,43,97,2
353,Barnsley,28,8,10,74,39,35,92,3
353,Ipswich Town,24,14,8,86,47,39,86,4
353,Derby County,25,10,11,77,44,33,85,5
353,Bolton,23,10,13,67,42,25,79,6
353,Portsmouth,20,16,10,67,50,17,76,7
353,Wycombe,21,12,13,61,40,21,75,8
353,Fleetwood Town,17,16,13,48,41,7,67,9
353,P'borough Utd,20,5,21,71,62,9,65,10
353,Charlton Ath,17,13,16,67,58,9,64,11
353,Shrewsbury,18,7,21,52,57,-5,61,12
353,Exeter City,15,13,18,60,59,1,58,13
353,Bristol Rovers,14,12,20,64,83,-19,54,14
353,Port Vale,15,8,23,49,69,-20,53,15
353,Lincoln City,10,22,14,36,46,-10,52,16
353,Oxford United,13,12,21,49,62,-13,51,17
353,Cheltenham,14,9,23,40,58,-18,51,18
353,MK Dons,13,7,26,42,65,-23,46,19
353,Morecambe,10,15,21,50,78,-28,45,20
353,Burton Albion,11,12,23,57,87,-30,45,21
353,Acc'ton Stanley,11,12,23,43,76,-33,45,22
353,Cambridge Utd,9,7,30,31,77,-46,34,23
353,FG Rovers,7,11,28,35,86,-51,32,24
354,Sheffield Weds,29,9,8,78,36,42,96,1
354,Plymouth Argyle,28,9,9,85,51,34,93,2
354,Ipswich Town,24,16,6,89,42,47,88,3
354,Derby County,25,13,8,74,39,35,88,4
354,Bolton,26,10,10,69,38,31,88,5
354,Barnsley,26,9,11,78,43,35,87,6
354,Wycombe,23,7,16,60,44,16,76,7
354,P'borough Utd,23,4,19,73,59,14,73,8
354,Shrewsbury,22,7,17,58,50,8,73,9
354,Portsmouth,17,19,10,69,56,13,70,10
354,Fleetwood Town,16,16,14,53,45,8,64,11
354,Charlton Ath,16,14,16,68,62,6,62,12
354,Lincoln City,13,20,13,45,46,-1,59,13
354,Oxford United,14,11,21,54,61,-7,53,14
354,Cheltenham,15,8,23,37,60,-23,53,15
354,Bristol Rovers,13,13,20,62,78,-16,52,16
354,Exeter City,13,12,21,59,64,-5,51,17
354,Port Vale,12,11,23,44,73,-29,47,18
354,Morecambe,11,12,23,47,77,-30,45,19
354,MK Dons,12,8,26,48,73,-25,44,20
354,Burton Albion,11,11,24,53,86,-33,44,21
354,Acc'ton Stanley,10,14,22,40,73,-33,44,22
354,Cambridge Utd,10,9,27,33,72,-39,39,23
354,FG Rovers,7,10,29,38,86,-48,31,24
355,Sheffield Weds,29,11,6,78,30,48,98,1
355,Plymouth Argyle,27,12,7,77,46,31,93,2
355,Ipswich Town,25,15,6,82,45,37,90,3
355,Barnsley,27,8,11,71,38,33,89,4
355,Bolton,26,10,10,67,31,36,88,5
355,Derby County,23,14,9,72,39,33,83,6
355,Wycombe,21,10,15,63,49,14,73,7
355,P'borough Utd,21,8,17,78,60,18,71,8
355,Portsmouth,18,17,11,64,48,16,71,9
355,Fleetwood Town,16,15,15,50,44,6,63,10
355,Charlton Ath,16,14,16,63,55,8,62,11
355,Shrewsbury,17,10,19,53,56,-3,61,12
355,Exeter City,16,11,19,57,58,-1,59,13
355,Lincoln City,11,23,12,43,49,-6,56,14
355,Oxford United,14,13,19,46,53,-7,55,15
355,Bristol Rovers,14,11,21,64,79,-15,53,16
355,Port Vale,14,11,21,48,65,-17,53,17
355,Acc'ton Stanley,11,15,20,40,63,-23,48,18
355,Cheltenham,13,9,24,39,65,-26,48,19
355,Morecambe,11,12,23,45,72,-27,45,20
355,Burton Albion,11,12,23,57,93,-36,45,21
355,MK Dons,11,9,26,42,71,-29,42,22
355,Cambridge Utd,8,9,29,28,71,-43,33,23
355,FG Rovers,6,13,27,34,81,-47,31,24
356,Sheffield Weds,31,11,4,85,30,55,104,1
356,Ipswich Town,27,13,6,93,43,50,94,2
356,Plymouth Argyle,28,10,8,87,49,38,94,3
356,Bolton,27,9,10,70,34,36,90,4
356,Derby County,25,11,10,77,37,40,86,5
356,Barnsley,24,11,11,67,41,26,83,6
356,P'borough Utd,24,5,17,76,54,22,77,7
356,Portsmouth,20,14,12,68,58,10,74,8
356,Wycombe,21,10,15,65,48,17,73,9
356,Shrewsbury,20,7,19,56,54,2,67,10
356,Exeter City,17,11,18,62,59,3,62,11
356,Charlton Ath,16,12,18,62,61,1,60,12
356,Lincoln City,13,20,13,50,48,2,59,13
356,Fleetwood Town,13,16,17,47,47,0,55,14
356,Port Vale,14,8,24,43,69,-26,50,15
356,Acc'ton Stanley,13,11,22,41,72,-31,50,16
356,Bristol Rovers,13,10,23,59,79,-20,49,17
356,Cambridge Utd,14,6,26,42,73,-31,48,18
356,Morecambe,12,11,23,47,71,-24,47,19
356,Oxford United,11,12,23,44,61,-17,45,20
356,Burton Albion,11,11,24,54,91,-37,44,21
356,MK Dons,11,9,26,40,71,-31,42,22
356,Cheltenham,11,8,27,30,65,-35,41,23
356,FG Rovers,7,12,27,32,82,-50,33,24
357,Sheffield Weds,31,10,5,90,32,58,103,1
357,Plymouth Argyle,28,11,7,83,48,35,95,2
357,Barnsley,28,7,11,83,40,43,91,3
357,Derby County,26,10,10,74,41,33,88,4
357,Ipswich Town,24,14,8,85,45,40,86,5
357,Wycombe,25,8,13,74,42,32,83,6
357,Bolton,24,11,11,67,40,27,83,7
357,P'borough Utd,24,5,17,76,55,21,77,8
357,Portsmouth,20,15,11,70,53,17,75,9
357,Shrewsbury,19,8,19,52,52,0,65,10
357,Lincoln City,15,20,11,45,45,0,65,11
357,Charlton Ath,15,16,15,60,55,5,61,12
357,Fleetwood Town,12,22,12,49,44,5,58,13
357,Exeter City,15,13,18,62,63,-1,58,14
357,Port Vale,16,9,21,49,65,-16,57,15
357,Bristol Rovers,14,9,23,56,77,-21,51,16
357,Oxford United,13,10,23,48,59,-11,49,17
357,MK Dons,11,9,26,40,74,-34,42,18
357,Cheltenham,10,11,25,32,62,-30,41,19
357,Burton Albion,10,10,26,51,88,-37,40,20
357,Acc'ton Stanley,8,16,22,38,76,-38,40,21
357,Cambridge Utd,10,10,26,34,74,-40,40,22
357,Morecambe,8,14,24,40,74,-34,38,23
357,FG Rovers,6,12,28,36,90,-54,30,24
358,Sheffield Weds,28,13,5,80,31,49,97,1
358,Plymouth Argyle,29,10,7,85,48,37,97,2
358,Ipswich Town,25,16,5,89,38,51,91,3
358,Barnsley,25,11,10,70,41,29,86,4
358,Derby County,23,12,11,73,45,28,81,5
358,Bolton,22,12,12,64,35,29,78,6
358,P'borough Utd,24,4,18,73,53,20,76,7
358,Wycombe,23,7,16,62,44,18,76,8
358,Charlton Ath,20,12,14,69,55,14,72,9
358,Portsmouth,18,16,12,67,49,18,70,10
358,Shrewsbury,19,10,17,49,47,2,67,11
358,Lincoln City,14,21,11,43,44,-1,63,12
358,Fleetwood Town,14,17,15,53,48,5,59,13
358,Exeter City,14,14,18,61,65,-4,56,14
358,Bristol Rovers,15,11,20,66,76,-10,56,15
358,Oxford United,14,12,20,45,55,-10,54,16
358,Port Vale,14,10,22,45,70,-25,52,17
358,MK Dons,12,9,25,46,73,-27,45,18
358,Acc'ton Stanley,9,16,21,34,67,-33,43,19
358,Morecambe,9,15,22,39,67,-28,42,20
358,Cheltenham,11,9,26,33,65,-32,42,21
358,Burton Albion,11,9,26,52,96,-44,42,22
358,Cambridge Utd,9,12,25,34,72,-38,39,23
358,FG Rovers,5,12,29,33,81,-48,27,24
359,Sheffield Weds,30,10,6,78,31,47,100,1
359,Plymouth Argyle,30,10,6,83,44,39,100,2
359,Ipswich Town,26,15,5,89,37,52,93,3
359,Derby County,24,13,9,69,40,29,85,4
359,Bolton,25,9,12,67,37,30,84,5
359,P'borough Utd,23,6,17,73,56,17,75,6
359,Barnsley,22,7,17,70,49,21,73,7
359,Portsmouth,19,12,15,64,56,8,69,8
359,Wycombe,19,10,17,56,46,10,67,9
359,Shrewsbury,19,10,17,53,49,4,67,10
359,Charlton Ath,16,13,17,68,62,6,61,11
359,Oxford United,17,10,19,55,52,3,61,12
359,Fleetwood Town,14,17,15,48,44,4,59,13
359,Exeter City,16,11,19,58,57,1,59,14
359,Port Vale,15,11,20,50,68,-18,56,15
359,Bristol Rovers,15,9,22,66,84,-18,54,16
359,Lincoln City,10,23,13,38,49,-11,53,17
359,Cheltenham,14,11,21,38,54,-16,53,18
359,MK Dons,13,8,25,43,71,-28,47,19
359,Acc'ton Stanley,11,12,23,34,71,-37,45,20
359,Burton Albion,11,11,24,59,91,-32,44,21
359,Cambridge Utd,11,8,27,39,72,-33,41,22
359,Morecambe,9,12,25,41,75,-34,39,23
359,FG Rovers,8,12,26,33,77,-44,36,24
360,Sheffield Weds,30,10,6,86,36,50,100,1
360,Ipswich Town,27,14,5,92,37,55,95,2
360,Plymouth Argyle,26,13,7,90,57,33,91,3
360,Barnsley,26,8,12,79,44,35,86,4
360,Derby County,23,14,9,80,46,34,83,5
360,P'borough Utd,25,6,15,79,48,31,81,6
360,Wycombe,25,6,15,62,39,23,81,7
360,Bolton,22,13,11,71,40,31,79,8
360,Shrewsbury,21,9,16,59,47,12,72,9
360,Charlton Ath,18,13,15,69,59,10,67,10
360,Portsmouth,17,14,15,59,60,-1,65,11
360,Fleetwood Town,15,16,15,49,46,3,61,12
360,Exeter City,13,15,18,58,63,-5,54,13
360,Lincoln City,11,21,14,40,46,-6,54,14
360,Bristol Rovers,15,9,22,64,83,-19,54,15
360,Port Vale,14,9,23,45,73,-28,51,16
360,Oxford United,12,13,21,43,58,-15,49,17
360,Burton Albion,13,10,23,56,88,-32,49,18
360,Acc'ton Stanley,12,12,22,41,67,-26,48,19
360,Morecambe,10,15,21,50,75,-25,45,20
360,MK Dons,11,10,25,44,73,-29,43,21
360,Cheltenham,11,9,26,35,69,-34,42,22
360,Cambridge Utd,9,9,28,34,78,-44,36,23
360,FG Rovers,7,10,29,35,88,-53,31,24
361,Sheffield Weds,30,13,3,86,33,53,103,1
361,Plymouth Argyle,30,8,8,101,49,52,98,2
361,Ipswich Town,24,16,6,82,43,39,88,3
361,Bolton,24,12,10,65,34,31,84,4
361,Derby County,23,14,9,74,41,33,83,5
361,Barnsley,22,14,10,66,45,21,80,6
361,P'borough Utd,22,7,17,75,54,21,73,7
361,Wycombe,20,9,17,67,51,16,69,8
361,Charlton Ath,18,14,14,71,53,18,68,9
361,Portsmouth,17,16,13,64,48,16,67,10
361,Shrewsbury,18,9,19,51,51,0,63,11
361,Fleetwood Town,16,14,16,51,48,3,62,12
361,Exeter City,16,13,17,60,57,3,61,13
361,Bristol Rovers,16,10,20,64,77,-13,58,14
361,Lincoln City,11,22,13,42,49,-7,55,15
361,Port Vale,14,10,22,41,68,-27,52,16
361,Oxford United,12,15,19,51,60,-9,51,17
361,Acc'ton Stanley,13,12,21,43,66,-23,51,18
361,Morecambe,12,13,21,49,73,-24,49,19
361,MK Dons,10,13,23,41,64,-23,43,20
361,Cheltenham,11,10,25,40,76,-36,43,21
361,Cambridge Utd,11,8,27,37,75,-38,41,22
361,Burton Albion,10,10,26,49,96,-47,40,23
361,FG Rovers,6,10,30,32,91,-59,28,24
362,Sheffield Weds,32,11,3,85,29,56,107,1
362,Plymouth Argyle,29,12,5,87,47,40,99,2
362,Ipswich Town,26,13,7,86,44,42,91,3
362,Barnsley,25,9,12,69,41,28,84,4
362,Wycombe,25,8,13,69,39,30,83,5
362,Bolton,23,10,13,64,37,27,79,6
362,P'borough Utd,23,8,15,76,57,19,77,7
362,Derby County,21,13,12,70,50,20,76,8
362,Portsmouth,18,16,12,68,51,17,70,9
362,Charlton Ath,17,12,17,62,55,7,63,10
362,Shrewsbury,18,8,20,52,53,-1,62,11
362,Fleetwood Town,15,16,15,46,41,5,61,12
362,Oxford United,14,13,19,53,53,0,55,13
362,Bristol Rovers,15,10,21,64,76,-12,55,14
362,Lincoln City,10,24,12,40,49,-9,54,15
362,Port Vale,13,14,19,42,61,-19,53,16
362,Exeter City,13,12,21,53,61,-8,51,17
362,Burton Albion,11,15,20,61,83,-22,48,18
362,Morecambe,11,12,23,40,79,-39,45,19
362,Cheltenham,11,11,24,37,64,-27,44,20
362,Acc'ton Stanley,9,16,21,39,68,-29,43,21
362,MK Dons,11,8,27,40,74,-34,41,22
362,Cambridge Utd,11,7,28,35,77,-42,40,23
362,FG Rovers,7,10,29,33,82,-49,31,24
363,Sheffield Weds,32,11,3,94,28,66,107,1
363,Plymouth Argyle,28,11,7,92,52,40,95,2
363,Barnsley,26,8,12,74,46,28,86,3
363,Ipswich Town,23,15,8,83,42,41,84,4
363,Bolton,23,14,9,66,35,31,83,5
363,Derby County,22,15,9,73,43,30,81,6
363,P'borough Utd,22,10,14,76,58,18,76,7
363,Charlton Ath,21,12,13,76,56,20,75,8
363,Wycombe,22,8,16,61,45,16,74,9
363,Portsmouth,18,15,13,64,50,14,69,10
363,Fleetwood Town,16,16,14,52,44,8,64,11
363,Shrewsbury,18,10,18,56,49,7,64,12
363,Lincoln City,13,21,12,45,48,-3,60,13
363,Exeter City,13,16,17,57,60,-3,55,14
363,Bristol Rovers,13,14,19,62,83,-21,53,15
363,Port Vale,13,12,21,45,70,-25,51,16
363,Oxford United,12,13,21,48,64,-16,49,17
363,Cheltenham,11,10,25,33,64,-31,43,18
363,Cambridge Utd,12,7,27,39,71,-32,43,19
363,Morecambe,10,11,25,45,82,-37,41,20
363,Burton Albion,9,13,24,51,88,-37,40,21
363,FG Rovers,9,12,25,37,81,-44,39,22
363,MK Dons,10,8,28,40,72,-32,38,23
363,Acc'ton Stanley,8,14,24,36,74,-38,38,24
364,Plymouth Argyle,30,9,7,85,45,40,99,1
364,Barnsley,29,6,11,90,50,40,93,2
364,Sheffield Weds,27,9,10,78,35,43,90,3
364,Derby County,24,14,8,76,39,37,86,4
364,Bolton,25,9,12,72,38,34,84,5
364,Ipswich Town,23,14,9,85,46,39,83,6
364,Wycombe,25,8,13,66,43,23,83,7
364,Portsmouth,19,15,12,63,54,9,72,8
364,Shrewsbury,21,7,18,58,53,5,70,9
364,Lincoln City,17,18,11,46,45,1,69,10
364,P'borough Utd,20,7,19,71,62,9,67,11
364,Fleetwood Town,16,16,14,52,44,8,64,12
364,Charlton Ath,16,13,17,61,61,0,61,13
364,Bristol Rovers,15,12,19,65,73,-8,57,14
364,Burton Albion,15,11,20,56,82,-26,56,15
364,Exeter City,14,11,21,59,67,-8,53,16
364,Oxford United,14,11,21,49,58,-9,53,17
364,Port Vale,14,10,22,46,69,-23,52,18
364,Cheltenham,13,10,23,32,54,-22,49,19
364,Acc'ton Stanley,11,13,22,37,72,-35,46,20
364,Cambridge Utd,12,6,28,39,74,-35,42,21
364,MK Dons,11,7,28,38,69,-31,40,22
364,Morecambe,8,10,28,44,78,-34,34,23
364,FG Rovers,5,10,31,34,91,-57,25,24
365,Sheffield Weds,34,8,4,91,29,62,110,1
365,Plymouth Argyle,29,11,6,91,49,42,98,2
365,Barnsley,27,8,11,78,39,39,89,3
365,Ipswich Town,25,13,8,87,47,40,88,4
365,Derby County,23,13,10,71,43,28,82,5
365,Bolton,23,11,12,66,39,27,80,6
365,Wycombe,21,9,16,61,44,17,72,7
365,P'borough Utd,22,6,18,74,58,16,72,8
365,Portsmouth,17,17,12,66,54,12,68,9
365,Fleetwood Town,15,19,12,52,43,9,64,10
365,Charlton Ath,16,12,18,65,63,2,60,11
365,Shrewsbury,17,9,20,49,52,-3,60,12
365,Lincoln City,12,23,11,48,48,0,59,13
365,Port Vale,16,10,20,61,68,-7,58,14
365,Exeter City,15,12,19,59,64,-5,57,15
365,Bristol Rovers,14,9,23,58,84,-26,51,16
365,Burton Albion,13,12,21,58,94,-36,51,17
365,Morecambe,12,14,20,47,72,-25,50,18
365,Acc'ton Stanley,12,13,21,43,70,-27,49,19
365,Oxford United,11,14,21,44,61,-17,47,20
365,Cambridge Utd,11,7,28,36,74,-38,40,21
365,MK Dons,10,9,27,46,73,-27,39,22
365,Cheltenham,10,8,28,34,69,-35,38,23
365,FG Rovers,9,9,28,36,84,-48,36,24
366,Sheffield Weds,28,9,9,80,34,46,93,1
366,Ipswich Town,25,15,6,91,44,47,90,2
366,Derby County,25,13,8,72,39,33,88,3
366,Plymouth Argyle,24,14,8,75,53,22,86,4
366,Barnsley,24,11,11,71,42,29,83,5
366,Bolton,25,8,13,67,40,27,83,6
366,Portsmouth,20,16,10,66,50,16,76,7
366,Wycombe,20,11,15,60,45,15,71,8
366,P'borough Utd,20,8,18,68,58,10,68,9
366,Shrewsbury,20,8,18,57,56,1,68,10
366,Charlton Ath,17,13,16,68,64,4,64,11
366,Fleetwood Town,15,17,14,48,44,4,62,12
366,Lincoln City,13,22,11,43,44,-1,61,13
366,Exeter City,15,14,17,56,53,3,59,14
366,Port Vale,15,11,20,44,60,-16,56,15
366,Bristol Rovers,15,10,21,62,71,-9,55,16
366,MK Dons,14,9,23,48,67,-19,51,17
366,Acc'ton Stanley,12,12,22,42,69,-27,48,18
366,Oxford United,12,11,23,48,65,-17,47,19
366,Burton Albion,10,15,21,58,82,-24,45,20
366,Cheltenham,12,9,25,34,63,-29,45,21
366,Morecambe,10,13,23,42,70,-28,43,22
366,FG Rovers,9,9,28,35,78,-43,36,23
366,Cambridge Utd,9,8,29,36,80,-44,35,24
367,Sheffield Weds,32,9,5,90,32,58,105,1
367,Plymouth Argyle,28,11,7,89,53,36,95,2
367,Bolton,25,11,10,71,35,36,86,3
367,Ipswich Town,23,16,7,84,46,38,85,4
367,Derby County,22,12,12,75,46,29,78,5
367,Barnsley,23,8,15,66,49,17,77,6
367,P'borough Utd,24,4,18,77,57,20,76,7
367,Wycombe,21,9,16,63,48,15,72,8
367,Portsmouth,18,15,13,67,54,13,69,9
367,Charlton Ath,17,15,14,76,61,15,66,10
367,Bristol Rovers,18,12,16,73,75,-2,66,11
367,Shrewsbury,18,10,18,55,56,-1,64,12
367,Lincoln City,14,21,11,42,48,-6,63,13
367,Fleetwood Town,15,16,15,50,45,5,61,14
367,Exeter City,15,11,20,55,58,-3,56,15
367,Port Vale,14,12,20,44,61,-17,54,16
367,Oxford United,12,12,22,51,63,-12,48,17
367,Burton Albion,12,12,22,52,88,-36,48,18
367,MK Dons,13,8,25,40,63,-23,47,19
367,Morecambe,10,15,21,48,75,-27,45,20
367,Cheltenham,12,9,25,34,61,-27,45,21
367,Cambridge Utd,12,7,27,37,76,-39,43,22
367,Acc'ton Stanley,9,13,24,35,73,-38,40,23
367,FG Rovers,7,8,31,33,84,-51,29,24
368,Plymouth Argyle,28,9,9,88,48,40,93,1
368,Sheffield Weds,27,10,9,83,44,39,91,2
368,Ipswich Town,25,15,6,88,44,44,90,3
368,Barnsley,26,9,11,72,39,33,87,4
368,Derby County,25,11,10,70,36,34,86,5
368,Bolton,24,10,12,70,37,33,82,6
368,P'borough Utd,22,7,17,74,59,15,73,7
368,Shrewsbury,19,12,15,58,49,9,69,8
368,Wycombe,20,7,19,56,45,11,67,9
368,Portsmouth,17,15,14,61,56,5,66,10
368,Fleetwood Town,17,14,15,52,45,7,65,11
368,Exeter City,17,12,17,55,54,1,63,12
368,Lincoln City,14,20,12,46,45,1,62,13
368,Charlton Ath,14,15,17,60,63,-3,57,14
368,Bristol Rovers,14,11,21,63,77,-14,53,15
368,Cheltenham,14,10,22,37,59,-22,52,16
368,Oxford United,12,14,20,49,58,-9,50,17
368,Port Vale,14,8,24,47,67,-20,50,18
368,Morecambe,12,14,20,48,71,-23,50,19
368,Cambridge Utd,13,6,27,38,68,-30,45,20
368,Burton Albion,11,12,23,55,88,-33,45,21
368,Acc'ton Stanley,10,13,23,38,78,-40,43,22
368,MK Dons,11,9,26,40,69,-29,42,23
368,FG Rovers,9,11,26,38,87,-49,38,24
369,Sheffield Weds,30,11,5,87,35,52,101,1
369,Plymouth Argyle,29,11,6,85,48,37,98,2
369,Derby County,23,15,8,69,37,32,84,3
369,Ipswich Town,22,17,7,86,44,42,83,4
369,Barnsley,24,11,11,74,43,31,83,5
369,Bolton,23,12,11,64,35,29,81,6
369,Wycombe,21,12,13,65,44,21,75,7
369,Fleetwood Town,20,13,13,61,44,17,73,8
369,Shrewsbury,19,13,14,57,46,11,70,9
369,Charlton Ath,17,14,15,67,58,9,65,10
369,Portsmouth,17,14,15,60,59,1,65,11
369,P'borough Utd,19,6,21,69,62,7,63,12
369,Lincoln City,12,22,12,41,45,-4,58,13
369,Exeter City,14,13,19,51,59,-8,55,14
369,Bristol Rovers,15,10,21,71,84,-13,55,15
369,Port Vale,15,8,23,51,68,-17,53,16
369,Oxford United,13,11,22,45,60,-15,50,17
369,Morecambe,12,13,21,48,73,-25,49,18
369,Acc'ton Stanley,12,12,22,38,72,-34,48,19
369,Burton Albion,12,11,23,55,81,-26,47,20
369,Cheltenham,11,11,24,30,61,-31,44,21
369,Cambridge Utd,12,7,27,41,73,-32,43,22
369,MK Dons,11,8,27,39,65,-26,41,23
369,FG Rovers,7,9,30,33,91,-58,30,24
370,Sheffield Weds,32,11,3,85,28,57,107,1
370,Plymouth Argyle,27,11,8,94,61,33,92,2
370,Derby County,23,15,8,78,39,39,84,3
370,Bolton,24,12,10,64,34,30,84,4
370,Barnsley,25,9,12,70,42,28,84,5
370,Ipswich Town,21,17,8,79,48,31,80,6
370,P'borough Utd,25,5,16,81,59,22,80,7
370,Portsmouth,20,14,12,67,49,18,74,8
370,Wycombe,20,11,15,60,46,14,71,9
370,Shrewsbury,20,7,19,58,53,5,67,10
370,Charlton Ath,15,15,16,60,54,6,60,11
370,Fleetwood Town,14,17,15,48,47,1,59,12
370,Exeter City,15,13,18,56,55,1,58,13
370,Lincoln City,11,23,12,45,50,-5,56,14
370,Oxford United,14,13,19,48,54,-6,55,15
370,Bristol Rovers,14,11,21,67,85,-18,53,16
370,Port Vale,13,11,22,43,68,-25,50,17
370,MK Dons,13,10,23,44,67,-23,49,18
370,Cheltenham,12,10,24,31,56,-25,46,19
370,Burton Albion,12,10,24,52,87,-35,46,20
370,Acc'ton Stanley,10,14,22,35,66,-31,44,21
370,Morecambe,9,13,24,47,78,-31,40,22
370,Cambridge Utd,10,8,28,36,75,-39,38,23
370,FG Rovers,7,12,27,36,83,-47,33,24
371,Sheffield Weds,30,10,6,90,36,54,100,1
371,Plymouth Argyle,27,12,7,81,48,33,93,2
371,Ipswich Town,26,13,7,88,42,46,91,3
371,Barnsley,25,10,11,75,42,33,85,4
371,Derby County,23,11,12,67,40,27,80,5
371,Wycombe,21,10,15,56,42,14,73,6
371,P'borough Utd,22,6,18,78,61,17,72,7
371,Bolton,21,9,16,61,45,16,72,8
371,Portsmouth,19,14,13,64,51,13,71,9
371,Shrewsbury,19,10,17,55,47,8,67,10
371,Charlton Ath,17,15,14,65,55,10,66,11
371,Lincoln City,15,21,10,48,48,0,66,12
371,Fleetwood Town,16,16,14,53,47,6,64,13
371,Exeter City,16,12,18,62,61,1,60,14
371,Port Vale,16,11,19,48,58,-10,59,15
371,Burton Albion,14,12,20,59,82,-23,54,16
371,Oxford United,14,11,21,47,61,-14,53,17
371,Bristol Rovers,13,10,23,58,77,-19,49,18
371,Cheltenham,11,11,24,31,61,-30,44,19
371,Acc'ton Stanley,11,11,24,39,80,-41,44,20
371,Morecambe,10,12,24,42,70,-28,42,21
371,MK Dons,11,8,27,48,73,-25,41,22
371,Cambridge Utd,8,13,25,34,74,-40,37,23
371,FG Rovers,7,12,27,36,84,-48,33,24
372,Sheffield Weds,29,11,6,82,35,47,98,1
372,Plymouth Argyle,27,12,7,86,50,36,93,2
372,Barnsley,29,5,12,81,36,45,92,3
372,Ipswich Town,25,15,6,83,44,39,90,4
372,Derby County,24,12,10,73,45,28,84,5
372,Bolton,24,9,13,72,39,33,81,6
372,Wycombe,23,11,12,64,40,24,80,7
372,P'borough Utd,21,8,17,71,59,12,71,8
372,Portsmouth,18,16,12,62,50,12,70,9
372,Lincoln City,15,22,9,46,36,10,67,10
372,Shrewsbury,19,8,19,55,57,-2,65,11
372,Charlton Ath,15,15,16,59,60,-1,60,12
372,Fleetwood Town,14,17,15,55,52,3,59,13
372,Bristol Rovers,15,12,19,63,71,-8,57,14
372,Exeter City,14,12,20,53,60,-7,54,15
372,Port Vale,14,11,21,47,68,-21,53,16
372,Oxford United,13,13,20,49,59,-10,52,17
372,Burton Albion,12,11,23,56,89,-33,47,18
372,Morecambe,11,12,23,41,71,-30,45,19
372,Cheltenham,10,12,24,30,60,-30,42,20
372,MK Dons,10,10,26,44,71,-27,40,21
372,Cambridge Utd,11,7,28,38,77,-39,40,22
372,Acc'ton Stanley,8,15,23,32,68,-36,39,23
372,FG Rovers,7,12,27,34,79,-45,33,24
373,Sheffield Weds,31,9,6,84,33,51,102,1
373,Plymouth Argyle,28,12,6,82,45,37,96,2
373,Barnsley,27,9,10,72,37,35,90,3
373,Ipswich Town,23,16,7,88,47,41,85,4
373,Derby County,24,11,11,75,42,33,83,5
373,Bolton,24,9,13,73,39,34,81,6
373,Wycombe,22,10,14,62,43,19,76,7
373,Portsmouth,20,15,11,72,52,20,75,8
373,Shrewsbury,21,7,18,59,55,4,70,9
373,P'borough Utd,20,7,19,75,65,10,67,10
373,Charlton Ath,17,14,15,57,54,3,65,11
373,Fleetwood Town,14,17,15,52,46,6,59,12
373,Lincoln City,11,23,12,42,48,-6,56,13
373,Exeter City,14,13,19,53,56,-3,55,14
373,Oxford United,13,13,20,46,54,-8,52,15
373,Burton Albion,13,13,20,56,80,-24,52,16
373,Bristol Rovers,13,12,21,57,75,-18,51,17
373,Port Vale,12,13,21,42,64,-22,49,18
373,MK Dons,13,9,24,41,64,-23,48,19
373,Morecambe,10,15,21,44,70,-26,45,20
373,Cambridge Utd,12,8,26,44,69,-25,44,21
373,Cheltenham,10,13,23,34,62,-28,43,22
373,Acc'ton Stanley,8,13,25,32,88,-56,37,23
373,FG Rovers,5,13,28,29,83,-54,28,24
374,Sheffield Weds,31,10,5,85,31,54,103,1
374,Plymouth Argyle,27,11,8,87,52,35,92,2
374,Barnsley,27,10,9,73,39,34,91,3
374,Derby County,26,12,8,79,42,37,90,4
374,Ipswich Town,24,16,6,84,40,44,88,5
374,Bolton,23,10,13,61,37,24,79,6
374,Wycombe,23,9,14,66,42,24,78,7
374,Portsmouth,20,15,11,70,51,19,75,8
374,P'borough Utd,22,7,17,74,57,17,73,9
374,Charlton Ath,18,15,13,68,57,11,69,10
374,Fleetwood Town,17,15,14,57,43,14,66,11
374,Shrewsbury,16,10,20,53,60,-7,58,12
374,Exeter City,15,11,20,58,59,-1,56,13
374,Lincoln City,11,22,13,43,51,-8,55,14
374,Bristol Rovers,14,10,22,60,80,-20,52,15
374,Oxford United,12,14,20,45,55,-10,50,16
374,Morecambe,12,13,21,51,75,-24,49,17
374,Port Vale,13,10,23,39,66,-27,49,18
374,Burton Albion,12,11,23,57,82,-25,47,19
374,Cambridge Utd,12,9,25,40,75,-35,45,20
374,Cheltenham,12,8,26,35,70,-35,44,21
374,Acc'ton Stanley,8,14,24,38,76,-38,38,22
374,MK Dons,8,13,25,42,72,-30,37,23
374,FG Rovers,6,11,29,38,91,-53,29,24
375,Sheffield Weds,30,9,7,82,35,47,99,1
375,Plymouth Argyle,27,10,9,86,52,34,91,2
375,Ipswich Town,24,17,5,86,44,42,89,3
375,Derby County,25,13,8,81,40,41,88,4
375,Wycombe,24,9,13,69,42,27,81,5
375,Bolton,22,12,12,71,34,37,78,6
375,Barnsley,22,11,13,68,45,23,77,7
375,P'borough Utd,21,6,19,76,62,14,69,8
375,Portsmouth,18,15,13,66,52,14,69,9
375,Shrewsbury,20,8,18,57,49,8,68,10
375,Charlton Ath,16,15,15,63,59,4,63,11
375,Lincoln City,13,24,9,51,50,1,63,12
375,Exeter City,17,12,17,59,59,0,63,13
375,Fleetwood Town,12,18,16,47,47,0,54,14
375,Cheltenham,13,11,22,41,59,-18,50,15
375,Burton Albion,12,14,20,60,88,-28,50,16
375,Port Vale,13,10,23,40,62,-22,49,17
375,Bristol Rovers,13,10,23,60,90,-30,49,18
375,Oxford United,11,14,21,43,60,-17,47,19
375,MK Dons,12,10,24,45,71,-26,46,20
375,Cambridge Utd,12,9,25,39,73,-34,45,21
375,Acc'ton Stanley,9,15,22,35,70,-35,42,22
375,Morecambe,9,14,23,44,76,-32,41,23
375,FG Rovers,10,8,28,41,91,-50,38,24
376,Sheffield Weds,32,10,4,80,28,52,106,1
376,Plymouth Argyle,27,10,9,91,51,40,91,2
376,Ipswich Town,24,15,7,79,42,37,87,3
376,Derby County,25,9,12,69,39,30,84,4
376,Bolton,23,12,11,68,34,34,81,5
376,Barnsley,22,12,12,70,46,24,78,6
376,Wycombe,22,11,13,61,44,17,77,7
376,P'borough Utd,23,5,18,78,63,15,74,8
376,Portsmouth,19,15,12,63,48,15,72,9
376,Shrewsbury,20,9,17,59,50,9,69,10
376,Charlton Ath,15,18,13,58,51,7,63,11
376,Lincoln City,12,22,12,44,45,-1,58,12
376,Fleetwood Town,14,15,17,47,48,-1,57,13
376,Exeter City,14,14,18,62,64,-2,56,14
376,Bristol Rovers,15,10,21,65,79,-14,55,15
376,Acc'ton Stanley,14,12,20,41,64,-23,54,16
376,Port Vale,14,9,23,44,72,-28,51,17
376,Morecambe,11,15,20,50,72,-22,48,18
376,Oxford United,12,10,24,48,66,-18,46,19
376,Cheltenham,11,12,23,34,60,-26,45,20
376,MK Dons,11,10,25,42,71,-29,43,21
376,Cambridge Utd,11,10,25,37,68,-31,43,22
376,Burton Albion,11,10,25,54,86,-32,43,23
376,FG Rovers,7,11,28,33,86,-53,32,24
377,Sheffield Weds,29,12,5,84,30,54,99,1
377,Plymouth Argyle,28,11,7,87,45,42,95,2
377,Ipswich Town,27,12,7,96,46,50,93,3
377,Derby County,25,11,10,75,41,34,86,4
377,Barnsley,24,12,10,80,45,35,84,5
377,Wycombe,24,10,12,65,37,28,82,6
377,Bolton,22,13,11,66,40,26,79,7
377,P'borough Utd,24,3,19,80,65,15,75,8
377,Portsmouth,16,19,11,59,51,8,67,9
377,Shrewsbury,19,10,17,56,52,4,67,10
377,Lincoln City,16,18,12,43,45,-2,66,11
377,Charlton Ath,15,17,14,66,57,9,62,12
377,Fleetwood Town,15,16,15,49,49,0,61,13
377,Bristol Rovers,14,12,20,63,82,-19,54,14
377,Exeter City,14,10,22,58,69,-11,52,15
377,Cheltenham,14,9,23,39,62,-23,51,16
377,Port Vale,13,11,22,48,67,-19,50,17
377,Burton Albion,13,11,22,55,85,-30,50,18
377,MK Dons,13,8,25,46,70,-24,47,19
377,Acc'ton Stanley,10,14,22,39,72,-33,44,20
377,Morecambe,10,13,23,43,71,-28,43,21
377,Oxford United,9,14,23,39,61,-22,41,22
377,Cambridge Utd,9,8,29,38,79,-41,35,23
377,FG Rovers,6,12,28,33,86,-53,30,24
378,Sheffield Weds,33,9,4,91,26,65,108,1
378,Plymouth Argyle,28,10,8,79,52,27,94,2
378,Ipswich Town,25,15,6,87,43,44,90,3
378,Derby County,26,11,9,81,43,38,89,4
378,Barnsley,25,10,11,67,36,31,85,5
378,Wycombe,24,8,14,62,41,21,80,6
378,Bolton,21,11,14,66,44,22,74,7
378,Shrewsbury,21,6,19,58,50,8,69,8
378,P'borough Utd,20,7,19,70,60,10,67,9
378,Charlton Ath,17,12,17,65,56,9,63,10
378,Portsmouth,15,18,13,60,55,5,63,11
378,Exeter City,17,11,18,61,58,3,62,12
378,Bristol Rovers,17,9,20,63,70,-7,60,13
378,Fleetwood Town,14,15,17,42,45,-3,57,14
378,Port Vale,15,12,19,46,61,-15,57,15
378,Lincoln City,12,20,14,42,48,-6,56,16
378,Oxford United,13,14,19,46,55,-9,53,17
378,MK Dons,11,12,23,40,65,-25,45,18
378,Cheltenham,12,9,25,35,68,-33,45,19
378,Acc'ton Stanley,10,14,22,37,72,-35,44,20
378,Morecambe,10,12,24,43,72,-29,42,21
378,Burton Albion,11,9,26,55,88,-33,42,22
378,Cambridge Utd,11,8,27,35,72,-37,41,23
378,FG Rovers,8,10,28,31,82,-51,34,24
379,Sheffield Weds,30,12,4,83,27,56,102,1
379,Plymouth Argyle,28,10,8,91,54,37,94,2
379,Barnsley,27,11,8,76,39,37,92,3
379,Ipswich Town,23,16,7,84,46,38,85,4
379,Wycombe,25,10,11,70,42,28,85,5
379,Bolton,23,11,12,72,40,32,80,6
379,Derby County,22,13,11,74,47,27,79,7
379,P'borough Utd,23,7,16,83,61,22,76,8
379,Portsmouth,18,15,13,62,50,12,69,9
379,Fleetwood Town,15,19,12,56,46,10,64,10
379,Exeter City,16,14,16,68,63,5,62,11
379,Shrewsbury,17,11,18,53,53,0,62,12
379,Charlton Ath,15,15,16,66,57,9,60,13
379,Oxford United,14,12,20,53,59,-6,54,14
379,Port Vale,14,10,22,50,69,-19,52,15
379,Lincoln City,9,24,13,36,48,-12,51,16
379,Bristol Rovers,13,11,22,59,77,-18,50,17
379,Acc'ton Stanley,11,14,21,41,75,-34,47,18
379,Cheltenham,13,7,26,36,65,-29,46,19
379,Morecambe,11,12,23,41,71,-30,45,20
379,Burton Albion,11,12,23,55,87,-32,45,21
379,MK Dons,10,8,28,38,77,-39,38,22
379,Cambridge Utd,10,7,29,35,81,-46,37,23
379,FG Rovers,8,11,27,39,87,-48,35,24
380,Plymouth Argyle,27,11,8,90,50,40,92,1
380,Bolton,27,10,9,75,35,40,91,2
380,Sheffield Weds,26,12,8,80,34,46,90,3
380,Derby County,24,13,9,78,37,41,85,4
380,Wycombe,26,6,14,69,40,29,84,5
380,Barnsley,24,10,12,68,40,28,82,6
380,Ipswich Town,22,15,9,79,46,33,81,7
380,Portsmouth,21,15,10,66,49,17,78,8
380,P'borough Utd,22,7,17,72,55,17,73,9
380,Shrewsbury,20,9,17,57,53,4,69,10
380,Fleetwood Town,17,14,15,49,51,-2,65,11
380,Lincoln City,13,20,13,44,48,-4,59,12
380,Charlton Ath,14,16,16,69,75,-6,58,13
380,Port Vale,15,11,20,42,61,-19,56,14
380,Exeter City,14,12,20,59,70,-11,54,15
380,Bristol Rovers,14,12,20,60,72,-12,54,16
380,Burton Albion,14,10,22,58,81,-23,52,17
380,Oxford United,13,12,21,50,63,-13,51,18
380,Cheltenham,11,11,24,34,62,-28,44,19
380,Acc'ton Stanley,10,13,23,39,70,-31,43,20
380,Cambridge Utd,11,8,27,39,77,-38,41,21
380,Morecambe,8,16,22,44,73,-29,40,22
380,MK Dons,9,10,27,40,71,-31,37,23
380,FG Rovers,7,13,26,38,86,-48,34,24
381,Sheffield Weds,33,8,5,83,28,55,107,1
381,Barnsley,28,7,11,74,40,34,91,2
381,Plymouth Argyle,27,9,10,84,56,28,90,3
381,Ipswich Town,24,15,7,86,42,44,87,4
381,Derby County,25,12,9,73,38,35,87,5
381,P'borough Utd,26,6,14,79,47,32,84,6
381,Bolton,23,12,11,64,36,28,81,7
381,Portsmouth,20,15,11,67,48,19,75,8
381,Wycombe,22,8,16,66,46,20,74,9
381,Shrewsbury,21,8,17,59,50,9,71,10
381,Charlton Ath,17,14,15,69,62,7,65,11
381,Lincoln City,13,20,13,42,47,-5,59,12
381,Fleetwood Town,14,15,17,51,51,0,57,13
381,Cheltenham,15,10,21,35,53,-18,55,14
381,Port Vale,15,9,22,45,68,-23,54,15
381,Exeter City,12,12,22,56,68,-12,48,16
381,Bristol Rovers,12,11,23,57,78,-21,47,17
381,MK Dons,11,12,23,40,64,-24,45,18
381,Acc'ton Stanley,11,12,23,37,74,-37,45,19
381,Oxford United,10,14,22,41,58,-17,44,20
381,Morecambe,9,14,23,42,76,-34,41,21
381,Burton Albion,10,11,25,51,89,-38,41,22
381,Cambridge Utd,10,9,27,38,75,-37,39,23
381,FG Rovers,8,9,29,32,77,-45,33,24
382,Sheffield Weds,28,13,5,82,35,47,97,1
382,Ipswich Town,26,14,6,89,41,48,92,2
382,Plymouth Argyle,27,10,9,86,56,30,91,3
382,Derby County,25,11,10,76,41,35,86,4
382,Bolton,24,10,12,64,36,28,82,5
382,P'borough Utd,24,7,15,74,50,24,79,6
382,Barnsley,23,8,15,68,48,20,77,7
382,Wycombe,23,7,16,64,44,20,76,8
382,Portsmouth,19,15,12,68,54,14,72,9
382,Shrewsbury,20,9,17,62,55,7,69,10
382,Fleetwood Town,16,15,15,59,47,12,63,11
382,Lincoln City,14,19,13,47,52,-5,61,12
382,Charlton Ath,15,13,18,72,73,-1,58,13
382,Exeter City,14,14,18,55,56,-1,56,14
382,Bristol Rovers,15,11,20,63,78,-15,56,15
382,Oxford United,14,11,21,49,55,-6,53,16
382,Port Vale,14,11,21,47,64,-17,53,17
382,Morecambe,11,14,21,52,75,-23,47,18
382,Burton Albion,12,11,23,61,88,-27,47,19
382,Cheltenham,12,10,24,34,60,-26,46,20
382,Cambridge Utd,11,10,25,37,71,-34,43,21
382,Acc'ton Stanley,9,15,22,33,72,-39,42,22
382,MK Dons,9,9,28,39,81,-42,36,23
382,FG Rovers,7,13,26,35,84,-49,34,24
383,Sheffield Weds,28,14,4,85,30,55,98,1
383,Ipswich Town,25,16,5,81,40,41,91,2
383,Derby County,26,11,9,82,38,44,89,3
383,Plymouth Argyle,26,10,10,83,58,25,88,4
383,Barnsley,25,10,11,70,39,31,85,5
383,P'borough Utd,25,4,17,77,59,18,79,6
383,Bolton,22,12,12,63,36,27,78,7
383,Portsmouth,21,15,10,75,51,24,78,8
383,Wycombe,24,6,16,70,46,24,78,9
383,Charlton Ath,17,15,14,72,58,14,66,10
383,Shrewsbury,19,9,18,53,53,0,66,11
383,Lincoln City,13,22,11,42,46,-4,61,12
383,Fleetwood Town,14,16,16,49,46,3,58,13
383,Exeter City,14,14,18,55,58,-3,56,14
383,Oxford United,14,12,20,51,58,-7,54,15
383,Port Vale,14,10,22,46,63,-17,52,16
383,Bristol Rovers,13,12,21,60,78,-18,51,17
383,Morecambe,11,14,21,45,71,-26,47,18
383,Burton Albion,11,11,24,56,91,-35,44,19
383,Cheltenham,11,10,25,35,65,-30,43,20
383,Acc'ton Stanley,9,13,24,36,71,-35,40,21
383,Cambridge Utd,11,7,28,39,78,-39,40,22
383,MK Dons,10,9,27,38,77,-39,39,23
383,FG Rovers,8,10,28,35,88,-53,34,24
384,Sheffield Weds,29,12,5,89,33,56,99,1
384,Plymouth Argyle,29,10,7,88,49,39,97,2
384,Barnsley,26,10,10,73,37,36,88,3
384,Ipswich Town,23,16,7,84,42,42,85,4
384,Bolton,24,12,10,71,36,35,84,5
384,Derby County,23,13,10,78,50,28,82,6
384,Wycombe,24,10,12,69,41,28,82,7
384,P'borough Utd,21,6,19,75,61,14,69,8
384,Portsmouth,18,15,13,69,59,10,69,9
384,Shrewsbury,20,8,18,58,49,9,68,10
384,Port Vale,18,9,19,51,65,-14,63,11
384,Fleetwood Town,14,19,13,52,45,7,61,12
384,Charlton Ath,14,14,18,60,64,-4,56,13
384,Lincoln City,10,25,11,38,43,-5,55,14
384,Bristol Rovers,14,10,22,59,80,-21,52,15
384,Oxford United,12,15,19,52,56,-4,51,16
384,Burton Albion,13,12,21,59,83,-24,51,17
384,Exeter City,13,11,22,52,68,-16,50,18
384,Acc'ton Stanley,12,14,20,34,69,-35,50,19
384,Morecambe,11,15,20,46,68,-22,48,20
384,MK Dons,11,10,25,46,75,-29,43,21
384,Cheltenham,10,13,23,31,60,-29,43,22
384,Cambridge Utd,9,6,31,35,83,-48,33,23
384,FG Rovers,6,11,29,34,87,-53,29,24
385,Sheffield Weds,32,10,4,89,31,58,106,1
385,Ipswich Town,27,15,4,88,40,48,96,2
385,Barnsley,28,9,9,70,37,33,93,3
385,Plymouth Argyle,26,12,8,86,55,31,90,4
385,Bolton,24,8,14,65,39,26,80,5
385,Derby County,22,13,11,77,49,28,79,6
385,Wycombe,23,8,15,61,42,19,77,7
385,Portsmouth,19,17,10,66,51,15,74,8
385,P'borough Utd,21,7,18,70,63,7,70,9
385,Shrewsbury,19,9,18,54,51,3,66,10
385,Charlton Ath,17,13,16,68,60,8,64,11
385,Fleetwood Town,15,15,16,49,45,4,60,12
385,Lincoln City,13,19,14,49,51,-2,58,13
385,Exeter City,15,11,20,64,65,-1,56,14
385,Port Vale,16,8,22,54,71,-17,56,15
385,Bristol Rovers,14,12,20,62,75,-13,54,16
385,Oxford United,13,12,21,49,56,-7,51,17
385,Morecambe,11,15,20,49,72,-23,48,18
385,Burton Albion,12,11,23,56,96,-40,47,19
385,MK Dons,11,9,26,43,69,-26,42,20
385,Cheltenham,10,11,25,31,62,-31,41,21
385,Acc'ton Stanley,9,13,24,38,71,-33,40,22
385,Cambridge Utd,10,10,26,37,71,-34,40,23
385,FG Rovers,5,13,28,34,87,-53,28,24
386,Sheffield Weds,34,9,3,100,27,73,111,1
386,Plymouth Argyle,29,8,9,88,52,36,95,2
386,Ipswich Town,24,14,8,83,48,35,86,3
386,Bolton,25,9,12,70,35,35,84,4
386,Derby County,22,13,11,73,47,26,79,5
386,Wycombe,21,14,11,58,37,21,77,6
386,Barnsley,22,9,15,61,43,18,75,7
386,Fleetwood Town,21,12,13,56,40,16,75,8
386,P'borough Utd,20,10,16,71,63,8,70,9
386,Charlton Ath,18,15,13,69,54,15,69,10
386,Portsmouth,17,17,12,67,57,10,68,11
386,Shrewsbury,18,8,20,50,49,1,62,12
386,Lincoln City,13,21,12,41,47,-6,60,13
386,Exeter City,15,12,19,59,65,-6,57,14
386,Oxford United,14,13,19,47,51,-4,55,15
386,Bristol Rovers,15,10,21,61,80,-19,55,16
386,MK Dons,14,9,23,45,65,-20,51,17
386,Cambridge Utd,13,9,24,40,68,-28,48,18
386,Port Vale,13,8,25,44,73,-29,47,19
386,Burton Albion,11,12,23,51,85,-34,45,20
386,Cheltenham,11,9,26,33,64,-31,42,21
386,Morecambe,8,14,24,40,69,-29,38,22
386,Acc'ton Stanley,9,11,26,36,73,-37,38,23
386,FG Rovers,7,10,29,36,87,-51,31,24
387,Sheffield Weds,32,10,4,93,35,58,106,1
387,Plymouth Argyle,28,11,7,98,53,45,95,2
387,Ipswich Town,26,16,4,89,41,48,94,3
387,Barnsley,24,11,11,80,42,38,83,4
387,Derby County,23,12,11,74,44,30,81,5
387,Wycombe,24,9,13,66,42,24,81,6
387,Bolton,22,12,12,61,37,24,78,7
387,P'borough Utd,22,8,16,73,60,13,74,8
387,Portsmouth,18,13,15,62,52,10,67,9
387,Charlton Ath,17,14,15,67,61,6,65,10
387,Fleetwood Town,16,16,14,49,44,5,64,11
387,Shrewsbury,17,11,18,52,51,1,62,12
387,Exeter City,15,13,18,61,63,-2,58,13
387,Lincoln City,12,21,13,43,50,-7,57,14
387,Port Vale,15,10,21,48,69,-21,55,15
387,Bristol Rovers,13,13,20,59,77,-18,52,16
387,Burton Albion,13,11,22,58,88,-30,50,17
387,Oxford United,10,14,22,44,61,-17,44,18
387,Morecambe,10,13,23,50,76,-26,43,19
387,MK Dons,12,7,27,45,71,-26,43,20
387,Cheltenham,10,13,23,31,60,-29,43,21
387,Acc'ton Stanley,8,17,21,38,68,-30,41,22
387,Cambridge Utd,10,7,29,33,77,-44,37,23
387,FG Rovers,8,12,26,37,89,-52,36,24
388,Sheffield Weds,32,9,5,87,29,58,105,1
388,Plymouth Argyle,30,9,7,100,45,55,99,2
388,Ipswich Town,26,15,5,93,40,53,93,3
388,Barnsley,25,11,10,67,40,27,86,4
388,Bolton,24,11,11,68,40,28,83,5
388,Derby County,22,12,12,79,49,30,78,6
388,P'borough Utd,23,9,14,81,56,25,78,7
388,Wycombe,24,6,16,65,43,22,78,8
388,Charlton Ath,19,12,15,66,54,12,69,9
388,Portsmouth,17,16,13,64,58,6,67,10
388,Fleetwood Town,16,16,14,55,48,7,64,11
388,Shrewsbury,19,7,20,53,53,0,64,12
388,Exeter City,14,15,17,58,63,-5,57,13
388,Bristol Rovers,15,12,19,64,71,-7,57,14
388,Lincoln City,11,22,13,42,55,-13,55,15
388,Oxford United,14,9,23,48,62,-14,51,16
388,Cheltenham,14,8,24,42,69,-27,50,17
388,Port Vale,13,8,25,42,71,-29,47,18
388,Cambridge Utd,12,11,23,37,67,-30,47,19
388,MK Dons,11,10,25,44,70,-26,43,20
388,Burton Albion,10,9,27,58,96,-38,39,21
388,Acc'ton Stanley,9,12,25,38,80,-42,39,22
388,Morecambe,7,15,24,47,83,-36,36,23
388,FG Rovers,7,12,27,36,92,-56,33,24
389,Sheffield Weds,31,11,4,91,34,57,104,1
389,Ipswich Town,25,15,6,82,40,42,90,2
389,Bolton,26,10,10,68,31,37,88,3
389,Plymouth Argyle,26,9,11,88,52,36,87,4
389,Derby County,25,12,9,72,39,33,87,5
389,Barnsley,25,9,12,73,43,30,84,6
389,Wycombe,22,10,14,61,44,17,76,7
389,Charlton Ath,19,11,16,67,61,6,68,8
389,Portsmouth,17,16,13,62,52,10,67,9
389,P'borough Utd,20,5,21,73,64,9,65,10
389,Lincoln City,14,23,9,43,39,4,65,11
389,Shrewsbury,18,10,18,57,58,-1,64,12
389,Bristol Rovers,16,12,18,68,73,-5,60,13
389,Port Vale,15,10,21,49,67,-18,55,14
389,Fleetwood Town,12,18,16,45,46,-1,54,15
389,Exeter City,14,12,20,55,64,-9,54,16
389,Oxford United,13,13,20,52,59,-7,52,17
389,Acc'ton Stanley,13,12,21,44,65,-21,51,18
389,MK Dons,12,9,25,49,72,-23,45,19
389,Burton Albion,10,12,24,53,89,-36,42,20
389,Cambridge Utd,11,9,26,39,75,-36,42,21
389,Morecambe,9,14,23,38,73,-35,41,22
389,Cheltenham,11,8,27,28,65,-37,41,23
389,FG Rovers,8,10,28,37,89,-52,34,24
390,Sheffield Weds,31,11,4,88,25,63,104,1
390,Plymouth Argyle,29,11,6,89,47,42,98,2
390,Ipswich Town,24,15,7,93,44,49,87,3
390,Derby County,25,12,9,76,39,37,87,4
390,Barnsley,25,11,10,69,40,29,86,5
390,Bolton,23,12,11,66,37,29,81,6
390,Wycombe,24,7,15,76,54,22,79,7
390,Portsmouth,22,12,12,68,49,19,78,8
390,P'borough Utd,21,7,18,77,64,13,70,9
390,Shrewsbury,18,10,18,55,53,2,64,10
390,Exeter City,17,10,19,62,64,-2,61,11
390,Fleetwood Town,15,15,16,48,51,-3,60,12
390,Port Vale,16,10,20,49,67,-18,58,13
390,Charlton Ath,13,15,18,64,63,1,54,14
390,Lincoln City,11,20,15,41,52,-11,53,15
390,Burton Albion,13,11,22,62,92,-30,50,16
390,Oxford United,13,10,23,44,59,-15,49,17
390,Cheltenham,13,10,23,37,62,-25,49,18
390,Morecambe,10,16,20,44,68,-24,46,19
390,Bristol Rovers,12,10,24,59,89,-30,46,20
390,Cambridge Utd,11,10,25,36,68,-32,43,21
390,Acc'ton Stanley,10,13,23,39,73,-34,43,22
390,MK Dons,11,7,28,40,74,-34,40,23
390,FG Rovers,7,11,28,36,84,-48,32,24
391,Sheffield Weds,30,12,4,82,28,54,102,1
391,Plymouth Argyle,29,10,7,95,47,48,97,2
391,Derby County,24,12,10,76,44,32,84,3
391,Wycombe,25,8,13,76,41,35,83,4
391,Ipswich Town,21,18,7,82,49,33,81,5
391,Barnsley,25,6,15,66,46,20,81,6
391,Bolton,22,14,10,69,41,28,80,7
391,P'borough Utd,22,8,16,80,57,23,74,8
391,Portsmouth,19,16,11,65,50,15,73,9
391,Shrewsbury,19,11,16,56,47,9,68,10
391,Charlton Ath,17,15,14,65,55,10,66,11
391,Exeter City,16,13,17,64,62,2,61,12
391,Bristol Rovers,15,14,17,66,77,-11,59,13
391,Fleetwood Town,13,18,15,45,42,3,57,14
391,Burton Albion,15,11,20,63,80,-17,56,15
391,Lincoln City,10,24,12,41,47,-6,54,16
391,Port Vale,13,10,23,46,72,-26,49,17
391,Oxford United,11,15,20,48,59,-11,48,18
391,Acc'ton Stanley,10,16,20,40,67,-27,46,19
391,Cheltenham,10,13,23,39,67,-28,43,20
391,MK Dons,10,8,28,37,79,-42,38,21
391,Cambridge Utd,9,10,27,34,81,-47,37,22
391,Morecambe,7,14,25,38,74,-36,35,23
391,FG Rovers,6,12,28,34,95,-61,30,24
392,Sheffield Weds,30,10,6,79,33,46,100,1
392,Plymouth Argyle,30,10,6,88,47,41,100,2
392,Ipswich Town,28,13,5,92,41,51,97,3
392,Derby County,26,11,9,77,38,39,89,4
392,Bolton,23,11,12,69,40,29,80,5
392,Barnsley,23,8,15,71,52,19,77,6
392,Portsmouth,21,13,12,69,50,19,76,7
392,Wycombe,20,9,17,62,47,15,69,8
392,Shrewsbury,20,9,17,61,54,7,69,9
392,P'borough Utd,20,6,20,72,62,10,66,10
392,Charlton Ath,17,13,16,69,60,9,64,11
392,Lincoln City,14,21,11,47,44,3,63,12
392,Fleetwood Town,15,16,15,51,50,1,61,13
392,Oxford United,15,13,18,52,54,-2,58,14
392,Bristol Rovers,15,9,22,57,82,-25,54,15
392,Burton Albion,14,10,22,62,88,-26,52,16
392,Exeter City,13,12,21,54,64,-10,51,17
392,Cheltenham,14,8,24,41,62,-21,50,18
392,Port Vale,13,9,24,47,73,-26,48,19
392,Morecambe,11,12,23,45,68,-23,45,20
392,MK Dons,12,9,25,43,70,-27,45,21
392,Acc'ton Stanley,11,11,24,43,72,-29,44,22
392,Cambridge Utd,12,7,27,39,83,-44,43,23
392,FG Rovers,5,10,31,34,90,-56,25,24
393,Sheffield Weds,31,11,4,80,29,51,104,1
393,Plymouth Argyle,27,11,8,81,51,30,92,2
393,Ipswich Town,25,15,6,93,43,50,90,3
393,Barnsley,26,6,14,73,46,27,84,4
393,Derby County,23,12,11,78,44,34,81,5
393,Bolton,21,14,11,65,38,27,77,6
393,Wycombe,22,10,14,58,37,21,76,7
393,P'borough Utd,22,7,17,76,62,14,73,8
393,Portsmouth,17,16,13,65,55,10,67,9
393,Shrewsbury,18,9,19,55,54,1,63,10
393,Charlton Ath,15,17,14,65,58,7,62,11
393,Fleetwood Town,15,15,16,50,50,0,60,12
393,Lincoln City,13,21,12,41,45,-4,60,13
393,Port Vale,17,9,20,51,66,-15,60,14
393,Burton Albion,15,11,20,58,79,-21,56,15
393,Exeter City,14,13,19,57,58,-1,55,16
393,Oxford United,14,12,20,46,56,-10,54,17
393,Bristol Rovers,13,14,19,64,79,-15,53,18
393,Acc'ton Stanley,12,11,23,37,67,-30,47,19
393,Cheltenham,11,11,24,35,63,-28,44,20
393,Morecambe,9,15,22,48,75,-27,42,21
393,MK Dons,10,11,25,44,73,-29,41,22
393,Cambridge Utd,9,10,27,36,78,-42,37,23
393,FG Rovers,8,9,29,37,87,-50,33,24
394,Plymouth Argyle,30,10,6,88,52,36,100,1
394,Sheffield Weds,29,12,5,79,30,49,99,2
394,Ipswich Town,26,15,5,93,45,48,93,3
394,Derby County,25,13,8,83,43,40,88,4
394,Wycombe,26,5,15,73,46,27,83,5
394,Barnsley,25,7,14,74,48,26,82,6
394,Bolton,23,10,13,66,40,26,79,7
394,Portsmouth,21,13,12,72,57,15,76,8
394,P'borough Utd,22,6,18,83,62,21,72,9
394,Shrewsbury,20,9,17,56,49,7,69,10
394,Fleetwood Town,15,16,15,52,45,7,61,11
394,Bristol Rovers,16,9,21,68,85,-17,57,12
394,Lincoln City,12,20,14,42,49,-7,56,13
394,Exeter City,15,10,21,57,67,-10,55,14
394,Cheltenham,15,9,22,45,64,-19,54,15
394,Charlton Ath,13,13,20,65,66,-1,52,16
394,Burton Albion,14,10,22,59,79,-20,52,17
394,Port Vale,13,12,21,45,67,-22,51,18
394,Oxford United,11,13,22,47,66,-19,46,19
394,Cambridge Utd,13,7,26,39,73,-34,46,20
394,Acc'ton Stanley,10,15,21,41,75,-34,45,21
394,MK Dons,10,9,27,39,75,-36,39,22
394,Morecambe,8,12,26,42,76,-34,36,23
394,FG Rovers,7,11,28,38,87,-49,32,24
395,Sheffield Weds,29,12,5,78,28,50,99,1
395,Plymouth Argyle,29,11,6,89,50,39,98,2
395,Barnsley,29,7,10,84,40,44,94,3
395,Ipswich Town,23,14,9,81,46,35,83,4
395,Derby County,24,10,12,76,44,32,82,5
395,Bolton,23,12,11,64,36,28,81,6
395,P'borough Utd,24,5,17,77,56,21,77,7
395,Wycombe,23,8,15,67,47,20,77,8
395,Portsmouth,20,16,10,67,50,17,76,9
395,Shrewsbury,19,7,20,55,58,-3,64,10
395,Charlton Ath,14,14,18,62,66,-4,56,11
395,Oxford United,15,11,20,46,54,-8,56,12
395,Exeter City,13,14,19,58,60,-2,53,13
395,Fleetwood Town,13,14,19,43,50,-7,53,14
395,Lincoln City,10,23,13,39,48,-9,53,15
395,Port Vale,14,10,22,46,68,-22,52,16
395,Burton Albion,14,10,22,58,85,-27,52,17
395,Acc'ton Stanley,11,18,17,46,63,-17,51,18
395,Bristol Rovers,13,11,22,63,83,-20,50,19
395,Cambridge Utd,13,8,25,40,69,-29,47,20
395,Morecambe,10,15,21,43,68,-25,45,21
395,Cheltenham,11,11,24,34,66,-32,44,22
395,MK Dons,10,9,27,40,69,-29,39,23
395,FG Rovers,8,10,28,32,84,-52,34,24
396,Sheffield Weds,32,10,4,82,28,54,106,1
396,Plymouth Argyle,28,8,10,82,57,25,92,2
396,Ipswich Town,23,15,8,82,43,39,84,3
396,Barnsley,25,9,12,64,39,25,84,4
396,Bolton,24,11,11,68,36,32,83,5
396,Wycombe,25,7,14,69,40,29,82,6
396,Derby County,22,13,11,73,44,29,79,7
396,P'borough Utd,24,7,15,78,53,25,79,8
396,Portsmouth,20,15,11,69,49,20,75,9
396,Fleetwood Town,15,16,15,54,47,7,61,10
396,Charlton Ath,16,13,17,62,61,1,61,11
396,Exeter City,16,11,19,57,55,2,59,12
396,Shrewsbury,16,10,20,47,52,-5,58,13
396,Lincoln City,12,21,13,40,51,-11,57,14
396,Bristol Rovers,15,12,19,58,71,-13,57,15
396,Oxford United,14,12,20,45,56,-11,54,16
396,Port Vale,14,10,22,45,63,-18,52,17
396,Burton Albion,12,12,22,57,79,-22,48,18
396,Acc'ton Stanley,10,16,20,36,62,-26,46,19
396,Cheltenham,12,9,25,30,61,-31,45,20
396,Morecambe,10,13,23,43,69,-26,43,21
396,MK Dons,10,8,28,38,73,-35,38,22
396,Cambridge Utd,10,8,28,33,73,-40,38,23
396,FG Rovers,8,12,26,36,86,-50,36,24
397,Sheffield Weds,30,11,5,91,32,59,101,1
397,Plymouth Argyle,27,13,6,85,48,37,94,2
397,Ipswich Town,25,16,5,85,40,45,91,3
397,Bolton,24,13,9,66,32,34,85,4
397,Derby County,23,13,10,72,40,32,82,5
397,Barnsley,24,10,12,72,46,26,82,6
397,Wycombe,24,7,15,66,47,19,79,7
397,P'borough Utd,22,7,17,79,56,23,73,8
397,Portsmouth,17,18,11,62,50,12,69,9
397,Shrewsbury,18,14,14,56,47,9,68,10
397,Fleetwood Town,16,16,14,52,41,11,64,11
397,Port Vale,16,9,21,47,64,-17,57,12
397,Charlton Ath,13,16,17,58,62,-4,55,13
397,Exeter City,13,14,19,55,63,-8,53,14
397,Lincoln City,10,22,14,38,51,-13,52,15
397,Bristol Rovers,13,11,22,60,81,-21,50,16
397,Oxford United,12,13,21,45,58,-13,49,17
397,Burton Albion,12,13,21,55,82,-27,49,18
397,Acc'ton Stanley,12,11,23,40,73,-33,47,19
397,Morecambe,11,13,22,48,76,-28,46,20
397,Cheltenham,11,10,25,33,60,-27,43,21
397,Cambridge Utd,11,9,26,34,69,-35,42,22
397,MK Dons,11,8,27,42,74,-32,41,23
397,FG Rovers,9,9,28,34,83,-49,36,24
398,Sheffield Weds,29,12,5,83,31,52,99,1
398,Plymouth Argyle,28,10,8,90,53,37,94,2
398,Barnsley,27,9,10,78,43,35,90,3
398,Ipswich Town,24,15,7,88,48,40,87,4
398,Wycombe,26,7,13,74,41,33,85,5
398,Bolton,25,9,12,73,36,37,84,6
398,Derby County,23,13,10,75,44,31,82,7
398,P'borough Utd,24,6,16,80,56,24,78,8
398,Portsmouth,18,18,10,59,45,14,72,9
398,Shrewsbury,19,11,16,57,50,7,68,10
398,Charlton Ath,18,12,16,69,63,6,66,11
398,Fleetwood Town,15,15,16,51,48,3,60,12
398,Exeter City,15,14,17,61,66,-5,59,13
398,Port Vale,16,8,22,51,64,-13,56,14
398,Bristol Rovers,14,10,22,61,82,-21,52,15
398,Lincoln City,10,19,17,41,57,-16,49,16
398,Morecambe,12,13,21,53,78,-25,49,17
398,Oxford United,12,11,23,50,66,-16,47,18
398,Cheltenham,11,11,24,33,59,-26,44,19
398,Acc'ton Stanley,10,13,23,36,70,-34,43,20
398,Burton Albion,10,12,24,50,86,-36,42,21
398,Cambridge Utd,11,8,27,39,79,-40,41,22
398,MK Dons,9,11,26,39,72,-33,38,23
398,FG Rovers,8,9,29,36,90,-54,33,24
399,Sheffield Weds,30,13,3,82,27,55,103,1
399,Plymouth Argyle,27,10,9,86,53,33,91,2
399,Barnsley,26,11,9,75,38,37,89,3
399,Bolton,25,11,10,68,36,32,86,4
399,Derby County,24,11,11,73,40,33,83,5
399,Ipswich Town,22,15,9,79,43,36,81,6
399,Wycombe,24,9,13,63,43,20,81,7
399,P'borough Utd,24,8,14,81,54,27,80,8
399,Portsmouth,19,16,11,66,51,15,73,9
399,Shrewsbury,18,11,17,52,46,6,65,10
399,Charlton Ath,17,13,16,69,62,7,64,11
399,Exeter City,16,10,20,55,60,-5,58,12
399,Fleetwood Town,14,14,18,45,48,-3,56,13
399,Bristol Rovers,15,11,20,62,82,-20,56,14
399,Lincoln City,11,22,13,42,49,-7,55,15
399,Port Vale,14,9,23,45,65,-20,51,16
399,Oxford United,12,14,20,49,59,-10,50,17
399,Morecambe,11,12,23,46,79,-33,45,18
399,Burton Albion,11,12,23,49,84,-35,45,19
399,Cambridge Utd,12,8,26,37,68,-31,44,20
399,Cheltenham,12,8,26,31,64,-33,44,21
399,Acc'ton Stanley,11,11,24,38,72,-34,44,22
399,MK Dons,11,10,25,44,65,-21,43,23
399,FG Rovers,6,11,29,33,82,-49,29,24
400,Sheffield Weds,31,11,4,88,30,58,104,1
400,Plymouth Argyle,28,10,8,88,48,40,94,2
400,Barnsley,26,9,11,71,40,31,87,3
400,Ipswich Town,24,14,8,90,44,46,86,4
400,Bolton,25,10,11,68,36,32,85,5
400,Derby County,23,12,11,80,45,35,81,6
400,Wycombe,23,10,13,68,48,20,79,7
400,Shrewsbury,21,9,16,59,48,11,72,8
400,Portsmouth,19,14,13,69,52,17,71,9
400,P'borough Utd,21,7,18,74,61,13,70,10
400,Charlton Ath,15,15,16,65,65,0,60,11
400,Fleetwood Town,15,15,16,49,52,-3,60,12
400,Lincoln City,13,21,12,43,49,-6,60,13
400,Oxford United,14,11,21,48,64,-16,53,14
400,Burton Albion,13,14,19,58,83,-25,53,15
400,Port Vale,14,10,22,45,70,-25,52,16
400,Exeter City,12,14,20,54,64,-10,50,17
400,Bristol Rovers,13,9,24,59,84,-25,48,18
400,Acc'ton Stanley,10,15,21,36,66,-30,45,19
400,MK Dons,12,8,26,43,67,-24,44,20
400,Cheltenham,11,11,24,38,67,-29,44,21
400,Cambridge Utd,10,11,25,39,73,-34,41,22
400,Morecambe,9,13,24,43,76,-33,40,23
400,FG Rovers,7,13,26,35,78,-43,34,24
401,Sheffield Weds,32,8,6,90,33,57,104,1
401,Plymouth Argyle,27,12,7,84,45,39,93,2
401,Barnsley,26,9,11,74,40,34,87,3
401,Ipswich Town,23,15,8,77,45,32,84,4
401,Bolton,23,12,11,67,35,32,81,5
401,Wycombe,23,9,14,64,41,23,78,6
401,Derby County,20,14,12,66,47,19,74,7
401,Portsmouth,19,15,12,65,52,13,72,8
401,Shrewsbury,18,12,16,58,54,4,66,9
401,Fleetwood Town,16,17,13,54,45,9,65,10
401,Exeter City,17,14,15,62,56,6,65,11
401,P'borough Utd,20,4,22,76,77,-1,64,12
401,Charlton Ath,15,14,17,64,63,1,59,13
401,Oxford United,15,12,19,50,53,-3,57,14
401,Lincoln City,12,21,13,43,51,-8,57,15
401,Port Vale,14,13,19,45,60,-15,55,16
401,Burton Albion,14,12,20,59,75,-16,54,17
401,Bristol Rovers,14,9,23,69,88,-19,51,18
401,Cheltenham,13,11,22,37,60,-23,50,19
401,Morecambe,9,14,23,46,76,-30,41,20
401,Acc'ton Stanley,9,13,24,35,72,-37,40,21
401,MK Dons,10,9,27,42,74,-32,39,22
401,Cambridge Utd,9,12,25,42,82,-40,39,23
401,FG Rovers,9,9,28,39,84,-45,36,24
402,Sheffield Weds,27,13,6,76,28,48,94,1
402,Plymouth Argyle,27,12,7,82,52,30,93,2
402,Barnsley,25,13,8,80,38,42,88,3
402,Ipswich Town,24,15,7,80,42,38,87,4
402,Derby County,25,11,10,79,40,39,86,5
402,Bolton,23,13,10,65,33,32,82,6
402,Wycombe,23,9,14,75,48,27,78,7
402,Charlton Ath,19,14,13,76,55,21,71,8
402,P'borough Utd,22,5,19,68,60,8,71,9
402,Portsmouth,17,17,12,61,54,7,68,10
402,Fleetwood Town,17,16,13,58,43,15,67,11
402,Shrewsbury,19,10,17,56,52,4,67,12
402,Lincoln City,13,21,12,44,45,-1,60,13
402,Exeter City,14,15,17,58,59,-1,57,14
402,Bristol Rovers,14,12,20,69,84,-15,54,15
402,Port Vale,13,12,21,44,62,-18,51,16
402,Acc'ton Stanley,12,13,21,37,64,-27,49,17
402,Oxford United,12,12,22,44,56,-12,48,18
402,Burton Albion,12,10,24,53,87,-34,46,19
402,MK Dons,11,11,24,41,67,-26,44,20
402,Cheltenham,11,9,26,32,68,-36,42,21
402,Morecambe,10,10,26,42,80,-38,40,22
402,Cambridge Utd,10,6,30,36,86,-50,36,23
402,FG Rovers,6,13,27,33,86,-53,31,24
403,Sheffield Weds,30,12,4,81,30,51,102,1
403,Plymouth Argyle,29,11,6,91,50,41,98,2
403,Derby County,26,10,10,72,41,31,88,3
403,Ipswich Town,24,14,8,90,55,35,86,4
403,Barnsley,25,10,11,77,44,33,85,5
403,Bolton,24,12,10,68,37,31,84,6
403,Wycombe,24,8,14,71,46,25,80,7
403,P'borough Utd,23,8,15,78,50,28,77,8
403,Shrewsbury,20,9,17,56,48,8,69,9
403,Fleetwood Town,18,14,14,52,44,8,68,10
403,Portsmouth,16,17,13,65,56,9,65,11
403,Charlton Ath,16,14,16,62,61,1,62,12
403,Bristol Rovers,16,9,21,60,72,-12,57,13
403,Exeter City,15,11,20,67,67,0,56,14
403,Port Vale,16,7,23,48,65,-17,55,15
403,Lincoln City,11,21,14,42,54,-12,54,16
403,Oxford United,13,12,21,44,58,-14,51,17
403,Cheltenham,12,11,23,36,61,-25,47,18
403,Burton Albion,11,11,24,55,86,-31,44,19
403,Cambridge Utd,11,9,26,33,70,-37,42,20
403,MK Dons,10,10,26,43,72,-29,40,21
403,Morecambe,8,15,23,43,77,-34,39,22
403,Acc'ton Stanley,8,15,23,36,74,-38,39,23
403,FG Rovers,6,10,30,34,86,-52,28,24
404,Sheffield Weds,28,13,5,76,29,47,97,1
404,Plymouth Argyle,28,8,10,81,46,35,92,2
404,Barnsley,25,11,10,72,44,28,86,3
404,Ipswich Town,22,17,7,79,44,35,83,4
404,Derby County,23,11,12,70,42,28,80,5
404,Wycombe,23,11,12,68,40,28,80,6
404,P'borough Utd,24,7,15,82,53,29,79,7
404,Bolton,22,11,13,68,42,26,77,8
404,Portsmouth,18,17,11,61,53,8,71,9
404,Shrewsbury,19,12,15,57,49,8,69,10
404,Fleetwood Town,16,17,13,60,45,15,65,11
404,Lincoln City,13,21,12,43,46,-3,60,12
404,Bristol Rovers,16,12,18,62,79,-17,60,13
404,Port Vale,17,8,21,52,67,-15,59,14
404,Charlton Ath,14,16,16,61,62,-1,58,15
404,Exeter City,11,17,18,51,59,-8,50,16
404,Oxford United,12,14,20,46,58,-12,50,17
404,Burton Albion,12,13,21,57,85,-28,49,18
404,Morecambe,11,12,23,50,73,-23,45,19
404,MK Dons,10,12,24,44,71,-27,42,20
404,Cheltenham,9,15,22,30,60,-30,42,21
404,Cambridge Utd,11,8,27,43,77,-34,41,22
404,Acc'ton Stanley,8,14,24,34,73,-39,38,23
404,FG Rovers,6,11,29,30,80,-50,29,24
405,Sheffield Weds,30,10,6,89,35,54,100,1
405,Plymouth Argyle,28,10,8,89,52,37,94,2
405,Bolton,26,10,10,71,34,37,88,3
405,Ipswich Town,24,15,7,85,48,37,87,4
405,Barnsley,26,8,12,69,38,31,86,5
405,Derby County,24,13,9,90,44,46,85,6
405,P'borough Utd,24,7,15,82,56,26,79,7
405,Wycombe,23,10,13,61,39,22,79,8
405,Portsmouth,18,18,10,68,48,20,72,9
405,Shrewsbury,17,12,17,55,55,0,63,10
405,Charlton Ath,15,16,15,64,58,6,61,11
405,Port Vale,16,10,20,50,68,-18,58,12
405,Fleetwood Town,14,15,17,48,48,0,57,13
405,Bristol Rovers,15,11,20,67,85,-18,56,14
405,Exeter City,14,13,19,61,63,-2,55,15
405,Lincoln City,11,22,13,43,52,-9,55,16
405,Cheltenham,15,9,22,37,55,-18,54,17
405,Oxford United,10,15,21,44,61,-17,45,18
405,Cambridge Utd,12,8,26,35,68,-33,44,19
405,Acc'ton Stanley,9,16,21,35,65,-30,43,20
405,Burton Albion,11,8,27,56,94,-38,41,21
405,MK Dons,9,11,26,38,68,-30,38,22
405,Morecambe,8,14,24,39,82,-43,38,23
405,FG Rovers,6,13,27,34,94,-60,31,24
406,Sheffield Weds,34,8,4,85,29,56,110,1
406,Plymouth Argyle,28,10,8,83,47,36,94,2
406,Bolton,26,9,11,72,32,40,87,3
406,Barnsley,26,9,11,71,38,33,87,4
406,Ipswich Town,24,13,9,81,52,29,85,5
406,Derby County,23,12,11,79,43,36,81,6
406,P'borough Utd,25,4,17,73,50,23,79,7
406,Wycombe,22,11,13,58,40,18,77,8
406,Charlton Ath,18,15,13,73,53,20,69,9
406,Shrewsbury,20,9,17,58,48,10,69,10
406,Portsmouth,17,16,13,60,52,8,67,11
406,Fleetwood Town,16,16,14,53,45,8,64,12
406,Port Vale,15,10,21,49,66,-17,55,13
406,Lincoln City,11,20,15,45,53,-8,53,14
406,Bristol Rovers,14,9,23,61,81,-20,51,15
406,Exeter City,13,11,22,51,66,-15,50,16
406,Oxford United,12,12,22,46,60,-14,48,17
406,Burton Albion,13,9,24,56,80,-24,48,18
406,Cheltenham,11,14,21,36,61,-25,47,19
406,Morecambe,11,11,24,45,76,-31,44,20
406,MK Dons,11,10,25,46,71,-25,43,21
406,Acc'ton Stanley,10,13,23,35,71,-36,43,22
406,Cambridge Utd,12,6,28,39,86,-47,42,23
406,FG Rovers,6,11,29,33,88,-55,29,24
407,Plymouth Argyle,28,11,7,94,46,48,95,1
407,Sheffield Weds,27,13,6,74,31,43,94,2
407,Ipswich Town,26,14,6,87,44,43,92,3
407,Barnsley,26,8,12,73,42,31,86,4
407,Bolton,24,11,11,68,37,31,83,5
407,P'borough Utd,26,5,15,81,53,28,83,6
407,Derby County,22,14,10,70,43,27,80,7
407,Wycombe,23,8,15,63,42,21,77,8
407,Charlton Ath,19,13,14,74,57,17,70,9
407,Exeter City,18,14,14,62,51,11,68,10
407,Portsmouth,16,18,12,61,50,11,66,11
407,Fleetwood Town,16,15,15,58,47,11,63,12
407,Shrewsbury,16,10,20,47,50,-3,58,13
407,Lincoln City,12,21,13,44,48,-4,57,14
407,Port Vale,15,10,21,44,65,-21,55,15
407,Oxford United,12,12,22,47,60,-13,48,16
407,MK Dons,12,11,23,41,64,-23,47,17
407,Bristol Rovers,12,11,23,59,92,-33,47,18
407,Burton Albion,11,12,23,54,83,-29,45,19
407,Acc'ton Stanley,11,10,25,38,73,-35,43,20
407,Cheltenham,10,11,25,34,66,-32,41,21
407,Morecambe,9,13,24,42,76,-34,40,22
407,Cambridge Utd,11,7,28,36,82,-46,40,23
407,FG Rovers,8,12,26,40,89,-49,36,24
408,Sheffield Weds,32,10,4,83,30,53,106,1
408,Plymouth Argyle,28,12,6,90,50,40,96,2
408,Barnsley,29,8,9,75,32,43,95,3
408,Derby County,27,11,8,85,42,43,92,4
408,Ipswich Town,23,15,8,87,45,42,84,5
408,Bolton,23,9,14,65,42,23,78,6
408,Wycombe,24,6,16,64,46,18,78,7
408,P'borough Utd,22,7,17,80,64,16,73,8
408,Fleetwood Town,19,13,14,55,42,13,70,9
408,Portsmouth,18,14,14,59,50,9,68,10
408,Bristol Rovers,17,11,18,74,80,-6,62,11
408,Shrewsbury,17,10,19,54,55,-1,61,12
408,Charlton Ath,14,15,17,64,61,3,57,13
408,Lincoln City,10,23,13,45,52,-7,53,14
408,Port Vale,14,9,23,45,70,-25,51,15
408,Cheltenham,14,9,23,35,61,-26,51,16
408,Exeter City,13,11,22,55,68,-13,50,17
408,Oxford United,13,10,23,45,59,-14,49,18
408,MK Dons,14,7,25,48,66,-18,49,19
408,Cambridge Utd,13,7,26,46,79,-33,46,20
408,Acc'ton Stanley,11,12,23,37,69,-32,45,21
408,Burton Albion,11,10,25,50,90,-40,43,22
408,Morecambe,10,11,25,45,80,-35,41,23
408,FG Rovers,6,10,30,31,84,-53,28,24
409,Plymouth Argyle,30,9,7,86,47,39,99,1
409,Sheffield Weds,28,12,6,77,33,44,96,2
409,Barnsley,28,8,10,73,39,34,92,3
409,Bolton,25,11,10,72,38,34,86,4
409,Derby County,25,9,12,74,42,32,84,5
409,Wycombe,25,8,13,69,45,24,83,6
409,Ipswich Town,22,15,9,86,53,33,81,7
409,Portsmouth,21,12,13,74,55,19,75,8
409,Shrewsbury,20,10,16,52,43,9,70,9
409,P'borough Utd,20,7,19,67,57,10,67,10
409,Charlton Ath,15,17,14,68,58,10,62,11
409,Exeter City,17,10,19,66,65,1,61,12
409,Fleetwood Town,15,15,16,47,49,-2,60,13
409,Lincoln City,11,21,14,43,49,-6,54,14
409,Burton Albion,14,12,20,61,90,-29,54,15
409,Port Vale,14,10,22,45,67,-22,52,16
409,Bristol Rovers,13,11,22,59,79,-20,50,17
409,Oxford United,12,12,22,45,60,-15,48,18
409,Acc'ton Stanley,10,17,19,39,70,-31,47,19
409,Cheltenham,12,9,25,37,65,-28,45,20
409,Cambridge Utd,11,8,27,40,73,-33,41,21
409,Morecambe,8,15,23,47,73,-26,39,22
409,MK Dons,10,9,27,41,74,-33,39,23
409,FG Rovers,8,9,29,38,82,-44,33,24
410,Sheffield Weds,29,12,5,84,33,51,99,1
410,Plymouth Argyle,30,9,7,96,49,47,99,2
410,Derby County,27,10,9,85,40,45,91,3
410,Ipswich Town,23,17,6,85,41,44,86,4
410,Barnsley,25,10,11,73,38,35,85,5
410,Wycombe,25,8,13,68,40,28,83,6
410,Bolton,21,13,12,59,36,23,76,7
410,Shrewsbury,22,9,15,61,46,15,75,8
410,P'borough Utd,23,5,18,73,63,10,74,9
410,Portsmouth,17,16,13,61,56,5,67,10
410,Exeter City,16,12,18,61,58,3,60,11
410,Fleetwood Town,14,16,16,46,49,-3,58,12
410,Charlton Ath,13,16,17,62,73,-11,55,13
410,Port Vale,15,10,21,44,62,-18,55,14
410,Oxford United,14,12,20,49,56,-7,54,15
410,Burton Albion,14,11,21,59,79,-20,53,16
410,Lincoln City,10,21,15,42,55,-13,51,17
410,Bristol Rovers,13,10,23,66,85,-19,49,18
410,Acc'ton Stanley,11,13,22,40,70,-30,46,19
410,Cheltenham,12,9,25,32,63,-31,45,20
410,Cambridge Utd,11,9,26,37,74,-37,42,21
410,Morecambe,9,14,23,41,70,-29,41,22
410,MK Dons,11,7,28,40,74,-34,40,23
410,FG Rovers,6,13,27,36,90,-54,31,24
411,Plymouth Argyle,31,9,6,94,45,49,102,1
411,Sheffield Weds,29,11,6,78,33,45,98,2
411,Ipswich Town,28,13,5,99,41,58,97,3
411,Barnsley,27,8,11,75,41,34,89,4
411,Bolton,23,12,11,68,35,33,81,5
411,Derby County,24,9,13,75,47,28,81,6
411,Wycombe,21,10,15,64,49,15,73,7
411,P'borough Utd,23,3,20,74,63,11,72,8
411,Portsmouth,19,13,14,66,60,6,70,9
411,Fleetwood Town,18,14,14,53,44,9,68,10
411,Shrewsbury,20,6,20,54,51,3,66,11
411,Lincoln City,13,25,8,46,43,3,64,12
411,Exeter City,16,12,18,61,69,-8,60,13
411,Charlton Ath,16,11,19,65,67,-2,59,14
411,Morecambe,14,11,21,49,68,-19,53,15
411,Bristol Rovers,14,10,22,63,87,-24,52,16
411,Port Vale,14,8,24,45,71,-26,50,17
411,Cheltenham,13,9,24,32,58,-26,48,18
411,Oxford United,12,11,23,45,60,-15,47,19
411,Acc'ton Stanley,10,13,23,45,73,-28,43,20
411,Burton Albion,11,10,25,58,93,-35,43,21
411,FG Rovers,10,10,26,41,75,-34,40,22
411,Cambridge Utd,10,8,28,35,77,-42,38,23
411,MK Dons,9,8,29,41,76,-35,35,24
412,Sheffield Weds,29,12,5,80,31,49,99,1
412,Plymouth Argyle,30,9,7,86,51,35,99,2
412,Barnsley,27,9,10,73,42,31,90,3
412,Ipswich Town,23,19,4,75,37,38,88,4
412,Derby County,24,14,8,79,40,39,86,5
412,Wycombe,24,10,12,70,41,29,82,6
412,Bolton,22,12,12,68,39,29,78,7
412,Portsmouth,18,18,10,68,50,18,72,8
412,P'borough Utd,21,8,17,80,64,16,71,9
412,Charlton Ath,18,12,16,66,54,12,66,10
412,Lincoln City,13,22,11,44,47,-3,61,11
412,Fleetwood Town,14,18,14,45,40,5,60,12
412,Shrewsbury,16,10,20,55,61,-6,58,13
412,Morecambe,13,14,19,48,64,-16,53,14
412,Oxford United,12,14,20,49,59,-10,50,15
412,Port Vale,13,10,23,44,65,-21,49,16
412,Exeter City,12,12,22,54,74,-20,48,17
412,Cambridge Utd,13,9,24,39,69,-30,48,18
412,Bristol Rovers,12,11,23,63,86,-23,47,19
412,Cheltenham,12,10,24,40,63,-23,46,20
412,Burton Albion,11,12,23,55,81,-26,45,21
412,MK Dons,10,9,27,38,68,-30,39,22
412,Acc'ton Stanley,9,12,25,36,72,-36,39,23
412,FG Rovers,8,10,28,34,91,-57,34,24
413,Sheffield Weds,32,10,4,91,27,64,106,1
413,Plymouth Argyle,26,15,5,87,51,36,93,2
413,Ipswich Town,24,16,6,88,46,42,88,3
413,Bolton,26,10,10,72,34,38,88,4
413,Derby County,25,11,10,75,41,34,86,5
413,Barnsley,26,7,13,73,48,25,85,6
413,Wycombe,23,9,14,60,39,21,78,7
413,P'borough Utd,24,5,17,74,60,14,77,8
413,Portsmouth,19,14,13,62,47,15,71,9
413,Shrewsbury,19,8,19,54,52,2,65,10
413,Lincoln City,14,19,13,47,50,-3,61,11
413,Port Vale,17,10,19,49,58,-9,61,12
413,Fleetwood Town,14,15,17,43,49,-6,57,13
413,Charlton Ath,13,16,17,57,59,-2,55,14
413,Bristol Rovers,14,10,22,62,81,-19,52,15
413,Cheltenham,14,10,22,44,68,-24,52,16
413,Exeter City,12,14,20,53,59,-6,50,17
413,Oxford United,12,11,23,46,63,-17,47,18
413,Morecambe,11,13,22,46,76,-30,46,19
413,Acc'ton Stanley,10,15,21,38,65,-27,45,20
413,Burton Albion,10,13,23,52,86,-34,43,21
413,Cambridge Utd,12,6,28,39,71,-32,42,22
413,MK Dons,10,8,28,35,65,-30,38,23
413,FG Rovers,8,9,29,38,90,-52,33,24
414,Plymouth Argyle,30,10,6,93,46,47,100,1
414,Sheffield Weds,29,10,7,75,32,43,97,2
414,Wycombe,28,6,12,75,39,36,90,3
414,Derby County,25,12,9,72,37,35,87,4
414,Bolton,26,9,11,66,36,30,87,5
414,Ipswich Town,22,16,8,77,43,34,82,6
414,P'borough Utd,25,6,15,77,50,27,81,7
414,Barnsley,23,9,14,68,40,28,78,8
414,Portsmouth,18,16,12,61,50,11,70,9
414,Charlton Ath,16,13,17,63,61,2,61,10
414,Shrewsbury,17,10,19,51,54,-3,61,11
414,Fleetwood Town,15,14,17,51,48,3,59,12
414,Port Vale,16,10,20,43,60,-17,58,13
414,Exeter City,15,12,19,56,59,-3,57,14
414,Lincoln City,11,23,12,41,45,-4,56,15
414,Oxford United,14,11,21,48,59,-11,53,16
414,Bristol Rovers,14,10,22,63,80,-17,52,17
414,Acc'ton Stanley,11,14,21,38,63,-25,47,18
414,MK Dons,12,10,24,44,67,-23,46,19
414,Morecambe,10,15,21,41,66,-25,45,20
414,Cheltenham,12,9,25,37,63,-26,45,21
414,Burton Albion,11,9,26,51,90,-39,42,22
414,Cambridge Utd,12,6,28,37,76,-39,42,23
414,FG Rovers,5,10,31,31,95,-64,25,24
415,Sheffield Weds,31,10,5,91,29,62,103,1
415,Barnsley,28,7,11,77,44,33,91,2
415,Plymouth Argyle,26,10,10,79,54,25,88,3
415,Ipswich Town,24,14,8,83,46,37,86,4
415,Derby County,24,14,8,72,38,34,86,5
415,Bolton,25,9,12,63,38,25,84,6
415,Wycombe,23,10,13,60,40,20,79,7
415,P'borough Utd,24,6,16,81,55,26,78,8
415,Shrewsbury,20,8,18,61,55,6,68,9
415,Portsmouth,17,16,13,64,56,8,67,10
415,Charlton Ath,16,14,16,61,59,2,62,11
415,Fleetwood Town,15,16,15,53,45,8,61,12
415,Lincoln City,13,20,13,43,47,-4,59,13
415,Exeter City,15,12,19,52,60,-8,57,14
415,Port Vale,16,8,22,46,61,-15,56,15
415,Bristol Rovers,15,10,21,66,82,-16,55,16
415,Burton Albion,13,9,24,60,88,-28,48,17
415,Acc'ton Stanley,12,12,22,41,70,-29,48,18
415,Cheltenham,12,10,24,38,64,-26,46,19
415,MK Dons,12,9,25,46,70,-24,45,20
415,Oxford United,11,11,24,40,60,-20,44,21
415,Morecambe,9,12,25,42,71,-29,39,22
415,FG Rovers,8,13,25,37,79,-42,37,23
415,Cambridge Utd,10,6,30,35,80,-45,36,24
416,Sheffield Weds,31,12,3,84,31,53,105,1
416,Plymouth Argyle,29,10,7,91,47,44,97,2
416,Barnsley,30,5,11,83,43,40,95,3
416,Ipswich Town,25,14,7,90,43,47,89,4
416,Derby County,24,14,8,71,39,32,86,5
416,Bolton,24,12,10,72,38,34,84,6
416,Wycombe,24,9,13,72,41,31,81,7
416,P'borough Utd,23,5,18,80,59,21,74,8
416,Shrewsbury,19,10,17,56,55,1,67,9
416,Port Vale,18,10,18,51,61,-10,64,10
416,Fleetwood Town,15,15,16,52,49,3,60,11
416,Lincoln City,12,22,12,48,46,2,58,12
416,Portsmouth,14,16,16,56,57,-1,58,13
416,Charlton Ath,14,14,18,61,60,1,56,14
416,Exeter City,12,15,19,56,69,-13,51,15
416,Cheltenham,13,11,22,35,53,-18,50,16
416,Cambridge Utd,14,8,24,41,74,-33,50,17
416,Bristol Rovers,13,10,23,64,84,-20,49,18
416,Oxford United,12,10,24,49,63,-14,46,19
416,Burton Albion,11,11,24,49,90,-41,44,20
416,MK Dons,11,10,25,39,74,-35,43,21
416,Morecambe,9,15,22,48,76,-28,42,22
416,Acc'ton Stanley,9,11,26,35,78,-43,38,23
416,FG Rovers,6,11,29,35,88,-53,29,24
417,Sheffield Weds,32,11,3,86,27,59,107,1
417,Plymouth Argyle,29,12,5,90,50,40,99,2
417,Barnsley,26,8,12,78,42,36,86,3
417,Bolton,25,9,12,66,32,34,84,4
417,Ipswich Town,22,17,7,80,45,35,83,5
417,Derby County,24,11,11,81,50,31,83,6
417,Wycombe,23,10,13,66,43,23,79,7
417,P'borough Utd,24,5,17,74,55,19,77,8
417,Portsmouth,17,16,13,62,53,9,67,9
417,Lincoln City,16,19,11,52,50,2,67,10
417,Shrewsbury,20,7,19,56,55,1,67,11
417,Fleetwood Town,14,18,14,51,45,6,60,12
417,Charlton Ath,14,17,15,61,57,4,59,13
417,Port Vale,14,12,20,47,62,-15,54,14
417,Bristol Rovers,14,12,20,59,82,-23,54,15
417,Exeter City,14,10,22,55,63,-8,52,16
417,Oxford United,12,12,22,45,61,-16,48,17
417,Cheltenham,13,8,25,35,63,-28,47,18
417,Morecambe,11,13,22,48,71,-23,46,19
417,Burton Albion,12,9,25,52,87,-35,45,20
417,MK Dons,12,7,27,42,71,-29,43,21
417,Acc'ton Stanley,10,13,23,38,72,-34,43,22
417,Cambridge Utd,9,8,29,34,76,-42,35,23
417,FG Rovers,7,12,27,37,83,-46,33,24
418,Sheffield Weds,31,10,5,90,33,57,103,1
418,Plymouth Argyle,26,14,6,83,46,37,92,2
418,Bolton,26,11,9,69,33,36,89,3
418,Ipswich Town,23,16,7,83,43,40,85,4
418,Barnsley,25,10,11,75,42,33,85,5
418,Wycombe,23,8,15,64,50,14,77,6
418,Derby County,21,12,13,67,44,23,75,7
418,P'borough Utd,22,7,17,72,60,12,73,8
418,Portsmouth,18,17,11,69,49,20,71,9
418,Charlton Ath,18,13,15,75,61,14,67,10
418,Shrewsbury,19,9,18,54,49,5,66,11
418,Lincoln City,15,21,10,50,46,4,66,12
418,Fleetwood Town,16,17,13,53,45,8,65,13
418,Exeter City,16,13,17,58,57,1,61,14
418,Port Vale,17,7,22,51,68,-17,58,15
418,Bristol Rovers,15,9,22,66,82,-16,54,16
418,MK Dons,12,12,22,39,60,-21,48,17
418,Oxford United,11,13,22,49,63,-14,46,18
418,Burton Albion,10,15,21,45,78,-33,45,19
418,Cambridge Utd,12,7,27,35,71,-36,43,20
418,Cheltenham,10,11,25,37,66,-29,41,21
418,Morecambe,8,15,23,44,80,-36,39,22
418,Acc'ton Stanley,8,15,23,34,70,-36,39,23
418,FG Rovers,5,8,33,33,99,-66,23,24
419,Sheffield Weds,28,13,5,81,33,48,97,1
419,Ipswich Town,26,14,6,85,40,45,92,2
419,Plymouth Argyle,25,11,10,79,53,26,86,3
419,Derby County,23,14,9,70,40,30,83,4
419,Barnsley,24,9,13,67,40,27,81,5
419,Bolton,22,11,13,64,40,24,77,6
419,Wycombe,21,9,16,57,45,12,72,7
419,Portsmouth,18,17,11,64,51,13,71,8
419,P'borough Utd,21,7,18,71,56,15,70,9
419,Charlton Ath,18,14,14,74,57,17,68,10
419,Shrewsbury,19,9,18,52,49,3,66,11
419,Lincoln City,14,22,10,56,50,6,64,12
419,Exeter City,16,15,15,58,52,6,63,13
419,Fleetwood Town,14,18,14,43,41,2,60,14
419,Oxford United,14,13,19,55,60,-5,55,15
419,Burton Albion,14,12,20,62,83,-21,54,16
419,Bristol Rovers,14,10,22,59,75,-16,52,17
419,Port Vale,14,9,23,44,69,-25,51,18
419,Morecambe,12,14,20,47,68,-21,50,19
419,Acc'ton Stanley,11,13,22,40,70,-30,46,20
419,Cheltenham,11,11,24,32,59,-27,44,21
419,MK Dons,10,10,26,39,76,-37,40,22
419,Cambridge Utd,10,7,29,32,73,-41,37,23
419,FG Rovers,6,12,28,29,80,-51,30,24
420,Sheffield Weds,29,13,4,86,33,53,100,1
420,Plymouth Argyle,29,10,7,82,48,34,97,2
420,Ipswich Town,26,14,6,98,48,50,92,3
420,Derby County,24,13,9,74,48,26,85,4
420,Wycombe,26,6,14,66,43,23,84,5
420,Barnsley,24,10,12,73,45,28,82,6
420,Bolton,23,9,14,65,37,28,78,7
420,P'borough Utd,22,7,17,77,57,20,73,8
420,Fleetwood Town,18,15,13,63,48,15,69,9
420,Portsmouth,17,16,13,62,53,9,67,10
420,Shrewsbury,17,11,18,52,52,0,62,11
420,Charlton Ath,16,12,18,69,67,2,60,12
420,Bristol Rovers,15,12,19,61,71,-10,57,13
420,Lincoln City,12,20,14,46,53,-7,56,14
420,Exeter City,14,11,21,60,67,-7,53,15
420,Burton Albion,14,11,21,64,88,-24,53,16
420,Port Vale,13,12,21,48,74,-26,51,17
420,Oxford United,13,11,22,56,68,-12,50,18
420,Acc'ton Stanley,13,11,22,43,75,-32,50,19
420,Cheltenham,13,8,25,37,65,-28,47,20
420,Morecambe,11,14,21,47,77,-30,47,21
420,MK Dons,12,8,26,50,71,-21,44,22
420,Cambridge Utd,10,6,30,35,73,-38,36,23
420,FG Rovers,5,12,29,31,84,-53,27,24
421,Sheffield Weds,30,12,4,85,28,57,102,1
421,Barnsley,28,9,9,79,40,39,93,2
421,Plymouth Argyle,25,13,8,81,51,30,88,3
421,Ipswich Town,21,18,7,79,47,32,81,4
421,Derby County,23,12,11,68,37,31,81,5
421,Wycombe,23,9,14,64,42,22,78,6
421,Bolton,21,13,12,65,41,24,76,7
421,P'borough Utd,22,7,17,84,57,27,73,8
421,Portsmouth,19,16,11,63,52,11,73,9
421,Shrewsbury,20,9,17,50,43,7,69,10
421,Lincoln City,16,19,11,44,46,-2,67,11
421,Charlton Ath,16,15,15,72,58,14,63,12
421,Bristol Rovers,18,9,19,64,73,-9,63,13
421,Exeter City,17,10,19,58,64,-6,61,14
421,Fleetwood Town,12,18,16,42,45,-3,54,15
421,Port Vale,15,7,24,49,68,-19,52,16
421,Cheltenham,14,9,23,36,59,-23,51,17
421,Morecambe,11,15,20,44,65,-21,48,18
421,Burton Albion,12,11,23,56,87,-31,47,19
421,Oxford United,11,12,23,44,59,-15,45,20
421,MK Dons,11,10,25,40,65,-25,43,21
421,Acc'ton Stanley,10,13,23,35,69,-34,43,22
421,Cambridge Utd,9,9,28,36,82,-46,36,23
421,FG Rovers,6,9,31,28,88,-60,27,24
422,Sheffield Weds,28,13,5,79,31,48,97,1
422,Plymouth Argyle,29,10,7,89,50,39,97,2
422,Barnsley,27,10,9,75,39,36,91,3
422,Bolton,26,10,10,72,38,34,88,4
422,Ipswich Town,24,15,7,85,46,39,87,5
422,Derby County,25,9,12,76,43,33,84,6
422,Wycombe,22,9,15,56,41,15,75,7
422,Portsmouth,19,15,12,63,53,10,72,8
422,P'borough Utd,20,7,19,72,62,10,67,9
422,Exeter City,17,12,17,64,58,6,63,10
422,Fleetwood Town,16,14,16,54,50,4,62,11
422,Shrewsbury,17,11,18,53,54,-1,62,12
422,Charlton Ath,15,14,17,65,59,6,59,13
422,Lincoln City,12,23,11,45,45,0,59,14
422,Port Vale,16,9,21,45,63,-18,57,15
422,Acc'ton Stanley,13,13,20,43,62,-19,52,16
422,Bristol Rovers,13,11,22,65,82,-17,50,17
422,Cheltenham,12,11,23,37,62,-25,47,18
422,Oxford United,11,13,22,45,62,-17,46,19
422,Burton Albion,11,13,22,52,85,-33,46,20
422,Morecambe,11,10,25,46,81,-35,43,21
422,Cambridge Utd,10,11,25,36,70,-34,41,22
422,MK Dons,10,9,27,41,73,-32,39,23
422,FG Rovers,7,10,29,34,83,-49,31,24
423,Sheffield Weds,30,9,7,81,30,51,99,1
423,Plymouth Argyle,28,12,6,89,47,42,96,2
423,Barnsley,27,9,10,75,42,33,90,3
423,Ipswich Town,24,15,7,81,44,37,87,4
423,Derby County,24,13,9,71,38,33,85,5
423,Bolton,24,12,10,70,33,37,84,6
423,P'borough Utd,25,4,17,77,53,24,79,7
423,Wycombe,21,8,17,58,52,6,71,8
423,Portsmouth,17,16,13,63,53,10,67,9
423,Shrewsbury,18,13,15,53,45,8,67,10
423,Exeter City,17,12,17,59,53,6,63,11
423,Charlton Ath,16,14,16,73,62,11,62,12
423,Cheltenham,16,9,21,39,54,-15,57,13
423,Port Vale,14,11,21,45,68,-23,53,14
423,Fleetwood Town,11,19,16,43,47,-4,52,15
423,Bristol Rovers,13,12,21,61,78,-17,51,16
423,Oxford United,12,14,20,46,54,-8,50,17
423,Lincoln City,8,22,16,36,54,-18,46,18
423,Burton Albion,12,10,24,57,86,-29,46,19
423,Morecambe,11,12,23,43,69,-26,45,20
423,Cambridge Utd,12,9,25,39,74,-35,45,21
423,Acc'ton Stanley,10,14,22,36,74,-38,44,22
423,MK Dons,10,11,25,40,68,-28,41,23
423,FG Rovers,7,10,29,33,90,-57,31,24
424,Sheffield Weds,29,14,3,86,30,56,101,1
424,Barnsley,28,8,10,73,39,34,92,2
424,Plymouth Argyle,27,11,8,79,54,25,92,3
424,Ipswich Town,24,15,7,84,45,39,87,4
424,Derby County,22,15,9,74,40,34,81,5
424,Bolton,23,10,13,69,44,25,79,6
424,Wycombe,23,9,14,67,42,25,78,7
424,P'borough Utd,23,4,19,76,63,13,73,8
424,Shrewsbury,21,7,18,56,50,6,70,9
424,Portsmouth,17,18,11,65,51,14,69,10
424,Charlton Ath,15,16,15,61,57,4,61,11
424,Fleetwood Town,14,16,16,46,45,1,58,12
424,Lincoln City,13,19,14,46,52,-6,58,13
424,Bristol Rovers,16,9,21,63,74,-11,57,14
424,Exeter City,15,11,20,61,62,-1,56,15
424,Port Vale,15,9,22,49,68,-19,54,16
424,Burton Albion,13,12,21,54,78,-24,51,17
424,Oxford United,12,14,20,48,55,-7,50,18
424,Acc'ton Stanley,11,15,20,45,77,-32,48,19
424,Cheltenham,13,8,25,35,62,-27,47,20
424,MK Dons,12,10,24,46,66,-20,46,21
424,Morecambe,10,12,24,46,73,-27,42,22
424,Cambridge Utd,8,10,28,35,79,-44,34,23
424,FG Rovers,7,10,29,32,90,-58,31,24
425,Sheffield Weds,32,11,3,89,31,58,107,1
425,Plymouth Argyle,27,11,8,86,50,36,92,2
425,Bolton,27,9,10,75,39,36,90,3
425,Derby County,25,12,9,80,48,32,87,4
425,Barnsley,25,10,11,75,45,30,85,5
425,Ipswich Town,23,15,8,79,50,29,84,6
425,Wycombe,24,8,14,78,41,37,80,7
425,P'borough Utd,23,8,15,86,61,25,77,8
425,Shrewsbury,19,10,17,51,45,6,67,9
425,Portsmouth,18,13,15,57,60,-3,67,10
425,Fleetwood Town,16,15,15,49,43,6,63,11
425,Charlton Ath,16,14,16,63,58,5,62,12
425,Bristol Rovers,18,8,20,67,76,-9,62,13
425,Lincoln City,13,20,13,44,48,-4,59,14
425,Exeter City,14,12,20,61,73,-12,54,15
425,Oxford United,13,12,21,52,62,-10,51,16
425,Burton Albion,14,9,23,60,86,-26,51,17
425,Port Vale,13,9,24,47,77,-30,48,18
425,Morecambe,10,13,23,46,74,-28,43,19
425,Cheltenham,10,12,24,33,61,-28,42,20
425,Cambridge Utd,11,9,26,43,76,-33,42,21
425,Acc'ton Stanley,10,12,24,38,74,-36,42,22
425,MK Dons,10,7,29,44,70,-26,37,23
425,FG Rovers,6,11,29,32,87,-55,29,24
426,Plymouth Argyle,30,9,7,85,50,35,99,1
426,Barnsley,30,7,9,74,37,37,97,2
426,Sheffield Weds,26,14,6,77,32,45,92,3
426,Bolton,25,12,9,73,34,39,87,4
426,Ipswich Town,24,15,7,77,42,35,87,5
426,Derby County,24,12,10,76,37,39,84,6
426,P'borough Utd,24,5,17,78,59,19,77,7
426,Portsmouth,19,17,10,64,48,16,74,8
426,Wycombe,21,10,15,61,45,16,73,9
426,Charlton Ath,16,15,15,66,58,8,63,10
426,Shrewsbury,18,8,20,55,57,-2,62,11
426,Lincoln City,13,21,12,45,46,-1,60,12
426,Exeter City,12,19,15,58,58,0,55,13
426,Bristol Rovers,14,13,19,64,77,-13,55,14
426,Port Vale,16,7,23,50,70,-20,55,15
426,Fleetwood Town,12,16,18,44,51,-7,52,16
426,Oxford United,13,11,22,52,59,-7,50,17
426,Cambridge Utd,13,8,25,42,70,-28,47,18
426,Acc'ton Stanley,10,15,21,41,76,-35,45,19
426,Morecambe,10,13,23,48,74,-26,43,20
426,Burton Albion,10,12,24,48,82,-34,42,21
426,Cheltenham,10,11,25,33,70,-37,41,22
426,MK Dons,10,9,27,43,75,-32,39,23
426,FG Rovers,6,13,27,32,79,-47,31,24
427,Sheffield Weds,32,9,5,89,29,60,105,1
427,Plymouth Argyle,28,11,7,81,46,35,95,2
427,Ipswich Town,26,14,6,86,43,43,92,3
427,Barnsley,24,10,12,65,42,23,82,4
427,Wycombe,24,9,13,70,43,27,81,5
427,Bolton,23,12,11,67,40,27,81,6
427,Derby County,23,11,12,75,45,30,80,7
427,P'borough Utd,23,5,18,77,57,20,74,8
427,Portsmouth,18,17,11,63,52,11,71,9
427,Fleetwood Town,17,17,12,59,43,16,68,10
427,Shrewsbury,19,9,18,57,56,1,66,11
427,Charlton Ath,17,11,18,64,68,-4,62,12
427,Lincoln City,12,22,12,43,49,-6,58,13
427,Exeter City,15,11,20,57,64,-7,56,14
427,Port Vale,14,10,22,44,64,-20,52,15
427,Morecambe,12,13,21,48,68,-20,49,16
427,Bristol Rovers,13,9,24,59,78,-19,48,17
427,Burton Albion,11,13,22,58,83,-25,46,18
427,Cheltenham,12,10,24,38,70,-32,46,19
427,Oxford United,11,12,23,46,65,-19,45,20
427,MK Dons,11,10,25,44,71,-27,43,21
427,Cambridge Utd,11,10,25,36,66,-30,43,22
427,Acc'ton Stanley,9,15,22,33,64,-31,42,23
427,FG Rovers,6,12,28,31,84,-53,30,24
428,Sheffield Weds,32,10,4,90,29,61,106,1
428,Plymouth Argyle,29,11,6,81,45,36,98,2
428,Derby County,25,13,8,80,39,41,88,3
428,Barnsley,26,10,10,73,40,33,88,4
428,Bolton,26,9,11,71,36,35,87,5
428,Ipswich Town,23,16,7,83,44,39,85,6
428,Wycombe,22,10,14,61,39,22,76,7
428,P'borough Utd,21,8,17,77,63,14,71,8
428,Shrewsbury,20,11,15,62,51,11,71,9
428,Portsmouth,18,14,14,62,60,2,68,10
428,Fleetwood Town,17,15,14,48,42,6,66,11
428,Lincoln City,13,20,13,39,44,-5,59,12
428,Charlton Ath,15,13,18,62,62,0,58,13
428,Oxford United,14,13,19,47,53,-6,55,14
428,Exeter City,14,12,20,57,64,-7,54,15
428,Burton Albion,13,12,21,58,77,-19,51,16
428,Bristol Rovers,13,9,24,56,80,-24,48,17
428,Acc'ton Stanley,11,13,22,39,70,-31,46,18
428,Port Vale,12,9,25,43,72,-29,45,19
428,Cheltenham,12,9,25,33,66,-33,45,20
428,MK Dons,12,8,26,41,69,-28,44,21
428,Cambridge Utd,13,5,28,41,75,-34,44,22
428,Morecambe,9,12,25,40,73,-33,39,23
428,FG Rovers,5,12,29,30,81,-51,27,24
429,Sheffield Weds,31,11,4,90,30,60,104,1
429,Plymouth Argyle,30,9,7,88,47,41,99,2
429,Barnsley,28,7,11,77,40,37,91,3
429,Ipswich Town,23,15,8,88,49,39,84,4
429,Derby County,23,14,9,75,44,31,83,5
429,Bolton,22,13,11,61,34,27,79,6
429,P'borough Utd,23,5,18,78,56,22,74,7
429,Wycombe,21,10,15,57,42,15,73,8
429,Shrewsbury,20,11,15,56,49,7,71,9
429,Fleetwood Town,16,16,14,51,44,7,64,10
429,Lincoln City,14,22,10,48,45,3,64,11
429,Portsmouth,16,15,15,61,53,8,63,12
429,Charlton Ath,14,14,18,65,65,0,56,13
429,Port Vale,16,8,22,47,66,-19,56,14
429,Exeter City,14,11,21,54,74,-20,53,15
429,Burton Albion,14,11,21,56,80,-24,53,16
429,Cheltenham,15,8,23,41,66,-25,53,17
429,Bristol Rovers,14,10,22,65,85,-20,52,18
429,Oxford United,13,9,24,45,62,-17,48,19
429,MK Dons,13,8,25,45,67,-22,47,20
429,Acc'ton Stanley,11,11,24,36,72,-36,44,21
429,Morecambe,10,13,23,50,72,-22,43,22
429,Cambridge Utd,11,6,29,37,77,-40,39,23
429,FG Rovers,6,11,29,33,85,-52,29,24
430,Sheffield Weds,29,13,4,86,33,53,100,1
430,Ipswich Town,27,13,6,92,44,48,94,2
430,Plymouth Argyle,27,11,8,92,55,37,92,3
430,Barnsley,26,9,11,69,38,31,87,4
430,Bolton,25,11,10,74,34,40,86,5
430,Derby County,25,11,10,77,42,35,86,6
430,Wycombe,23,8,15,66,44,22,77,7
430,Portsmouth,20,14,12,66,56,10,74,8
430,Shrewsbury,21,8,17,63,58,5,71,9
430,Fleetwood Town,17,13,16,56,47,9,64,10
430,P'borough Utd,19,6,21,70,67,3,63,11
430,Lincoln City,14,19,13,45,49,-4,61,12
430,Charlton Ath,14,15,17,62,60,2,57,13
430,Exeter City,14,13,19,61,65,-4,55,14
430,Bristol Rovers,14,11,21,59,72,-13,53,15
430,Port Vale,13,12,21,49,71,-22,51,16
430,Cheltenham,14,6,26,43,66,-23,48,17
430,MK Dons,13,9,24,49,73,-24,48,18
430,Acc'ton Stanley,11,15,20,41,73,-32,48,19
430,Oxford United,11,13,22,49,70,-21,46,20
430,Burton Albion,12,10,24,52,88,-36,46,21
430,Morecambe,10,13,23,44,73,-29,43,22
430,Cambridge Utd,10,8,28,41,80,-39,38,23
430,FG Rovers,7,11,28,36,84,-48,32,24
431,Sheffield Weds,31,10,5,91,35,56,103,1
431,Plymouth Argyle,29,8,9,90,51,39,95,2
431,Ipswich Town,26,14,6,87,43,44,92,3
431,Derby County,25,11,10,76,36,40,86,4
431,Barnsley,26,6,14,76,44,32,84,5
431,Bolton,23,13,10,67,38,29,82,6
431,P'borough Utd,22,8,16,78,58,20,74,7
431,Wycombe,19,10,17,62,50,12,67,8
431,Charlton Ath,16,16,14,66,54,12,64,9
431,Fleetwood Town,16,15,15,52,45,7,63,10
431,Exeter City,16,14,16,63,62,1,62,11
431,Lincoln City,13,23,10,42,45,-3,62,12
431,Shrewsbury,17,10,19,52,58,-6,61,13
431,Portsmouth,14,16,16,58,55,3,58,14
431,MK Dons,16,9,21,47,62,-15,57,15
431,Oxford United,14,14,18,48,53,-5,56,16
431,Burton Albion,14,11,21,57,84,-27,53,17
431,Port Vale,13,12,21,51,73,-22,51,18
431,Bristol Rovers,13,11,22,61,80,-19,50,19
431,Cambridge Utd,12,9,25,41,71,-30,45,20
431,Acc'ton Stanley,10,12,24,37,72,-35,42,21
431,Morecambe,10,11,25,47,75,-28,41,22
431,Cheltenham,9,11,26,35,69,-34,38,23
431,FG Rovers,6,10,30,34,105,-71,28,24
432,Sheffield Weds,32,11,3,95,30,65,107,1
432,Bolton,28,8,10,75,34,41,92,2
432,Derby County,26,12,8,80,45,35,90,3
432,Plymouth Argyle,26,10,10,73,51,22,88,4
432,Wycombe,26,8,12,65,38,27,86,5
432,Ipswich Town,22,17,7,77,43,34,83,6
432,Barnsley,24,9,13,72,48,24,81,7
432,Portsmouth,19,14,13,66,58,8,71,8
432,P'borough Utd,22,3,21,71,59,12,69,9
432,Shrewsbury,19,9,18,56,52,4,66,10
432,Fleetwood Town,15,17,14,56,48,8,62,11
432,Exeter City,15,12,19,54,55,-1,57,12
432,Cheltenham,17,6,23,44,64,-20,57,13
432,Lincoln City,12,20,14,46,49,-3,56,14
432,Charlton Ath,13,15,18,59,62,-3,54,15
432,Bristol Rovers,14,10,22,57,76,-19,52,16
432,Port Vale,14,9,23,46,67,-21,51,17
432,Morecambe,13,12,21,51,74,-23,51,18
432,Acc'ton Stanley,10,15,21,43,73,-30,45,19
432,Cambridge Utd,12,8,26,41,70,-29,44,20
432,Burton Albion,12,8,26,59,92,-33,44,21
432,Oxford United,10,13,23,43,57,-14,43,22
432,MK Dons,12,7,27,42,75,-33,43,23
432,FG Rovers,8,9,29,38,89,-51,33,24
433,Sheffield Weds,30,13,3,83,26,57,103,1
433,Plymouth Argyle,28,11,7,90,50,40,95,2
433,Ipswich Town,25,13,8,81,45,36,88,3
433,Barnsley,26,9,11,75,43,32,87,4
433,Wycombe,26,9,11,68,38,30,87,5
433,Derby County,22,14,10,76,44,32,80,6
433,Bolton,21,14,11,63,39,24,77,7
433,Portsmouth,20,13,13,70,49,21,73,8
433,P'borough Utd,22,4,20,76,64,12,70,9
433,Charlton Ath,18,13,15,67,55,12,67,10
433,Fleetwood Town,16,16,14,51,44,7,64,11
433,Shrewsbury,18,10,18,57,54,3,64,12
433,Oxford United,16,12,18,54,55,-1,60,13
433,Exeter City,16,10,20,58,61,-3,58,14
433,Lincoln City,12,20,14,44,48,-4,56,15
433,Port Vale,15,10,21,50,71,-21,55,16
433,MK Dons,14,7,25,48,69,-21,49,17
433,Bristol Rovers,13,9,24,60,88,-28,48,18
433,Cheltenham,12,11,23,35,61,-26,47,19
433,Acc'ton Stanley,9,15,22,39,70,-31,42,20
433,Burton Albion,10,12,24,51,90,-39,42,21
433,Cambridge Utd,9,9,28,36,74,-38,36,22
433,Morecambe,8,12,26,37,78,-41,36,23
433,FG Rovers,8,10,28,36,89,-53,34,24
434,Plymouth Argyle,32,8,6,90,49,41,104,1
434,Sheffield Weds,29,13,4,80,34,46,100,2
434,Derby County,25,11,10,78,40,38,86,3
434,Ipswich Town,23,15,8,88,49,39,84,4
434,Bolton,24,12,10,73,34,39,84,5
434,Barnsley,23,11,12,70,44,26,80,6
434,Wycombe,24,8,14,67,41,26,80,7
434,Portsmouth,21,15,10,65,46,19,78,8
434,P'borough Utd,22,3,21,81,63,18,69,9
434,Shrewsbury,19,9,18,53,51,2,66,10
434,Fleetwood Town,16,16,14,49,44,5,64,11
434,Charlton Ath,16,14,16,68,60,8,62,12
434,Exeter City,16,11,19,63,63,0,59,13
434,Burton Albion,16,11,19,57,73,-16,59,14
434,Lincoln City,12,19,15,41,47,-6,55,15
434,Oxford United,14,12,20,47,57,-10,54,16
434,Bristol Rovers,14,11,21,68,84,-16,53,17
434,Port Vale,12,11,23,41,74,-33,47,18
434,Cambridge Utd,12,8,26,45,83,-38,44,19
434,Acc'ton Stanley,10,13,23,35,71,-36,43,20
434,Morecambe,10,12,24,44,79,-35,42,21
434,MK Dons,10,9,27,43,75,-32,39,22
434,Cheltenham,9,10,27,32,67,-35,37,23
434,FG Rovers,6,12,28,35,85,-50,30,24
435,Sheffield Weds,31,9,6,82,29,53,102,1
435,Plymouth Argyle,29,10,7,99,59,40,97,2
435,Barnsley,27,9,10,75,43,32,90,3
435,Derby County,25,9,12,80,42,38,84,4
435,Ipswich Town,22,15,9,79,44,35,81,5
435,Bolton,23,10,13,63,39,24,79,6
435,Wycombe,22,12,12,63,39,24,78,7
435,Portsmouth,17,18,11,58,45,13,69,8
435,P'borough Utd,20,8,18,71,58,13,68,9
435,Shrewsbury,18,10,18,54,56,-2,64,10
435,Lincoln City,14,21,11,45,41,4,63,11
435,Fleetwood Town,15,14,17,44,42,2,59,12
435,Bristol Rovers,16,9,21,72,78,-6,57,13
435,Acc'ton Stanley,15,12,19,42,64,-22,57,14
435,Charlton Ath,14,14,18,63,67,-4,56,15
435,Burton Albion,14,11,21,62,85,-23,53,16
435,Exeter City,13,13,20,55,66,-11,52,17
435,Port Vale,13,12,21,42,64,-22,51,18
435,Oxford United,13,11,22,45,60,-15,50,19
435,Cheltenham,13,10,23,37,65,-28,49,20
435,MK Dons,12,10,24,46,66,-20,46,21
435,Morecambe,9,13,24,40,75,-35,40,22
435,Cambridge Utd,8,13,25,33,68,-35,37,23
435,FG Rovers,8,9,29,37,92,-55,33,24
436,Plymouth Argyle,31,9,6,79,45,34,102,1
436,Sheffield Weds,28,13,5,79,29,50,97,2
436,Ipswich Town,27,14,5,92,46,46,95,3
436,Barnsley,27,8,11,74,42,32,89,4
436,Bolton,25,9,12,73,36,37,84,5
436,Wycombe,24,8,14,67,38,29,80,6
436,Derby County,22,11,13,68,45,23,77,7
436,P'borough Utd,23,6,17,80,62,18,75,8
436,Shrewsbury,22,8,16,55,42,13,74,9
436,Portsmouth,17,17,12,62,54,8,68,10
436,Exeter City,18,9,19,63,61,2,63,11
436,Bristol Rovers,17,10,19,69,72,-3,61,12
436,Charlton Ath,14,15,17,58,58,0,57,13
436,Fleetwood Town,14,15,17,49,53,-4,57,14
436,Lincoln City,12,18,16,44,55,-11,54,15
436,Oxford United,13,12,21,48,58,-10,51,16
436,Port Vale,14,9,23,45,67,-22,51,17
436,Burton Albion,13,10,23,52,79,-27,49,18
436,MK Dons,13,8,25,44,68,-24,47,19
436,Cheltenham,11,11,24,34,62,-28,44,20
436,Acc'ton Stanley,10,14,22,42,74,-32,44,21
436,Cambridge Utd,11,6,29,35,76,-41,39,22
436,Morecambe,7,14,25,38,77,-39,35,23
436,FG Rovers,7,10,29,34,85,-51,31,24
437,Plymouth Argyle,29,11,6,91,52,39,98,1
437,Sheffield Weds,28,13,5,85,32,53,97,2
437,Barnsley,27,9,10,71,40,31,90,3
437,Ipswich Town,25,13,8,85,41,44,88,4
437,Bolton,24,11,11,65,34,31,83,5
437,Derby County,24,10,12,74,44,30,82,6
437,Wycombe,25,6,15,69,47,22,81,7
437,P'borough Utd,21,7,18,72,61,11,70,8
437,Shrewsbury,20,10,16,55,48,7,70,9
437,Portsmouth,16,18,12,62,52,10,66,10
437,Exeter City,17,11,18,61,60,1,62,11
437,Fleetwood Town,15,15,16,52,49,3,60,12
437,Oxford United,15,15,16,50,50,0,60,13
437,Bristol Rovers,15,10,21,66,82,-16,55,14
437,Lincoln City,10,24,12,38,47,-9,54,15
437,Charlton Ath,12,17,17,58,65,-7,53,16
437,Port Vale,14,11,21,44,63,-19,53,17
437,Cheltenham,12,15,19,34,54,-20,51,18
437,MK Dons,13,8,25,46,67,-21,47,19
437,Cambridge Utd,12,9,25,43,68,-25,45,20
437,Burton Albion,10,9,27,50,89,-39,39,21
437,Acc'ton Stanley,8,14,24,35,79,-44,38,22
437,Morecambe,8,12,26,38,75,-37,36,23
437,FG Rovers,7,12,27,39,84,-45,33,24
438,Plymouth Argyle,30,11,5,90,47,43,101,1
438,Sheffield Weds,28,12,6,78,31,47,96,2
438,Ipswich Town,27,14,5,94,41,53,95,3
438,Barnsley,27,8,11,70,38,32,89,4
438,Bolton,24,12,10,72,41,31,84,5
438,Wycombe,25,5,16,68,48,20,80,6
438,Derby County,22,13,11,69,40,29,79,7
438,P'borough Utd,22,5,19,74,62,12,71,8
438,Lincoln City,16,20,10,48,40,8,68,9
438,Shrewsbury,19,10,17,55,50,5,67,10
438,Portsmouth,17,15,14,68,57,11,66,11
438,Exeter City,15,15,16,55,57,-2,60,12
438,Charlton Ath,15,13,18,63,61,2,58,13
438,Oxford United,15,10,21,47,55,-8,55,14
438,Fleetwood Town,12,18,16,44,49,-5,54,15
438,Port Vale,14,11,21,49,66,-17,53,16
438,Bristol Rovers,13,11,22,61,86,-25,50,17
438,Morecambe,10,14,22,48,75,-27,44,18
438,Burton Albion,11,11,24,54,89,-35,44,19
438,Cheltenham,12,8,26,34,69,-35,44,20
438,MK Dons,12,7,27,42,67,-25,43,21
438,Acc'ton Stanley,10,13,23,37,74,-37,43,22
438,Cambridge Utd,10,10,26,41,75,-34,40,23
438,FG Rovers,7,12,27,38,81,-43,33,24
439,Plymouth Argyle,30,9,7,86,47,39,99,1
439,Sheffield Weds,28,10,8,80,36,44,94,2
439,Barnsley,27,7,12,78,38,40,88,3
439,Derby County,25,13,8,76,39,37,88,4
439,Ipswich Town,23,16,7,83,44,39,85,5
439,Wycombe,26,7,13,72,45,27,85,6
439,Bolton,23,13,10,67,38,29,82,7
439,P'borough Utd,23,6,17,76,53,23,75,8
439,Portsmouth,19,16,11,66,49,17,73,9
439,Shrewsbury,18,11,17,58,51,7,65,10
439,Lincoln City,15,20,11,50,51,-1,65,11
439,Fleetwood Town,16,15,15,54,43,11,63,12
439,Oxford United,15,14,17,56,54,2,59,13
439,Exeter City,14,12,20,57,61,-4,54,14
439,Bristol Rovers,15,9,22,61,79,-18,54,15
439,Charlton Ath,12,16,18,63,66,-3,52,16
439,Burton Albion,14,10,22,60,86,-26,52,17
439,MK Dons,13,9,24,43,65,-22,48,18
439,Port Vale,12,11,23,43,72,-29,47,19
439,Acc'ton Stanley,9,14,23,32,66,-34,41,20
439,Cheltenham,10,8,28,35,75,-40,38,21
439,Cambridge Utd,10,8,28,39,83,-44,38,22
439,Morecambe,8,13,25,41,84,-43,37,23
439,FG Rovers,8,11,27,39,90,-51,35,24
440,Plymouth Argyle,28,11,7,81,50,31,95,1
440,Sheffield Weds,26,13,7,79,39,40,91,2
440,Ipswich Town,24,16,6,80,43,37,88,3
440,Derby County,25,13,8,74,38,36,88,4
440,Bolton,24,12,10,70,35,35,84,5
440,Wycombe,24,9,13,67,43,24,81,6
440,P'borough Utd,22,7,17,83,61,22,73,7
440,Barnsley,22,7,17,73,55,18,73,8
440,Portsmouth,18,15,13,59,49,10,69,9
440,Charlton Ath,18,14,14,61,52,9,68,10
440,Shrewsbury,19,8,19,53,45,8,65,11
440,Exeter City,16,14,16,57,55,2,62,12
440,Port Vale,17,9,20,46,58,-12,60,13
440,Lincoln City,12,23,11,43,47,-4,59,14
440,Fleetwood Town,14,16,16,48,51,-3,58,15
440,Oxford United,13,14,19,50,55,-5,53,16
440,Bristol Rovers,14,11,21,60,79,-19,53,17
440,Cheltenham,13,8,25,37,63,-26,47,18
440,Burton Albion,12,10,24,54,81,-27,46,19
440,Acc'ton Stanley,11,13,22,38,72,-34,46,20
440,MK Dons,12,7,27,41,68,-27,43,21
440,Morecambe,9,14,23,42,74,-32,41,22
440,Cambridge Utd,9,10,27,39,75,-36,37,23
440,FG Rovers,8,10,28,37,84,-47,34,24
441,Sheffield Weds,29,11,6,86,33,53,98,1
441,Plymouth Argyle,28,11,7,80,45,35,95,2
441,Derby County,26,10,10,81,38,43,88,3
441,Bolton,25,11,10,71,37,34,86,4
441,Barnsley,25,10,11,72,45,27,85,5
441,Ipswich Town,22,16,8,76,51,25,82,6
441,P'borough Utd,25,6,15,81,58,23,81,7
441,Wycombe,23,11,12,66,39,27,80,8
441,Portsmouth,17,17,12,61,50,11,68,9
441,Charlton Ath,18,13,15,69,55,14,67,10
441,Fleetwood Town,17,15,14,50,40,10,66,11
441,Shrewsbury,17,12,17,47,43,4,63,12
441,Lincoln City,10,24,12,39,47,-8,54,13
441,Burton Albion,14,12,20,63,82,-19,54,14
441,Bristol Rovers,15,9,22,60,80,-20,54,15
441,Exeter City,12,16,18,57,64,-7,52,16
441,Port Vale,13,11,22,43,67,-24,50,17
441,Oxford United,11,14,21,41,58,-17,47,18
441,Morecambe,10,16,20,43,68,-25,46,19
441,MK Dons,11,10,25,43,73,-30,43,20
441,Cambridge Utd,12,6,28,39,76,-37,42,21
441,Cheltenham,10,9,27,31,63,-32,39,22
441,Acc'ton Stanley,8,14,24,38,73,-35,38,23
441,FG Rovers,7,10,29,37,89,-52,31,24
442,Sheffield Weds,31,10,5,77,31,46,103,1
442,Derby County,27,11,8,85,45,40,92,2
442,Plymouth Argyle,27,11,8,88,49,39,92,3
442,Bolton,28,8,10,70,33,37,92,4
442,Barnsley,26,7,13,69,37,32,85,5
442,Ipswich Town,20,17,9,77,49,28,77,6
442,Wycombe,21,10,15,59,45,14,73,7
442,P'borough Utd,21,9,16,75,53,22,72,8
442,Lincoln City,18,18,10,49,44,5,72,9
442,Shrewsbury,18,9,19,56,53,3,63,10
442,Charlton Ath,16,14,16,62,56,6,62,11
442,Fleetwood Town,16,14,16,50,46,4,62,12
442,Portsmouth,16,13,17,55,56,-1,61,13
442,Bristol Rovers,14,11,21,61,79,-18,53,14
442,Exeter City,14,10,22,51,59,-8,52,15
442,Morecambe,13,12,21,49,70,-21,51,16
442,Oxford United,12,13,21,47,61,-14,49,17
442,Port Vale,13,10,23,45,70,-25,49,18
442,Cambridge Utd,14,7,25,42,73,-31,49,19
442,Cheltenham,12,11,23,36,58,-22,47,20
442,MK Dons,13,8,25,44,67,-23,47,21
442,Burton Albion,11,12,23,60,91,-31,45,22
442,Acc'ton Stanley,8,16,22,32,66,-34,40,23
442,FG Rovers,6,13,27,37,85,-48,31,24
443,Sheffield Weds,30,11,5,89,34,55,101,1
443,Plymouth Argyle,26,13,7,87,53,34,91,2
443,Barnsley,27,8,11,77,43,34,89,3
443,Derby County,25,13,8,79,38,41,88,4
443,Ipswich Town,24,15,7,94,48,46,87,5
443,Bolton,23,10,13,67,37,30,79,6
443,Wycombe,22,8,16,63,48,15,74,7
443,P'borough Utd,22,6,18,80,66,14,72,8
443,Portsmouth,18,15,13,65,52,13,69,9
443,Lincoln City,14,23,9,50,43,7,65,10
443,Charlton Ath,17,12,17,69,59,10,63,11
443,Shrewsbury,18,9,19,49,55,-6,63,12
443,Fleetwood Town,14,14,18,52,55,-3,56,13
443,Bristol Rovers,14,14,18,66,78,-12,56,14
443,Port Vale,15,11,20,47,63,-16,56,15
443,Burton Albion,13,12,21,60,86,-26,51,16
443,Acc'ton Stanley,13,11,22,39,77,-38,50,17
443,Oxford United,13,10,23,51,65,-14,49,18
443,Morecambe,12,13,21,51,69,-18,49,19
443,Exeter City,12,11,23,56,77,-21,47,20
443,MK Dons,13,7,26,46,73,-27,46,21
443,Cheltenham,12,9,25,38,69,-31,45,22
443,Cambridge Utd,12,8,26,41,69,-28,44,23
443,FG Rovers,7,9,30,35,94,-59,30,24
444,Sheffield Weds,32,11,3,85,30,55,107,1
444,Ipswich Town,27,13,6,92,39,53,94,2
444,Plymouth Argyle,26,11,9,79,51,28,89,3
444,Bolton,24,12,10,64,32,32,84,4
444,Derby County,24,12,10,75,44,31,84,5
444,Barnsley,24,9,13,66,40,26,81,6
444,P'borough Utd,23,6,17,76,58,18,75,7
444,Wycombe,20,11,15,56,43,13,71,8
444,Portsmouth,18,16,12,60,48,12,70,9
444,Charlton Ath,19,11,16,64,59,5,68,10
444,Shrewsbury,20,7,19,57,46,11,67,11
444,Lincoln City,15,20,11,44,42,2,65,12
444,Exeter City,15,14,17,58,61,-3,59,13
444,Port Vale,16,11,19,53,64,-11,59,14
444,Fleetwood Town,14,16,16,50,47,3,58,15
444,Oxford United,12,12,22,50,64,-14,48,16
444,Bristol Rovers,12,12,22,57,83,-26,48,17
444,Burton Albion,11,13,22,52,81,-29,46,18
444,Cheltenham,12,9,25,36,65,-29,45,19
444,Cambridge Utd,11,10,25,39,72,-33,43,20
444,MK Dons,11,9,26,41,69,-28,42,21
444,Morecambe,9,14,23,45,72,-27,41,22
444,Acc'ton Stanley,9,14,23,35,72,-37,41,23
444,FG Rovers,6,11,29,36,88,-52,29,24
445,Sheffield Weds,31,10,5,88,31,57,103,1
445,Plymouth Argyle,30,9,7,96,54,42,99,2
445,Ipswich Town,26,13,7,87,44,43,91,3
445,Bolton,25,9,12,70,36,34,84,4
445,Barnsley,23,12,11,69,45,24,81,5
445,Wycombe,24,9,13,64,40,24,81,6
445,Derby County,22,12,12,76,48,28,78,7
445,P'borough Utd,24,5,17,80,57,23,77,8
445,Portsmouth,18,14,14,64,54,10,68,9
445,Shrewsbury,19,9,18,55,54,1,66,10
445,Fleetwood Town,15,15,16,51,46,5,60,11
445,Charlton Ath,15,14,17,65,60,5,59,12
445,Lincoln City,13,19,14,45,52,-7,58,13
445,Exeter City,15,11,20,56,65,-9,56,14
445,Port Vale,15,11,20,46,66,-20,56,15
445,Bristol Rovers,14,11,21,65,81,-16,53,16
445,Oxford United,13,13,20,45,53,-8,52,17
445,Cheltenham,14,9,23,39,59,-20,51,18
445,Burton Albion,14,9,23,53,86,-33,51,19
445,Morecambe,12,11,23,47,74,-27,47,20
445,MK Dons,11,9,26,41,68,-27,42,21
445,Cambridge Utd,10,9,27,36,72,-36,39,22
445,Acc'ton Stanley,8,14,24,34,76,-42,38,23
445,FG Rovers,7,11,28,36,87,-51,32,24
446,Plymouth Argyle,28,12,6,81,48,33,96,1
446,Sheffield Weds,28,11,7,76,31,45,95,2
446,Ipswich Town,27,13,6,92,44,48,94,3
446,Derby County,26,11,9,74,39,35,89,4
446,Barnsley,26,9,11,69,40,29,87,5
446,Bolton,23,11,12,70,41,29,80,6
446,Wycombe,23,7,16,72,46,26,76,7
446,P'borough Utd,22,6,18,78,62,16,72,8
446,Shrewsbury,19,12,15,53,46,7,69,9
446,Portsmouth,17,17,12,66,52,14,68,10
446,Charlton Ath,17,13,16,73,62,11,64,11
446,Exeter City,17,12,17,65,58,7,63,12
446,Fleetwood Town,14,19,13,50,48,2,61,13
446,Port Vale,15,11,20,49,64,-15,56,14
446,Lincoln City,10,24,12,42,53,-11,54,15
446,Bristol Rovers,14,12,20,61,76,-15,54,16
446,Oxford United,11,16,19,46,57,-11,49,17
446,MK Dons,13,9,24,49,72,-23,48,18
446,Burton Albion,12,11,23,56,84,-28,47,19
446,Acc'ton Stanley,10,14,22,40,72,-32,44,20
446,Morecambe,10,11,25,51,79,-28,41,21
446,Cheltenham,10,11,25,36,67,-31,41,22
446,Cambridge Utd,11,5,30,38,84,-46,38,23
446,FG Rovers,6,9,31,30,92,-62,27,24
447,Sheffield Weds,31,10,5,89,31,58,103,1
447,Plymouth Argyle,29,10,7,86,50,36,97,2
447,Ipswich Town,26,14,6,86,45,41,92,3
447,Barnsley,27,8,11,70,39,31,89,4
447,Derby County,22,13,11,76,43,33,79,5
447,Wycombe,22,12,12,64,42,22,78,6
447,P'borough Utd,24,4,18,84,67,17,76,7
447,Bolton,21,12,13,62,39,23,75,8
447,Portsmouth,18,14,14,66,56,10,68,9
447,Charlton Ath,16,16,14,66,53,13,64,10
447,Shrewsbury,18,6,22,55,62,-7,60,11
447,Bristol Rovers,15,14,17,66,74,-8,59,12
447,Port Vale,16,11,19,53,67,-14,59,13
447,Lincoln City,13,19,14,46,47,-1,58,14
447,Fleetwood Town,13,16,17,54,52,2,55,15
447,Exeter City,14,13,19,56,65,-9,55,16
447,MK Dons,14,7,25,47,66,-19,49,17
447,Acc'ton Stanley,12,13,21,37,65,-28,49,18
447,Burton Albion,12,12,22,58,84,-26,48,19
447,Morecambe,12,12,22,46,73,-27,48,20
447,Cheltenham,11,11,24,31,63,-32,44,21
447,Oxford United,9,13,24,48,72,-24,40,22
447,FG Rovers,9,11,26,39,86,-47,38,23
447,Cambridge Utd,8,9,29,32,76,-44,33,24
448,Sheffield Weds,29,12,5,79,33,46,99,1
448,Plymouth Argyle,28,10,8,93,53,40,94,2
448,Bolton,26,10,10,71,38,33,88,3
448,Derby County,24,11,11,78,44,34,83,4
448,Barnsley,24,11,11,69,40,29,83,5
448,P'borough Utd,25,5,16,81,60,21,80,6
448,Wycombe,23,10,13,67,42,25,79,7
448,Portsmouth,20,17,9,74,52,22,77,8
448,Ipswich Town,20,16,10,79,48,31,76,9
448,Shrewsbury,18,11,17,56,58,-2,65,10
448,Exeter City,18,9,19,62,58,4,63,11
448,Charlton Ath,16,14,16,63,58,5,62,12
448,Fleetwood Town,14,18,14,44,43,1,60,13
448,Port Vale,15,11,20,51,64,-13,56,14
448,Lincoln City,11,22,13,43,49,-6,55,15
448,Oxford United,13,13,20,48,56,-8,52,16
448,Bristol Rovers,13,12,21,61,81,-20,51,17
448,Burton Albion,13,12,21,55,80,-25,51,18
448,Acc'ton Stanley,11,14,21,40,64,-24,47,19
448,Cheltenham,12,10,24,35,62,-27,46,20
448,MK Dons,11,11,24,38,65,-27,44,21
448,Morecambe,9,12,25,46,82,-36,39,22
448,Cambridge Utd,10,6,30,37,84,-47,36,23
448,FG Rovers,5,11,30,34,90,-56,26,24
449,Sheffield Weds,33,10,3,92,27,65,109,1
449,Plymouth Argyle,30,10,6,87,49,38,100,2
449,Ipswich Town,27,15,4,91,42,49,96,3
449,Barnsley,27,9,10,79,41,38,90,4
449,Wycombe,25,9,12,61,38,23,84,5
449,Bolton,23,12,11,64,37,27,81,6
449,Derby County,23,11,12,68,41,27,80,7
449,P'borough Utd,23,6,17,74,63,11,75,8
449,Portsmouth,18,15,13,62,53,9,69,9
449,Fleetwood Town,16,16,14,51,45,6,64,10
449,Shrewsbury,18,10,18,53,52,1,64,11
449,Charlton Ath,16,13,17,61,61,0,61,12
449,Lincoln City,12,19,15,44,52,-8,55,13
449,Port Vale,15,10,21,47,66,-19,55,14
449,Bristol Rovers,14,12,20,67,83,-16,54,15
449,Exeter City,14,11,21,61,62,-1,53,16
449,Oxford United,14,10,22,51,56,-5,52,17
449,Cheltenham,12,9,25,34,65,-31,45,18
449,Acc'ton Stanley,10,15,21,36,68,-32,45,19
449,Burton Albion,12,9,25,52,88,-36,45,20
449,MK Dons,11,10,25,49,70,-21,43,21
449,Cambridge Utd,10,7,29,38,79,-41,37,22
449,Morecambe,8,11,27,38,78,-40,35,23
449,FG Rovers,6,11,29,37,81,-44,29,24
450,Sheffield Weds,29,13,4,75,26,49,100,1
450,Plymouth Argyle,26,10,10,81,48,33,88,2
450,Ipswich Town,24,15,7,79,39,40,87,3
450,Wycombe,25,9,12,69,40,29,84,4
450,Barnsley,25,9,12,67,46,21,84,5
450,Bolton,24,10,12,63,37,26,82,6
450,Derby County,23,13,10,67,46,21,82,7
450,P'borough Utd,25,5,16,82,55,27,80,8
450,Charlton Ath,20,12,14,69,56,13,72,9
450,Portsmouth,17,16,13,68,59,9,67,10
450,Shrewsbury,20,7,19,55,50,5,67,11
450,Fleetwood Town,16,16,14,54,45,9,64,12
450,Exeter City,15,15,16,57,56,1,60,13
450,Lincoln City,11,22,13,40,48,-8,55,14
450,Bristol Rovers,14,11,21,66,78,-12,53,15
450,Port Vale,13,12,21,48,72,-24,51,16
450,Cambridge Utd,14,6,26,44,72,-28,48,17
450,Morecambe,11,14,21,48,70,-22,47,18
450,Cheltenham,12,11,23,36,65,-29,47,19
450,Oxford United,10,16,20,45,61,-16,46,20
450,Burton Albion,11,11,24,57,86,-29,44,21
450,MK Dons,10,9,27,43,70,-27,39,22
450,Acc'ton Stanley,7,15,24,33,71,-38,36,23
450,FG Rovers,6,11,29,37,87,-50,29,24
451,Sheffield Weds,28,13,5,77,31,46,97,1
451,Plymouth Argyle,27,11,8,81,53,28,92,2
451,Ipswich Town,24,15,7,96,44,52,87,3
451,Barnsley,26,9,11,74,42,32,87,4
451,Bolton,23,11,12,67,39,28,80,5
451,Wycombe,24,8,14,64,40,24,80,6
451,Derby County,21,13,12,75,50,25,76,7
451,P'borough Utd,22,4,20,80,61,19,70,8
451,Portsmouth,17,19,10,65,53,12,70,9
451,Fleetwood Town,18,15,13,52,43,9,69,10
451,Shrewsbury,20,9,17,60,56,4,69,11
451,Charlton Ath,15,16,15,62,62,0,61,12
451,Lincoln City,12,24,10,45,44,1,60,13
451,Exeter City,16,11,19,54,62,-8,59,14
451,Bristol Rovers,15,10,21,65,79,-14,55,15
451,Port Vale,14,11,21,44,63,-19,53,16
451,Oxford United,13,13,20,51,60,-9,52,17
451,Burton Albion,13,12,21,63,90,-27,51,18
451,Acc'ton Stanley,11,14,21,42,69,-27,47,19
451,Morecambe,9,17,20,51,74,-23,44,20
451,Cheltenham,10,13,23,32,64,-32,43,21
451,MK Dons,9,11,26,40,70,-30,38,22
451,Cambridge Utd,9,8,29,35,76,-41,35,23
451,FG Rovers,7,11,28,37,87,-50,32,24
452,Plymouth Argyle,29,11,6,89,47,42,98,1
452,Sheffield Weds,28,12,6,81,34,47,96,2
452,Ipswich Town,26,16,4,82,38,44,94,3
452,Barnsley,27,11,8,72,34,38,92,4
452,Bolton,25,11,10,73,39,34,86,5
452,Derby County,25,9,12,80,47,33,84,6
452,P'borough Utd,24,6,16,81,59,22,78,7
452,Wycombe,21,9,16,60,45,15,72,8
452,Portsmouth,17,18,11,61,48,13,69,9
452,Shrewsbury,20,7,19,57,53,4,67,10
452,Lincoln City,15,20,11,50,46,4,65,11
452,Charlton Ath,15,17,14,58,53,5,62,12
452,Fleetwood Town,14,18,14,46,43,3,60,13
452,Exeter City,15,12,19,59,63,-4,57,14
452,Bristol Rovers,14,12,20,59,76,-17,54,15
452,Port Vale,13,12,21,46,67,-21,51,16
452,Cheltenham,14,9,23,37,58,-21,51,17
452,Burton Albion,12,10,24,52,86,-34,46,18
452,Acc'ton Stanley,10,14,22,41,65,-24,44,19
452,Oxford United,10,12,24,43,62,-19,42,20
452,Cambridge Utd,11,9,26,36,67,-31,42,21
452,Morecambe,9,11,26,42,82,-40,38,22
452,MK Dons,9,9,28,37,72,-35,36,23
452,FG Rovers,7,9,30,37,95,-58,30,24
453,Sheffield Weds,30,11,5,81,30,51,101,1
453,Plymouth Argyle,29,11,6,84,47,37,98,2
453,Barnsley,28,7,11,78,44,34,91,3
453,Ipswich Town,24,15,7,85,45,40,87,4
453,Derby County,25,11,10,75,39,36,86,5
453,Bolton,23,13,10,64,32,32,82,6
453,P'borough Utd,22,6,18,70,54,16,72,7
453,Wycombe,21,8,17,59,46,13,71,8
453,Shrewsbury,20,9,17,56,49,7,69,9
453,Lincoln City,15,22,9,50,45,5,67,10
453,Portsmouth,16,16,14,59,55,4,64,11
453,Charlton Ath,14,17,15,66,63,3,59,12
453,Fleetwood Town,14,16,16,47,47,0,58,13
453,Exeter City,15,12,19,60,64,-4,57,14
453,Bristol Rovers,16,8,22,61,79,-18,56,15
453,Port Vale,15,11,20,46,66,-20,56,16
453,Oxford United,12,13,21,46,54,-8,49,17
453,Cheltenham,13,10,23,35,58,-23,49,18
453,Acc'ton Stanley,10,14,22,45,70,-25,44,19
453,Cambridge Utd,11,11,24,40,70,-30,44,20
453,Burton Albion,10,14,22,52,83,-31,44,21
453,Morecambe,8,16,22,43,75,-32,40,22
453,MK Dons,9,10,27,41,75,-34,37,23
453,FG Rovers,7,9,30,40,93,-53,30,24
454,Sheffield Weds,29,12,5,80,30,50,99,1
454,Ipswich Town,25,14,7,81,45,36,89,2
454,Plymouth Argyle,25,13,8,87,60,27,88,3
454,Barnsley,23,12,11,73,45,28,81,4
454,Wycombe,24,7,15,63,42,21,79,5
454,Derby County,21,15,10,66,41,25,78,6
454,Bolton,22,11,13,65,40,25,77,7
454,Shrewsbury,20,7,19,52,48,4,67,8
454,Fleetwood Town,16,16,14,50,44,6,64,9
454,P'borough Utd,18,8,20,66,59,7,62,10
454,Portsmouth,15,17,14,59,55,4,62,11
454,Bristol Rovers,17,10,19,71,81,-10,61,12
454,Port Vale,16,11,19,53,60,-7,59,13
454,Lincoln City,12,22,12,42,44,-2,58,14
454,Exeter City,16,10,20,57,61,-4,58,15
454,Charlton Ath,14,15,17,63,63,0,57,16
454,Cheltenham,15,9,22,39,57,-18,54,17
454,Oxford United,12,14,20,45,56,-11,50,18
454,Acc'ton Stanley,12,13,21,39,66,-27,49,19
454,MK Dons,12,11,23,44,67,-23,47,20
454,Burton Albion,12,11,23,52,81,-29,47,21
454,Morecambe,10,16,20,49,71,-22,46,22
454,Cambridge Utd,11,9,26,38,77,-39,42,23
454,FG Rovers,7,13,26,35,76,-41,34,24
455,Sheffield Weds,32,9,5,90,33,57,105,1
455,Plymouth Argyle,28,13,5,92,48,44,97,2
455,Ipswich Town,25,14,7,90,43,47,89,3
455,Bolton,25,11,10,73,33,40,86,4
455,Barnsley,25,11,10,73,43,30,86,5
455,Derby County,23,12,11,71,45,26,81,6
455,Wycombe,25,5,16,66,47,19,80,7
455,P'borough Utd,22,6,18,76,59,17,72,8
455,Shrewsbury,21,7,18,63,53,10,70,9
455,Fleetwood Town,17,15,14,56,45,11,66,10
455,Portsmouth,15,16,15,58,59,-1,61,11
455,Lincoln City,12,23,11,45,45,0,59,12
455,Charlton Ath,15,12,19,69,71,-2,57,13
455,Bristol Rovers,14,13,19,65,75,-10,55,14
455,Port Vale,13,13,20,46,67,-21,52,15
455,Burton Albion,13,13,20,56,78,-22,52,16
455,Acc'ton Stanley,13,13,20,41,71,-30,52,17
455,Exeter City,13,12,21,55,69,-14,51,18
455,Morecambe,11,14,21,52,77,-25,47,19
455,Oxford United,11,13,22,43,60,-17,46,20
455,MK Dons,11,11,24,46,68,-22,44,21
455,Cheltenham,10,10,26,28,64,-36,40,22
455,Cambridge Utd,10,5,31,38,87,-49,35,23
455,FG Rovers,8,9,29,34,86,-52,33,24
456,Sheffield Weds,31,9,6,89,33,56,102,1
456,Ipswich Town,28,13,5,85,41,44,97,2
456,Plymouth Argyle,26,13,7,84,52,32,91,3
456,Bolton,27,9,10,75,35,40,90,4
456,Derby County,25,11,10,70,39,31,86,5
456,Barnsley,23,12,11,68,40,28,81,6
456,P'borough Utd,24,7,15,84,52,32,79,7
456,Wycombe,20,9,17,61,47,14,69,8
456,Portsmouth,17,17,12,62,55,7,68,9
456,Fleetwood Town,17,13,16,50,46,4,64,10
456,Shrewsbury,18,9,19,54,53,1,63,11
456,Lincoln City,15,18,13,51,50,1,63,12
456,Charlton Ath,14,14,18,60,64,-4,56,13
456,Port Vale,15,10,21,47,67,-20,55,14
456,Oxford United,14,12,20,52,60,-8,54,15
456,Bristol Rovers,14,12,20,66,82,-16,54,16
456,Exeter City,14,10,22,57,63,-6,52,17
456,Burton Albion,13,10,23,60,94,-34,49,18
456,Acc'ton Stanley,11,15,20,42,72,-30,48,19
456,Cheltenham,12,9,25,36,65,-29,45,20
456,Cambridge Utd,11,10,25,40,74,-34,43,21
456,MK Dons,10,8,28,41,71,-30,38,22
456,Morecambe,8,13,25,42,75,-33,37,23
456,FG Rovers,8,11,27,39,85,-46,35,24
457,Plymouth Argyle,31,9,6,92,44,48,102,1
457,Sheffield Weds,30,10,6,90,33,57,100,2
457,Derby County,25,13,8,75,40,35,88,3
457,Barnsley,26,10,10,76,42,34,88,4
457,Bolton,26,10,10,70,36,34,88,5
457,Ipswich Town,23,16,7,85,43,42,85,6
457,Wycombe,24,7,15,66,48,18,79,7
457,P'borough Utd,23,5,18,75,55,20,74,8
457,Portsmouth,17,17,12,72,58,14,68,9
457,Shrewsbury,19,9,18,54,52,2,66,10
457,Fleetwood Town,15,19,12,55,45,10,64,11
457,Lincoln City,14,18,14,51,54,-3,60,12
457,Bristol Rovers,15,12,19,69,82,-13,57,13
457,Charlton Ath,14,14,18,60,63,-3,56,14
457,Exeter City,13,16,17,54,63,-9,55,15
457,Port Vale,14,10,22,45,65,-20,52,16
457,Oxford United,12,14,20,47,58,-11,50,17
457,Cambridge Utd,14,6,26,38,70,-32,48,18
457,MK Dons,11,9,26,44,71,-27,42,19
457,Burton Albion,11,9,26,52,86,-34,42,20
457,Morecambe,10,12,24,43,78,-35,42,21
457,Cheltenham,10,11,25,31,68,-37,41,22
457,Acc'ton Stanley,8,16,22,33,69,-36,40,23
457,FG Rovers,6,10,30,36,90,-54,28,24
458,Plymouth Argyle,30,10,6,86,46,40,100,1
458,Sheffield Weds,28,10,8,87,34,53,94,2
458,Ipswich Town,25,14,7,95,48,47,89,3
458,Barnsley,25,11,10,68,37,31,86,4
458,Derby County,23,14,9,77,40,37,83,5
458,Bolton,24,11,11,68,39,29,83,6
458,Portsmouth,20,17,9,72,48,24,77,7
458,P'borough Utd,23,8,15,74,54,20,77,8
458,Wycombe,20,12,14,66,47,19,72,9
458,Charlton Ath,17,13,16,68,66,2,64,10
458,Lincoln City,14,21,11,48,47,1,63,11
458,Shrewsbury,17,11,18,51,50,1,62,12
458,Fleetwood Town,13,18,15,46,44,2,57,13
458,Exeter City,15,12,19,59,68,-9,57,14
458,Bristol Rovers,15,12,19,62,76,-14,57,15
458,Port Vale,15,10,21,51,73,-22,55,16
458,MK Dons,13,9,24,43,64,-21,48,17
458,Cheltenham,13,9,24,37,60,-23,48,18
458,Oxford United,11,14,21,44,59,-15,47,19
458,Burton Albion,12,9,25,54,90,-36,45,20
458,Acc'ton Stanley,9,13,24,39,80,-41,40,21
458,Morecambe,9,11,26,41,80,-39,38,22
458,Cambridge Utd,10,6,30,37,80,-43,36,23
458,FG Rovers,7,13,26,38,81,-43,34,24
459,Sheffield Weds,31,10,5,89,32,57,103,1
459,Plymouth Argyle,30,10,6,85,46,39,100,2
459,Barnsley,27,8,11,78,43,35,89,3
459,Ipswich Town,22,17,7,75,43,32,83,4
459,Wycombe,23,11,12,65,37,28,80,5
459,Bolton,22,13,11,69,44,25,79,6
459,Derby County,22,11,13,73,46,27,77,7
459,Portsmouth,21,14,11,64,49,15,77,8
459,Shrewsbury,22,8,16,58,51,7,74,9
459,P'borough Utd,21,6,19,73,61,12,69,10
459,Fleetwood Town,16,14,16,49,47,2,62,11
459,Charlton Ath,15,15,16,66,58,8,60,12
459,Lincoln City,12,22,12,41,44,-3,58,13
459,Exeter City,14,15,17,55,57,-2,57,14
459,Bristol Rovers,14,12,20,68,81,-13,54,15
459,Port Vale,14,11,21,51,68,-17,53,16
459,Cheltenham,13,12,21,34,56,-22,51,17
459,Morecambe,10,18,18,45,65,-20,48,18
459,Burton Albion,11,13,22,57,84,-27,46,19
459,Oxford United,11,12,23,44,62,-18,45,20
459,Cambridge Utd,11,9,26,49,79,-30,42,21
459,Acc'ton Stanley,9,12,25,33,71,-38,39,22
459,MK Dons,10,7,29,45,79,-34,37,23
459,FG Rovers,6,10,30,29,92,-63,28,24
460,Sheffield Weds,32,11,3,81,28,53,107,1
460,Plymouth Argyle,29,10,7,87,48,39,97,2
460,Barnsley,27,10,9,73,41,32,91,3
460,Ipswich Town,24,16,6,86,40,46,88,4
460,Wycombe,25,7,14,74,40,34,82,5
460,Bolton,23,11,12,64,39,25,80,6
460,Derby County,22,12,12,74,47,27,78,7
460,Portsmouth,21,15,10,69,53,16,78,8
460,P'borough Utd,21,8,17,73,54,19,71,9
460,Charlton Ath,16,16,14,67,54,13,64,10
460,Shrewsbury,17,10,19,49,50,-1,61,11
460,Fleetwood Town,15,15,16,50,51,-1,60,12
460,Exeter City,14,14,18,58,66,-8,56,13
460,Lincoln City,10,23,13,41,44,-3,53,14
460,Oxford United,13,12,21,47,57,-10,51,15
460,Cheltenham,13,12,21,34,55,-21,51,16
460,Bristol Rovers,12,12,22,60,82,-22,48,17
460,Port Vale,13,9,24,44,71,-27,48,18
460,Burton Albion,12,12,22,56,88,-32,48,19
460,Cambridge Utd,12,11,23,40,69,-29,47,20
460,Acc'ton Stanley,10,13,23,39,70,-31,43,21
460,Morecambe,9,13,24,46,83,-37,40,22
460,MK Dons,9,10,27,37,70,-33,37,23
460,FG Rovers,7,10,29,39,88,-49,31,24
461,Sheffield Weds,31,12,3,84,27,57,105,1
461,Plymouth Argyle,28,10,8,92,55,37,94,2
461,Ipswich Town,26,14,6,86,40,46,92,3
461,Bolton,26,10,10,73,33,40,88,4
461,Derby County,21,16,9,70,42,28,79,5
461,P'borough Utd,24,6,16,75,54,21,78,6
461,Wycombe,22,11,13,59,42,17,77,7
461,Portsmouth,20,16,10,72,50,22,76,8
461,Barnsley,20,13,13,67,49,18,73,9
461,Shrewsbury,18,9,19,54,53,1,63,10
461,Charlton Ath,17,11,18,66,60,6,62,11
461,Exeter City,16,11,19,60,57,3,59,12
461,Lincoln City,12,23,11,47,44,3,59,13
461,Fleetwood Town,13,19,14,46,46,0,58,14
461,Port Vale,15,10,21,46,62,-16,55,15
461,Bristol Rovers,12,13,21,61,79,-18,49,16
461,Morecambe,11,13,22,47,75,-28,46,17
461,Burton Albion,12,10,24,57,92,-35,46,18
461,Cambridge Utd,13,6,27,35,74,-39,45,19
461,Cheltenham,11,11,24,35,65,-30,44,20
461,Oxford United,9,16,21,44,61,-17,43,21
461,MK Dons,11,10,25,43,72,-29,43,22
461,Acc'ton Stanley,10,12,24,38,81,-43,42,23
461,FG Rovers,6,14,26,38,82,-44,32,24
462,Sheffield Weds,29,9,8,78,38,40,96,1
462,Plymouth Argyle,28,10,8,88,52,36,94,2
462,Ipswich Town,25,16,5,81,37,44,91,3
462,Derby County,25,13,8,73,37,36,88,4
462,Barnsley,25,8,13,77,47,30,83,5
462,Wycombe,25,6,15,67,41,26,81,6
462,Bolton,23,11,12,64,38,26,80,7
462,Shrewsbury,20,9,17,56,46,10,69,8
462,P'borough Utd,21,4,21,68,59,9,67,9
462,Exeter City,17,14,15,61,58,3,65,10
462,Portsmouth,14,18,14,54,55,-1,60,11
462,Port Vale,17,9,20,50,64,-14,60,12
462,Fleetwood Town,14,17,15,48,48,0,59,13
462,Charlton Ath,15,14,17,61,64,-3,59,14
462,Lincoln City,11,22,13,47,52,-5,55,15
462,Bristol Rovers,13,12,21,63,75,-12,51,16
462,Acc'ton Stanley,12,15,19,43,63,-20,51,17
462,Burton Albion,12,12,22,57,82,-25,48,18
462,Oxford United,11,13,22,42,57,-15,46,19
462,Morecambe,11,13,22,47,71,-24,46,20
462,MK Dons,12,9,25,42,66,-24,45,21
462,Cheltenham,11,12,23,33,60,-27,45,22
462,Cambridge Utd,11,8,27,40,79,-39,41,23
462,FG Rovers,7,12,27,33,84,-51,33,24
463,Sheffield Weds,32,9,5,82,30,52,105,1
463,Plymouth Argyle,27,11,8,85,54,31,92,2
463,Ipswich Town,22,18,6,85,45,40,84,3
463,Barnsley,25,8,13,72,45,27,83,4
463,Portsmouth,23,13,10,79,48,31,82,5
463,Bolton,23,13,10,65,35,30,82,6
463,Derby County,23,11,12,70,40,30,80,7
463,Wycombe,22,9,15,65,46,19,75,8
463,P'borough Utd,22,7,17,76,57,19,73,9
463,Charlton Ath,18,15,13,68,57,11,69,10
463,Fleetwood Town,16,15,15,50,44,6,63,11
463,Shrewsbury,18,9,19,57,54,3,63,12
463,Oxford United,16,10,20,52,59,-7,58,13
463,Lincoln City,12,21,13,40,48,-8,57,14
463,Exeter City,14,14,18,57,58,-1,56,15
463,Bristol Rovers,14,12,20,60,76,-16,54,16
463,Burton Albion,13,10,23,58,84,-26,49,17
463,Cambridge Utd,13,10,23,41,68,-27,49,18
463,Port Vale,12,12,22,43,65,-22,48,19
463,MK Dons,13,7,26,45,74,-29,46,20
463,Cheltenham,11,10,25,35,63,-28,43,21
463,Acc'ton Stanley,10,13,23,40,76,-36,43,22
463,Morecambe,7,12,27,38,78,-40,33,23
463,FG Rovers,6,11,29,34,93,-59,29,24
464,Sheffield Weds,30,11,5,79,28,51,101,1
464,Plymouth Argyle,25,12,9,81,52,29,87,2
464,Derby County,24,14,8,79,39,40,86,3
464,Bolton,26,8,12,72,42,30,86,4
464,Barnsley,25,10,11,72,39,33,85,5
464,Ipswich Town,22,15,9,82,48,34,81,6
464,Wycombe,23,11,12,71,44,27,80,7
464,P'borough Utd,24,6,16,83,52,31,78,8
464,Portsmouth,18,15,13,63,55,8,69,9
464,Shrewsbury,18,12,16,49,45,4,66,10
464,Exeter City,17,12,17,58,56,2,63,11
464,Bristol Rovers,16,12,18,66,68,-2,60,12
464,Lincoln City,11,23,12,43,47,-4,56,13
464,Fleetwood Town,14,13,19,51,52,-1,55,14
464,Charlton Ath,13,15,18,63,67,-4,54,15
464,Port Vale,13,11,22,42,70,-28,50,16
464,Oxford United,12,13,21,47,60,-13,49,17
464,Cheltenham,13,10,23,40,62,-22,49,18
464,Burton Albion,13,10,23,58,90,-32,49,19
464,MK Dons,12,9,25,40,66,-26,45,20
464,Acc'ton Stanley,11,12,23,38,71,-33,45,21
464,Morecambe,9,16,21,44,75,-31,43,22
464,Cambridge Utd,10,10,26,36,75,-39,40,23
464,FG Rovers,7,12,27,33,87,-54,33,24
465,Sheffield Weds,27,12,7,76,32,44,93,1
465,Plymouth Argyle,27,11,8,86,47,39,92,2
465,Barnsley,28,8,10,74,36,38,92,3
465,Ipswich Town,24,15,7,82,44,38,87,4
465,Bolton,25,10,11,63,34,29,85,5
465,Derby County,23,12,11,74,45,29,81,6
465,Wycombe,21,12,13,59,39,20,75,7
465,Shrewsbury,22,9,15,60,46,14,75,8
465,Portsmouth,18,14,14,67,50,17,68,9
465,Charlton Ath,18,14,14,68,57,11,68,10
465,P'borough Utd,20,7,19,67,58,9,67,11
465,Fleetwood Town,14,17,15,46,45,1,59,12
465,Port Vale,16,10,20,49,60,-11,58,13
465,Exeter City,13,17,16,56,61,-5,56,14
465,Lincoln City,12,20,14,42,47,-5,56,15
465,Acc'ton Stanley,13,14,19,42,69,-27,53,16
465,Bristol Rovers,14,10,22,65,83,-18,52,17
465,Burton Albion,13,12,21,57,85,-28,51,18
465,Morecambe,12,13,21,45,73,-28,49,19
465,Oxford United,11,12,23,44,62,-18,45,20
465,Cheltenham,12,9,25,33,65,-32,45,21
465,MK Dons,10,8,28,45,73,-28,38,22
465,Cambridge Utd,9,10,27,31,71,-40,37,23
465,FG Rovers,7,10,29,33,82,-49,31,24
466,Sheffield Weds,28,13,5,83,32,51,97,1
466,Ipswich Town,26,14,6,86,41,45,92,2
466,Plymouth Argyle,27,10,9,83,55,28,91,3
466,Derby County,25,10,11,74,43,31,85,4
466,Barnsley,26,7,13,74,43,31,85,5
466,Bolton,24,11,11,65,34,31,83,6
466,Wycombe,23,8,15,69,44,25,77,7
466,Portsmouth,17,16,13,58,53,5,67,8
466,Shrewsbury,19,8,19,58,50,8,65,9
466,P'borough Utd,20,5,21,67,64,3,65,10
466,Lincoln City,14,22,10,46,42,4,64,11
466,Charlton Ath,17,12,17,69,66,3,63,12
466,Exeter City,17,10,19,58,61,-3,61,13
466,Burton Albion,15,11,20,56,81,-25,56,14
466,Fleetwood Town,12,17,17,45,48,-3,53,15
466,Bristol Rovers,14,11,21,65,72,-7,53,16
466,Oxford United,13,12,21,48,58,-10,51,17
466,Port Vale,13,12,21,43,70,-27,51,18
466,Cheltenham,14,8,24,35,58,-23,50,19
466,Cambridge Utd,14,7,25,42,65,-23,49,20
466,MK Dons,11,11,24,46,70,-24,44,21
466,Morecambe,10,12,24,47,83,-36,42,22
466,Acc'ton Stanley,9,14,23,39,73,-34,41,23
466,FG Rovers,8,11,27,34,84,-50,35,24
467,Plymouth Argyle,30,10,6,89,47,42,100,1
467,Sheffield Weds,27,14,5,85,31,54,95,2
467,Ipswich Town,24,16,6,83,39,44,88,3
467,Barnsley,26,7,13,69,42,27,85,4
467,Wycombe,25,8,13,66,41,25,83,5
467,Bolton,24,10,12,64,43,21,82,6
467,Derby County,22,15,9,67,37,30,81,7
467,Portsmouth,19,17,10,63,49,14,74,8
467,P'borough Utd,20,9,17,74,56,18,69,9
467,Charlton Ath,17,13,16,67,63,4,64,10
467,Shrewsbury,16,15,15,46,42,4,63,11
467,Lincoln City,12,22,12,44,49,-5,58,12
467,Burton Albion,14,15,17,57,71,-14,57,13
467,Exeter City,15,11,20,58,66,-8,56,14
467,Port Vale,16,8,22,45,63,-18,56,15
467,Fleetwood Town,13,15,18,45,49,-4,54,16
467,Bristol Rovers,14,10,22,58,79,-21,52,17
467,Cheltenham,14,8,24,35,60,-25,50,18
467,Oxford United,12,12,22,52,62,-10,48,19
467,Morecambe,11,12,23,48,72,-24,45,20
467,Acc'ton Stanley,11,11,24,44,78,-34,44,21
467,MK Dons,11,8,27,42,67,-25,41,22
467,Cambridge Utd,10,10,26,36,71,-35,40,23
467,FG Rovers,7,8,31,35,95,-60,29,24
468,Sheffield Weds,29,11,6,79,33,46,98,1
468,Plymouth Argyle,30,8,8,92,51,41,98,2
468,Derby County,24,14,8,73,37,36,86,3
468,Ipswich Town,23,16,7,82,47,35,85,4
468,Barnsley,23,10,13,67,41,26,79,5
468,Wycombe,24,7,15,63,44,19,79,6
468,Bolton,23,9,14,64,37,27,78,7
468,Shrewsbury,23,8,15,60,47,13,77,8
468,Portsmouth,20,14,12,63,45,18,74,9
468,P'borough Utd,22,6,18,76,56,20,72,10
468,Exeter City,19,12,15,72,57,15,69,11
468,Charlton Ath,17,14,15,68,59,9,65,12
468,Fleetwood Town,15,14,17,47,46,1,59,13
468,Lincoln City,12,17,17,43,60,-17,53,14
468,Port Vale,14,11,21,46,65,-19,53,15
468,Oxford United,13,13,20,44,58,-14,52,16
468,Cheltenham,15,7,24,40,61,-21,52,17
468,Bristol Rovers,14,9,23,61,83,-22,51,18
468,Cambridge Utd,11,12,23,40,71,-31,45,19
468,Burton Albion,11,12,23,57,90,-33,45,20
468,Acc'ton Stanley,10,14,22,38,69,-31,44,21
468,MK Dons,9,11,26,39,69,-30,38,22
468,Morecambe,8,12,26,39,74,-35,36,23
468,FG Rovers,7,11,28,34,87,-53,32,24
469,Sheffield Weds,31,12,3,88,28,60,105,1
469,Plymouth Argyle,27,10,9,81,48,33,91,2
469,Ipswich Town,23,19,4,94,45,49,88,3
469,Barnsley,24,12,10,69,43,26,84,4
469,Bolton,24,11,11,68,36,32,83,5
469,Derby County,22,13,11,73,42,31,79,6
469,Wycombe,23,9,14,65,46,19,78,7
469,Portsmouth,19,17,10,65,47,18,74,8
469,P'borough Utd,19,7,20,73,68,5,64,9
469,Fleetwood Town,15,18,13,50,42,8,63,10
469,Shrewsbury,18,9,19,52,52,0,63,11
469,Exeter City,16,14,16,68,62,6,62,12
469,Charlton Ath,16,13,17,67,66,1,61,13
469,Oxford United,14,14,18,50,57,-7,56,14
469,Bristol Rovers,14,14,18,67,75,-8,56,15
469,Lincoln City,11,21,14,42,48,-6,54,16
469,Port Vale,13,12,21,46,66,-20,51,17
469,Cheltenham,14,9,23,36,61,-25,51,18
469,MK Dons,13,9,24,42,63,-21,48,19
469,Cambridge Utd,11,9,26,41,75,-34,42,20
469,Acc'ton Stanley,9,15,22,43,81,-38,42,21
469,Burton Albion,11,8,27,48,92,-44,41,22
469,Morecambe,9,13,24,45,80,-35,40,23
469,FG Rovers,7,10,29,36,86,-50,31,24
470,Sheffield Weds,28,12,6,80,35,45,96,1
470,Plymouth Argyle,28,10,8,85,49,36,94,2
470,Ipswich Town,24,14,8,84,44,40,86,3
470,Bolton,25,10,11,65,30,35,85,4
470,Derby County,23,13,10,71,38,33,82,5
470,Barnsley,24,10,12,63,38,25,82,6
470,P'borough Utd,24,6,16,79,55,24,78,7
470,Wycombe,23,9,14,66,49,17,78,8
470,Portsmouth,16,21,9,59,46,13,69,9
470,Fleetwood Town,16,16,14,53,47,6,64,10
470,Lincoln City,15,19,12,48,47,1,64,11
470,Shrewsbury,18,9,19,53,50,3,63,12
470,Charlton Ath,15,14,17,67,61,6,59,13
470,Port Vale,16,8,22,48,68,-20,56,14
470,Bristol Rovers,14,11,21,63,81,-18,53,15
470,Cambridge Utd,14,9,23,45,69,-24,51,16
470,Exeter City,12,14,20,54,64,-10,50,17
470,Oxford United,12,14,20,46,57,-11,50,18
470,Cheltenham,13,11,22,36,59,-23,50,19
470,Burton Albion,12,10,24,56,84,-28,46,20
470,MK Dons,10,12,24,40,69,-29,42,21
470,Acc'ton Stanley,8,17,21,33,68,-35,41,22
470,Morecambe,9,13,24,43,75,-32,40,23
470,FG Rovers,5,14,27,29,83,-54,29,24
471,Plymouth Argyle,30,11,5,86,46,40,101,1
471,Sheffield Weds,27,12,7,73,33,40,93,2
471,Ipswich Town,24,16,6,78,41,37,88,3
471,Derby County,24,12,10,78,42,36,84,4
471,Bolton,24,12,10,67,35,32,84,5
471,Wycombe,25,9,12,66,39,27,84,6
471,Barnsley,24,8,14,67,44,23,80,7
471,Portsmouth,20,14,12,65,60,5,74,8
471,P'borough Utd,20,6,20,72,58,14,66,9
471,Exeter City,17,15,14,61,51,10,66,10
471,Shrewsbury,19,9,18,60,55,5,66,11
471,Lincoln City,15,20,11,45,41,4,65,12
471,Fleetwood Town,15,14,17,46,47,-1,59,13
471,Charlton Ath,14,15,17,59,56,3,57,14
471,Port Vale,13,13,20,46,62,-16,52,15
471,Bristol Rovers,13,10,23,66,91,-25,49,16
471,Oxford United,11,14,21,46,58,-12,47,17
471,Morecambe,12,11,23,40,64,-24,47,18
471,Burton Albion,11,13,22,56,82,-26,46,19
471,MK Dons,12,9,25,42,67,-25,45,20
471,Cheltenham,11,10,25,31,59,-28,43,21
471,Acc'ton Stanley,8,17,21,38,73,-35,41,22
471,Cambridge Utd,10,8,28,31,70,-39,38,23
471,FG Rovers,9,10,27,41,86,-45,37,24
472,Sheffield Weds,33,10,3,86,26,60,109,1
472,Plymouth Argyle,29,11,6,97,53,44,98,2
472,Ipswich Town,23,18,5,83,47,36,87,3
472,Derby County,24,11,11,77,42,35,83,4
472,Bolton,23,12,11,64,36,28,81,5
472,Wycombe,24,9,13,69,46,23,81,6
472,Barnsley,23,10,13,69,46,23,79,7
472,P'borough Utd,22,7,17,71,58,13,73,8
472,Fleetwood Town,19,14,13,54,41,13,71,9
472,Shrewsbury,18,13,15,62,55,7,67,10
472,Charlton Ath,17,14,15,67,56,11,65,11
472,Portsmouth,16,17,13,62,57,5,65,12
472,Lincoln City,13,22,11,44,45,-1,61,13
472,Exeter City,14,11,21,59,64,-5,53,14
472,Burton Albion,14,11,21,62,80,-18,53,15
472,Bristol Rovers,14,10,22,60,83,-23,52,16
472,Oxford United,13,11,22,48,63,-15,50,17
472,Port Vale,13,9,24,52,72,-20,48,18
472,Morecambe,10,13,23,45,71,-26,43,19
472,Acc'ton Stanley,10,12,24,42,76,-34,42,20
472,Cheltenham,11,8,27,33,63,-30,41,21
472,MK Dons,10,10,26,34,66,-32,40,22
472,Cambridge Utd,11,7,28,39,84,-45,40,23
472,FG Rovers,8,10,28,37,86,-49,34,24
473,Sheffield Weds,30,11,5,80,32,48,101,1
473,Plymouth Argyle,29,10,7,85,51,34,97,2
473,Barnsley,29,5,12,79,42,37,92,3
473,Ipswich Town,24,15,7,87,43,44,87,4
473,Wycombe,25,7,14,69,40,29,82,5
473,Bolton,24,10,12,65,39,26,82,6
473,Derby County,21,14,11,74,44,30,77,7
473,Portsmouth,20,15,11,69,50,19,75,8
473,Shrewsbury,18,13,15,55,47,8,67,9
473,P'borough Utd,19,8,19,69,62,7,65,10
473,Fleetwood Town,15,16,15,56,52,4,61,11
473,Lincoln City,13,21,12,49,51,-2,60,12
473,Charlton Ath,15,14,17,57,56,1,59,13
473,Bristol Rovers,16,11,19,65,72,-7,59,14
473,Port Vale,15,12,19,46,62,-16,57,15
473,Exeter City,13,14,19,56,66,-10,53,16
473,Oxford United,13,12,21,49,60,-11,51,17
473,Burton Albion,12,9,25,50,87,-37,45,18
473,MK Dons,11,10,25,45,68,-23,43,19
473,Morecambe,9,16,21,44,69,-25,43,20
473,Acc'ton Stanley,10,12,24,35,71,-36,42,21
473,Cambridge Utd,11,8,27,34,68,-34,41,22
473,Cheltenham,11,8,27,34,71,-37,41,23
473,FG Rovers,8,11,27,36,85,-49,35,24
474,Sheffield Weds,28,13,5,76,29,47,97,1
474,Plymouth Argyle,28,11,7,81,46,35,95,2
474,Derby County,26,12,8,86,43,43,90,3
474,Barnsley,27,6,13,70,42,28,87,4
474,Ipswich Town,23,16,7,86,48,38,85,5
474,Bolton,24,11,11,69,39,30,83,6
474,Wycombe,21,13,12,64,42,22,76,7
474,Shrewsbury,22,8,16,56,46,10,74,8
474,Portsmouth,18,16,12,66,50,16,70,9
474,Fleetwood Town,17,16,13,57,45,12,67,10
474,P'borough Utd,21,3,22,66,63,3,66,11
474,Port Vale,18,8,20,47,63,-16,62,12
474,Charlton Ath,16,13,17,66,59,7,61,13
474,Exeter City,16,11,19,57,61,-4,59,14
474,Bristol Rovers,15,11,20,59,74,-15,56,15
474,Lincoln City,10,22,14,37,46,-9,52,16
474,Burton Albion,12,12,22,55,84,-29,48,17
474,Acc'ton Stanley,11,14,21,38,61,-23,47,18
474,Oxford United,12,9,25,45,61,-16,45,19
474,Cambridge Utd,13,5,28,35,74,-39,44,20
474,Cheltenham,10,13,23,29,54,-25,43,21
474,Morecambe,9,13,24,43,72,-29,40,22
474,MK Dons,9,11,26,38,69,-31,38,23
474,FG Rovers,8,9,29,32,87,-55,33,24
475,Plymouth Argyle,32,9,5,97,51,46,105,1
475,Sheffield Weds,29,11,6,79,31,48,98,2
475,Derby County,27,10,9,81,42,39,91,3
475,Barnsley,27,6,13,69,46,23,87,4
475,Ipswich Town,21,17,8,76,44,32,80,5
475,Bolton,23,10,13,64,40,24,79,6
475,Wycombe,22,10,14,64,43,21,76,7
475,P'borough Utd,23,5,18,74,55,19,74,8
475,Charlton Ath,16,16,14,68,60,8,64,9
475,Fleetwood Town,16,14,16,48,43,5,62,10
475,Portsmouth,15,17,14,62,60,2,62,11
475,Shrewsbury,18,8,20,51,55,-4,62,12
475,Lincoln City,14,19,13,47,48,-1,61,13
475,Bristol Rovers,17,10,19,68,76,-8,61,14
475,Exeter City,16,11,19,59,64,-5,59,15
475,Port Vale,14,13,19,50,65,-15,55,16
475,Oxford United,13,11,22,46,58,-12,50,17
475,Burton Albion,13,10,23,61,81,-20,49,18
475,Cheltenham,12,11,23,34,65,-31,47,19
475,MK Dons,11,10,25,43,69,-26,43,20
475,Acc'ton Stanley,10,12,24,37,69,-32,42,21
475,Cambridge Utd,11,8,27,41,76,-35,41,22
475,Morecambe,7,16,23,49,80,-31,37,23
475,FG Rovers,7,12,27,35,82,-47,33,24
476,Sheffield Weds,31,9,6,97,36,61,102,1
476,Plymouth Argyle,30,10,6,88,53,35,100,2
476,Bolton,27,9,10,70,36,34,90,3
476,Barnsley,26,7,13,79,45,34,85,4
476,Ipswich Town,23,15,8,82,44,38,84,5
476,Derby County,23,11,12,78,44,34,80,6
476,Wycombe,22,9,15,55,40,15,75,7
476,Portsmouth,19,17,10,61,47,14,74,8
476,Fleetwood Town,19,16,11,57,38,19,73,9
476,Shrewsbury,19,11,16,56,53,3,68,10
476,P'borough Utd,19,9,18,71,58,13,66,11
476,Charlton Ath,17,14,15,63,55,8,65,12
476,Lincoln City,14,22,10,46,44,2,64,13
476,Exeter City,14,12,20,57,63,-6,54,14
476,Oxford United,13,12,21,47,63,-16,51,15
476,Port Vale,13,12,21,47,67,-20,51,16
476,Bristol Rovers,12,12,22,61,87,-26,48,17
476,Burton Albion,12,10,24,54,90,-36,46,18
476,MK Dons,11,9,26,43,67,-24,42,19
476,Acc'ton Stanley,10,12,24,40,74,-34,42,20
476,Cambridge Utd,11,9,26,38,72,-34,42,21
476,Morecambe,9,14,23,46,78,-32,41,22
476,Cheltenham,11,8,27,37,72,-35,41,23
476,FG Rovers,7,11,28,39,86,-47,32,24
477,Sheffield Weds,31,9,6,88,29,59,102,1
477,Plymouth Argyle,28,11,7,88,51,37,95,2
477,Ipswich Town,24,16,6,82,43,39,88,3
477,Bolton,24,11,11,68,34,34,83,4
477,Derby County,23,12,11,74,45,29,81,5
477,Barnsley,24,9,13,73,46,27,81,6
477,P'borough Utd,24,5,17,82,51,31,77,7
477,Portsmouth,19,15,12,68,57,11,72,8
477,Wycombe,20,10,16,61,46,15,70,9
477,Shrewsbury,20,9,17,52,46,6,69,10
477,Charlton Ath,16,15,15,64,55,9,63,11
477,Fleetwood Town,14,17,15,51,46,5,59,12
477,Oxford United,16,11,19,46,56,-10,59,13
477,Exeter City,14,15,17,58,60,-2,57,14
477,Bristol Rovers,15,12,19,67,76,-9,57,15
477,Lincoln City,11,22,13,40,52,-12,55,16
477,Port Vale,12,12,22,42,68,-26,48,17
477,Acc'ton Stanley,12,12,22,36,67,-31,48,18
477,MK Dons,12,10,24,46,68,-22,46,19
477,Cheltenham,13,7,26,34,66,-32,46,20
477,Morecambe,10,15,21,45,71,-26,45,21
477,Cambridge Utd,11,10,25,34,71,-37,43,22
477,Burton Albion,9,13,24,52,92,-40,40,23
477,FG Rovers,6,10,30,34,89,-55,28,24
478,Sheffield Weds,31,11,4,87,36,51,104,1
478,Ipswich Town,25,16,5,85,41,44,91,2
478,Plymouth Argyle,26,11,9,80,53,27,89,3
478,Barnsley,25,9,12,73,41,32,84,4
478,Bolton,23,12,11,68,39,29,81,5
478,Derby County,22,14,10,74,43,31,80,6
478,Portsmouth,19,16,11,64,51,13,73,7
478,Wycombe,21,8,17,63,50,13,71,8
478,Fleetwood Town,19,14,13,54,41,13,71,9
478,Charlton Ath,18,13,15,70,61,9,67,10
478,Shrewsbury,18,13,15,54,49,5,67,11
478,P'borough Utd,20,5,21,74,66,8,65,12
478,Lincoln City,13,21,12,44,43,1,60,13
478,Oxford United,13,14,19,57,63,-6,53,14
478,Port Vale,14,11,21,52,70,-18,53,15
478,Bristol Rovers,14,10,22,59,80,-21,52,16
478,Exeter City,13,12,21,56,70,-14,51,17
478,Burton Albion,13,11,22,53,78,-25,50,18
478,Cheltenham,12,11,23,38,59,-21,47,19
478,MK Dons,11,11,24,45,70,-25,44,20
478,Cambridge Utd,12,7,27,40,74,-34,43,21
478,Acc'ton Stanley,10,13,23,37,71,-34,43,22
478,Morecambe,10,12,24,41,69,-28,42,23
478,FG Rovers,6,13,27,34,84,-50,31,24
479,Sheffield Weds,31,11,4,93,31,62,104,1
479,Plymouth Argyle,27,13,6,80,47,33,94,2
479,Barnsley,26,10,10,71,43,28,88,3
479,Wycombe,27,6,13,65,38,27,87,4
479,Bolton,24,12,10,68,33,35,84,5
479,Derby County,22,14,10,70,45,25,80,6
479,P'borough Utd,22,8,16,78,58,20,74,7
479,Ipswich Town,19,16,11,73,54,19,73,8
479,Fleetwood Town,18,16,12,53,43,10,70,9
479,Portsmouth,19,12,15,70,57,13,69,10
479,Charlton Ath,17,15,14,73,62,11,66,11
479,Shrewsbury,17,9,20,50,52,-2,60,12
479,Port Vale,16,11,19,53,65,-12,59,13
479,Lincoln City,12,22,12,39,46,-7,58,14
479,Exeter City,14,11,21,60,60,0,53,15
479,Bristol Rovers,14,11,21,66,85,-19,53,16
479,Cambridge Utd,14,9,23,39,64,-25,51,17
479,Oxford United,12,12,22,47,60,-13,48,18
479,Acc'ton Stanley,11,14,21,40,69,-29,47,19
479,Burton Albion,10,16,20,54,80,-26,46,20
479,MK Dons,12,9,25,44,70,-26,45,21
479,Cheltenham,11,8,27,33,66,-33,41,22
479,Morecambe,8,11,27,39,72,-33,35,23
479,FG Rovers,6,10,30,34,92,-58,28,24
480,Plymouth Argyle,29,9,8,85,46,39,96,1
480,Sheffield Weds,27,11,8,91,43,48,92,2
480,Barnsley,28,8,10,77,39,38,92,3
480,Ipswich Town,24,15,7,86,42,44,87,4
480,Bolton,25,10,11,69,38,31,85,5
480,Derby County,23,15,8,80,40,40,84,6
480,Wycombe,25,9,12,65,42,23,84,7
480,P'borough Utd,25,5,16,84,63,21,80,8
480,Fleetwood Town,18,16,12,52,40,12,70,9
480,Lincoln City,16,19,11,47,48,-1,67,10
480,Portsmouth,16,18,12,61,52,9,66,11
480,Shrewsbury,18,10,18,56,53,3,64,12
480,Charlton Ath,16,13,17,66,61,5,61,13
480,Exeter City,14,12,20,54,62,-8,54,14
480,Bristol Rovers,14,10,22,59,81,-22,52,15
480,Port Vale,14,10,22,47,69,-22,52,16
480,Oxford United,12,12,22,46,58,-12,48,17
480,Cheltenham,11,10,25,33,61,-28,43,18
480,Cambridge Utd,11,10,25,41,74,-33,43,19
480,Burton Albion,11,10,25,53,92,-39,43,20
480,MK Dons,10,12,24,46,74,-28,42,21
480,Acc'ton Stanley,9,13,24,38,77,-39,40,22
480,Morecambe,7,15,24,42,74,-32,36,23
480,FG Rovers,6,14,26,34,83,-49,32,24
481,Sheffield Weds,27,14,5,79,30,49,95,1
481,Barnsley,28,10,8,80,39,41,94,2
481,Plymouth Argyle,28,10,8,85,53,32,94,3
481,Ipswich Town,24,14,8,82,45,37,86,4
481,Bolton,25,10,11,67,35,32,85,5
481,Derby County,22,14,10,73,41,32,80,6
481,Wycombe,22,7,17,60,47,13,73,7
481,Shrewsbury,21,10,15,58,48,10,73,8
481,P'borough Utd,22,4,20,72,57,15,70,9
481,Portsmouth,17,17,12,60,51,9,68,10
481,Fleetwood Town,17,15,14,52,45,7,66,11
481,Charlton Ath,16,13,17,67,57,10,61,12
481,Bristol Rovers,15,14,17,60,69,-9,59,13
481,Lincoln City,12,21,13,44,49,-5,57,14
481,Port Vale,15,11,20,47,63,-16,56,15
481,Exeter City,13,12,21,55,64,-9,51,16
481,Burton Albion,14,9,23,52,81,-29,51,17
481,Acc'ton Stanley,12,13,21,41,67,-26,49,18
481,Morecambe,11,14,21,54,77,-23,47,19
481,Cambridge Utd,12,10,24,39,65,-26,46,20
481,Oxford United,11,11,24,49,69,-20,44,21
481,Cheltenham,12,7,27,34,69,-35,43,22
481,MK Dons,11,8,27,41,72,-31,41,23
481,FG Rovers,5,12,29,34,92,-58,27,24
482,Sheffield Weds,28,14,4,85,28,57,98,1
482,Plymouth Argyle,29,10,7,94,49,45,97,2
482,Ipswich Town,25,15,6,94,45,49,90,3
482,Barnsley,24,12,10,68,36,32,84,4
482,Bolton,24,12,10,67,38,29,84,5
482,Derby County,23,14,9,73,40,33,83,6
482,P'borough Utd,22,8,16,82,57,25,74,7
482,Wycombe,21,10,15,61,45,16,73,8
482,Portsmouth,17,18,11,62,50,12,69,9
482,Charlton Ath,17,16,13,72,62,10,67,10
482,Fleetwood Town,15,16,15,52,48,4,61,11
482,Shrewsbury,17,10,19,52,55,-3,61,12
482,Exeter City,15,13,18,58,62,-4,58,13
482,Lincoln City,11,24,11,42,45,-3,57,14
482,Oxford United,14,12,20,54,60,-6,54,15
482,Port Vale,15,8,23,43,61,-18,53,16
482,Bristol Rovers,12,13,21,58,83,-25,49,17
482,Burton Albion,12,13,21,63,91,-28,49,18
482,MK Dons,13,8,25,42,71,-29,47,19
482,Cambridge Utd,13,7,26,45,78,-33,46,20
482,Cheltenham,11,11,24,38,65,-27,44,21
482,Acc'ton Stanley,9,13,24,37,79,-42,40,22
482,Morecambe,8,13,25,40,80,-40,37,23
482,FG Rovers,7,10,29,34,88,-54,31,24
483,Sheffield Weds,28,12,6,82,36,46,96,1
483,Plymouth Argyle,28,9,9,84,52,32,93,2
483,Ipswich Town,24,15,7,85,45,40,87,3
483,Derby County,24,13,9,74,41,33,85,4
483,Bolton,25,10,11,72,39,33,85,5
483,Wycombe,24,10,12,64,42,22,82,6
483,P'borough Utd,25,6,15,82,52,30,81,7
483,Barnsley,24,9,13,72,46,26,81,8
483,Portsmouth,21,17,8,69,44,25,80,9
483,Fleetwood Town,16,15,15,51,48,3,63,10
483,Charlton Ath,16,13,17,64,64,0,61,11
483,Shrewsbury,17,10,19,53,55,-2,61,12
483,Bristol Rovers,15,12,19,66,77,-11,57,13
483,Oxford United,14,12,20,56,61,-5,54,14
483,Exeter City,14,12,20,57,65,-8,54,15
483,Burton Albion,13,12,21,65,89,-24,51,16
483,Lincoln City,9,21,16,39,53,-14,48,17
483,Cheltenham,13,9,24,44,62,-18,48,18
483,Cambridge Utd,13,9,24,41,68,-27,48,19
483,Port Vale,11,13,22,42,66,-24,46,20
483,Morecambe,9,14,23,44,76,-32,41,21
483,MK Dons,9,11,26,47,80,-33,38,22
483,Acc'ton Stanley,7,15,24,32,77,-45,36,23
483,FG Rovers,9,9,28,36,83,-47,36,24
484,Sheffield Weds,30,10,6,83,32,51,100,1
484,Barnsley,27,9,10,81,39,42,90,2
484,Plymouth Argyle,26,11,9,75,48,27,89,3
484,Ipswich Town,24,16,6,83,40,43,88,4
484,Bolton,24,11,11,64,32,32,83,5
484,Derby County,24,11,11,74,43,31,83,6
484,Wycombe,24,9,13,62,41,21,81,7
484,P'borough Utd,24,4,18,77,60,17,76,8
484,Portsmouth,19,14,13,58,49,9,71,9
484,Shrewsbury,20,8,18,54,53,1,68,10
484,Fleetwood Town,17,13,16,52,45,7,64,11
484,Charlton Ath,16,15,15,61,57,4,63,12
484,Lincoln City,14,20,12,40,46,-6,62,13
484,Bristol Rovers,16,9,21,62,73,-11,57,14
484,Port Vale,16,9,21,43,60,-17,57,15
484,Exeter City,13,12,21,55,68,-13,51,16
484,Oxford United,12,12,22,48,59,-11,48,17
484,Burton Albion,11,13,22,55,83,-28,46,18
484,Cambridge Utd,12,10,24,38,68,-30,46,19
484,Acc'ton Stanley,10,14,22,40,67,-27,44,20
484,Cheltenham,11,11,24,33,60,-27,44,21
484,Morecambe,8,16,22,42,69,-27,40,22
484,MK Dons,10,10,26,40,71,-31,40,23
484,FG Rovers,6,9,31,35,92,-57,27,24
485,Sheffield Weds,32,11,3,90,30,60,107,1
485,Plymouth Argyle,28,13,5,83,51,32,97,2
485,Bolton,25,11,10,74,36,38,86,3
485,Barnsley,26,8,12,74,43,31,86,4
485,Ipswich Town,23,16,7,79,46,33,85,5
485,Derby County,20,15,11,63,41,22,75,6
485,Wycombe,22,9,15,68,48,20,75,7
485,P'borough Utd,21,9,16,79,57,22,72,8
485,Charlton Ath,19,13,14,75,54,21,70,9
485,Portsmouth,18,16,12,64,54,10,70,10
485,Fleetwood Town,16,18,12,49,41,8,66,11
485,Shrewsbury,18,10,18,56,59,-3,64,12
485,Lincoln City,12,22,12,40,42,-2,58,13
485,Exeter City,14,13,19,57,61,-4,55,14
485,Oxford United,13,13,20,52,61,-9,52,15
485,Bristol Rovers,13,13,20,58,74,-16,52,16
485,Port Vale,14,10,22,48,69,-21,52,17
485,Burton Albion,12,10,24,58,90,-32,46,18
485,Morecambe,9,15,22,46,73,-27,42,19
485,Cheltenham,10,12,24,28,61,-33,42,20
485,Acc'ton Stanley,10,12,24,44,79,-35,42,21
485,Cambridge Utd,11,9,26,35,71,-36,42,22
485,MK Dons,10,10,26,40,73,-33,40,23
485,FG Rovers,7,10,29,37,83,-46,31,24
486,Plymouth Argyle,29,10,7,82,46,36,97,1
486,Sheffield Weds,28,12,6,87,37,50,96,2
486,Ipswich Town,27,14,5,88,42,46,95,3
486,Derby County,23,14,9,80,43,37,83,4
486,Barnsley,24,9,13,66,40,26,81,5
486,Wycombe,24,7,15,65,43,22,79,6
486,Bolton,23,9,14,63,39,24,78,7
486,P'borough Utd,21,8,17,74,62,12,71,8
486,Portsmouth,18,15,13,62,54,8,69,9
486,Shrewsbury,19,10,17,55,46,9,67,10
486,Charlton Ath,18,12,16,75,61,14,66,11
486,Fleetwood Town,15,15,16,50,48,2,60,12
486,Lincoln City,12,24,10,40,40,0,60,13
486,Oxford United,15,10,21,53,59,-6,55,14
486,Exeter City,13,15,18,55,61,-6,54,15
486,Bristol Rovers,13,11,22,65,82,-17,50,16
486,Port Vale,13,11,22,45,63,-18,50,17
486,MK Dons,14,7,25,47,69,-22,49,18
486,Cheltenham,14,7,25,42,64,-22,49,19
486,Burton Albion,13,10,23,56,84,-28,49,20
486,Acc'ton Stanley,10,12,24,37,74,-37,42,21
486,FG Rovers,10,11,25,38,86,-48,41,22
486,Morecambe,8,15,23,45,81,-36,39,23
486,Cambridge Utd,10,8,28,39,85,-46,38,24
487,Sheffield Weds,30,11,5,85,37,48,101,1
487,Plymouth Argyle,28,10,8,79,49,30,94,2
487,Ipswich Town,24,15,7,85,42,43,87,3
487,Barnsley,25,9,12,70,43,27,84,4
487,Derby County,24,10,12,67,42,25,82,5
487,Bolton,23,11,12,62,36,26,80,6
487,P'borough Utd,24,7,15,77,55,22,79,7
487,Wycombe,21,10,15,60,46,14,73,8
487,Shrewsbury,20,9,17,57,52,5,69,9
487,Portsmouth,17,16,13,67,56,11,67,10
487,Exeter City,16,14,16,63,59,4,62,11
487,Charlton Ath,16,13,17,65,60,5,61,12
487,Fleetwood Town,15,16,15,50,46,4,61,13
487,Port Vale,16,10,20,50,64,-14,58,14
487,Oxford United,14,11,21,49,58,-9,53,15
487,Cheltenham,15,8,23,38,61,-23,53,16
487,Lincoln City,11,19,16,41,51,-10,52,17
487,Burton Albion,14,10,22,59,84,-25,52,18
487,Bristol Rovers,14,9,23,66,83,-17,51,19
487,MK Dons,12,10,24,50,70,-20,46,20
487,Cambridge Utd,10,11,25,35,69,-34,41,21
487,Morecambe,9,13,24,42,76,-34,40,22
487,FG Rovers,9,10,27,38,79,-41,37,23
487,Acc'ton Stanley,8,12,26,37,74,-37,36,24
488,Sheffield Weds,30,11,5,88,30,58,101,1
488,Plymouth Argyle,30,11,5,91,45,46,101,2
488,Ipswich Town,26,14,6,83,39,44,92,3
488,Barnsley,24,11,11,69,42,27,83,4
488,Derby County,23,12,11,77,45,32,81,5
488,Wycombe,23,10,13,63,39,24,79,6
488,Bolton,22,12,12,63,37,26,78,7
488,P'borough Utd,24,6,16,80,57,23,78,8
488,Portsmouth,19,15,12,65,57,8,72,9
488,Fleetwood Town,18,15,13,52,40,12,69,10
488,Charlton Ath,18,13,15,69,58,11,67,11
488,Shrewsbury,19,10,17,55,49,6,67,12
488,Port Vale,16,9,21,46,63,-17,57,13
488,Lincoln City,12,20,14,39,48,-9,56,14
488,Exeter City,14,13,19,53,62,-9,55,15
488,Oxford United,11,16,19,46,56,-10,49,16
488,Cheltenham,12,11,23,39,64,-25,47,17
488,Bristol Rovers,12,10,24,57,78,-21,46,18
488,Morecambe,11,12,23,48,77,-29,45,19
488,Acc'ton Stanley,10,13,23,40,73,-33,43,20
488,Burton Albion,11,9,26,54,96,-42,42,21
488,Cambridge Utd,9,11,26,32,67,-35,38,22
488,MK Dons,9,9,28,37,75,-38,36,23
488,FG Rovers,7,11,28,35,84,-49,32,24
489,Sheffield Weds,33,10,3,94,32,62,109,1
489,Plymouth Argyle,27,9,10,85,53,32,90,2
489,Derby County,26,11,9,79,37,42,89,3
489,Barnsley,26,9,11,69,46,23,87,4
489,Ipswich Town,23,17,6,79,44,35,86,5
489,Bolton,23,14,9,64,31,33,83,6
489,P'borough Utd,25,6,15,80,55,25,81,7
489,Wycombe,22,7,17,65,53,12,73,8
489,Shrewsbury,22,6,18,58,50,8,72,9
489,Portsmouth,19,14,13,67,54,13,71,10
489,Charlton Ath,18,12,16,62,53,9,66,11
489,Port Vale,17,8,21,51,68,-17,59,12
489,Lincoln City,12,21,13,43,43,0,57,13
489,Exeter City,13,16,17,58,62,-4,55,14
489,Fleetwood Town,12,18,16,49,51,-2,54,15
489,Bristol Rovers,14,8,24,60,83,-23,50,16
489,Burton Albion,12,12,22,58,88,-30,48,17
489,Morecambe,11,12,23,47,73,-26,45,18
489,MK Dons,13,6,27,46,75,-29,45,19
489,Oxford United,11,11,24,47,63,-16,44,20
489,Acc'ton Stanley,9,15,22,35,66,-31,42,21
489,Cheltenham,11,8,27,33,64,-31,41,22
489,Cambridge Utd,10,9,27,35,77,-42,39,23
489,FG Rovers,9,9,28,35,78,-43,36,24
490,Sheffield Weds,28,10,8,80,31,49,94,1
490,Plymouth Argyle,28,10,8,86,49,37,94,2
490,Ipswich Town,25,15,6,84,42,42,90,3
490,Bolton,26,10,10,68,34,34,88,4
490,Barnsley,25,8,13,66,42,24,83,5
490,Derby County,23,13,10,72,41,31,82,6
490,Wycombe,21,12,13,63,41,22,75,7
490,Portsmouth,19,16,11,59,45,14,73,8
490,P'borough Utd,22,6,18,70,57,13,72,9
490,Shrewsbury,19,9,18,56,51,5,66,10
490,Lincoln City,15,20,11,48,46,2,65,11
490,Exeter City,16,13,17,58,59,-1,61,12
490,Port Vale,17,10,19,45,60,-15,61,13
490,Fleetwood Town,14,17,15,49,42,7,59,14
490,Oxford United,13,13,20,48,57,-9,52,15
490,Cheltenham,13,12,21,35,57,-22,51,16
490,Bristol Rovers,12,14,20,59,77,-18,50,17
490,MK Dons,14,8,24,52,73,-21,50,18
490,Charlton Ath,11,16,19,51,61,-10,49,19
490,Burton Albion,11,12,23,50,82,-32,45,20
490,Acc'ton Stanley,9,12,25,38,73,-35,39,21
490,Morecambe,8,14,24,37,72,-35,38,22
490,Cambridge Utd,9,10,27,33,72,-39,37,23
490,FG Rovers,6,16,24,36,79,-43,34,24
491,Sheffield Weds,31,10,5,84,31,53,103,1
491,Plymouth Argyle,25,14,7,75,49,26,89,2
491,Ipswich Town,24,16,6,85,43,42,88,3
491,Bolton,25,12,9,65,31,34,87,4
491,Derby County,24,11,11,77,46,31,83,5
491,Barnsley,25,8,13,71,43,28,83,6
491,Wycombe,22,12,12,63,36,27,78,7
491,Portsmouth,18,17,11,63,47,16,71,8
491,P'borough Utd,20,8,18,67,61,6,68,9
491,Charlton Ath,16,16,14,70,61,9,64,10
491,Shrewsbury,17,12,17,54,49,5,63,11
491,Lincoln City,13,21,12,43,42,1,60,12
491,Port Vale,17,8,21,46,64,-18,59,13
491,Exeter City,14,15,17,58,60,-2,57,14
491,Bristol Rovers,14,13,19,67,77,-10,55,15
491,Fleetwood Town,12,18,16,49,49,0,54,16
491,Burton Albion,13,12,21,53,73,-20,51,17
491,Cheltenham,13,10,23,39,62,-23,49,18
491,MK Dons,12,11,23,47,68,-21,47,19
491,Oxford United,10,13,23,49,66,-17,43,20
491,Morecambe,9,16,21,50,76,-26,43,21
491,Cambridge Utd,11,10,25,41,79,-38,43,22
491,Acc'ton Stanley,8,11,27,31,82,-51,35,23
491,FG Rovers,7,10,29,35,87,-52,31,24
492,Sheffield Weds,29,14,3,85,28,57,101,1
492,Plymouth Argyle,29,10,7,93,49,44,97,2
492,Barnsley,26,10,10,73,37,36,88,3
492,Ipswich Town,24,15,7,87,46,41,87,4
492,Bolton,26,9,11,72,34,38,87,5
492,Derby County,22,13,11,69,41,28,79,6
492,Wycombe,22,10,14,57,40,17,76,7
492,P'borough Utd,22,6,18,82,57,25,72,8
492,Portsmouth,18,18,10,63,51,12,72,9
492,Shrewsbury,20,7,19,58,56,2,67,10
492,Charlton Ath,14,17,15,61,60,1,59,11
492,Lincoln City,12,23,11,38,43,-5,59,12
492,Fleetwood Town,14,15,17,46,46,0,57,13
492,Port Vale,15,12,19,49,64,-15,57,14
492,Oxford United,12,13,21,47,62,-15,49,15
492,Exeter City,12,12,22,56,69,-13,48,16
492,MK Dons,12,11,23,43,63,-20,47,17
492,Acc'ton Stanley,11,14,21,40,70,-30,47,18
492,Morecambe,11,13,22,47,71,-24,46,19
492,Cheltenham,12,10,24,33,63,-30,46,20
492,Bristol Rovers,11,13,22,54,85,-31,46,21
492,Cambridge Utd,10,12,24,34,67,-33,42,22
492,Burton Albion,10,9,27,51,95,-44,39,23
492,FG Rovers,8,14,24,35,76,-41,38,24
493,Barnsley,31,5,10,83,38,45,98,1
493,Sheffield Weds,28,12,6,89,36,53,96,2
493,Plymouth Argyle,27,11,8,86,49,37,92,3
493,Derby County,25,12,9,75,40,35,87,4
493,Bolton,25,11,10,71,36,35,86,5
493,Ipswich Town,23,15,8,81,50,31,84,6
493,Wycombe,24,6,16,68,48,20,78,7
493,P'borough Utd,24,5,17,78,54,24,77,8
493,Shrewsbury,19,10,17,52,46,6,67,9
493,Charlton Ath,17,14,15,63,55,8,65,10
493,Portsmouth,17,14,15,60,53,7,65,11
493,Lincoln City,14,19,13,43,49,-6,61,12
493,Fleetwood Town,14,16,16,51,51,0,58,13
493,Exeter City,15,11,20,57,69,-12,56,14
493,Bristol Rovers,15,9,22,63,80,-17,54,15
493,Oxford United,13,13,20,49,61,-12,52,16
493,Port Vale,14,10,22,47,64,-17,52,17
493,Burton Albion,13,9,24,55,86,-31,48,18
493,Acc'ton Stanley,11,15,20,34,67,-33,48,19
493,MK Dons,12,10,24,50,73,-23,46,20
493,Morecambe,10,14,22,46,71,-25,44,21
493,Cambridge Utd,12,5,29,41,83,-42,41,22
493,Cheltenham,10,9,27,34,66,-32,39,23
493,FG Rovers,6,11,29,33,84,-51,29,24
494,Plymouth Argyle,30,9,7,90,46,44,99,1
494,Sheffield Weds,29,11,6,87,40,47,98,2
494,Derby County,25,13,8,76,38,38,88,3
494,Barnsley,27,6,13,77,45,32,87,4
494,Ipswich Town,23,15,8,77,40,37,84,5
494,Bolton,25,9,12,66,38,28,84,6
494,P'borough Utd,24,6,16,79,59,20,78,7
494,Wycombe,24,6,16,62,48,14,78,8
494,Portsmouth,21,13,12,64,49,15,76,9
494,Shrewsbury,22,6,18,61,49,12,72,10
494,Fleetwood Town,18,15,13,55,38,17,69,11
494,Lincoln City,14,19,13,45,48,-3,61,12
494,Port Vale,17,9,20,51,62,-11,60,13
494,Charlton Ath,14,14,18,61,65,-4,56,14
494,Exeter City,14,12,20,60,63,-3,54,15
494,Burton Albion,14,12,20,62,79,-17,54,16
494,Oxford United,13,9,24,52,60,-8,48,17
494,Bristol Rovers,13,9,24,62,90,-28,48,18
494,Acc'ton Stanley,11,13,22,35,68,-33,46,19
494,Cheltenham,12,9,25,34,62,-28,45,20
494,Morecambe,11,11,24,44,73,-29,44,21
494,Cambridge Utd,10,7,29,33,72,-39,37,22
494,MK Dons,9,7,30,36,78,-42,34,23
494,FG Rovers,7,10,29,36,95,-59,31,24
495,Sheffield Weds,30,11,5,88,33,55,101,1
495,Ipswich Town,25,15,6,89,41,48,90,2
495,Plymouth Argyle,26,10,10,79,49,30,88,3
495,Derby County,23,14,9,75,45,30,83,4
495,Barnsley,24,10,12,77,51,26,82,5
495,Bolton,22,14,10,65,38,27,80,6
495,Portsmouth,21,14,11,66,50,16,77,7
495,Wycombe,21,10,15,63,46,17,73,8
495,Charlton Ath,19,12,15,69,53,16,69,9
495,Shrewsbury,20,9,17,54,51,3,69,10
495,P'borough Utd,20,8,18,72,55,17,68,11
495,Lincoln City,13,25,8,46,44,2,64,12
495,Fleetwood Town,14,19,13,48,41,7,61,13
495,Exeter City,13,15,18,59,62,-3,54,14
495,Bristol Rovers,14,12,20,66,83,-17,54,15
495,Port Vale,14,10,22,41,65,-24,52,16
495,Oxford United,12,14,20,44,57,-13,50,17
495,Morecambe,12,13,21,49,71,-22,49,18
495,Cheltenham,12,12,22,30,55,-25,48,19
495,Burton Albion,12,10,24,54,83,-29,46,20
495,Acc'ton Stanley,9,16,21,38,74,-36,43,21
495,MK Dons,10,9,27,42,72,-30,39,22
495,Cambridge Utd,10,8,28,33,74,-41,38,23
495,FG Rovers,5,12,29,31,85,-54,27,24
496,Sheffield Weds,30,10,6,90,34,56,100,1
496,Plymouth Argyle,26,12,8,83,49,34,90,2
496,Ipswich Town,24,17,5,80,39,41,89,3
496,Barnsley,27,6,13,70,43,27,87,4
496,Derby County,24,13,9,74,38,36,85,5
496,Bolton,25,10,11,72,39,33,85,6
496,P'borough Utd,24,6,16,77,55,22,78,7
496,Wycombe,22,8,16,64,42,22,74,8
496,Charlton Ath,18,15,13,74,59,15,69,9
496,Portsmouth,17,16,13,62,53,9,67,10
496,Shrewsbury,20,7,19,51,52,-1,67,11
496,Fleetwood Town,14,18,14,50,47,3,60,12
496,Lincoln City,12,22,12,44,50,-6,58,13
496,Exeter City,14,15,17,57,63,-6,57,14
496,Bristol Rovers,16,9,21,63,82,-19,57,15
496,Port Vale,15,10,21,44,59,-15,55,16
496,Burton Albion,14,9,23,59,80,-21,51,17
496,Acc'ton Stanley,12,14,20,45,72,-27,50,18
496,Cheltenham,12,10,24,31,58,-27,46,19
496,Oxford United,10,13,23,39,60,-21,43,20
496,Morecambe,9,14,23,46,75,-29,41,21
496,Cambridge Utd,10,9,27,34,76,-42,39,22
496,MK Dons,9,9,28,38,73,-35,36,23
496,FG Rovers,6,12,28,32,81,-49,30,24
497,Sheffield Weds,33,9,4,96,26,70,108,1
497,Plymouth Argyle,26,13,7,80,47,33,91,2
497,Barnsley,26,8,12,67,41,26,86,3
497,Derby County,23,13,10,72,42,30,82,4
497,Ipswich Town,20,19,7,77,43,34,79,5
497,Bolton,22,12,12,65,36,29,78,6
497,Wycombe,22,12,12,60,37,23,78,7
497,P'borough Utd,23,7,16,79,59,20,76,8
497,Portsmouth,20,14,12,69,51,18,74,9
497,Exeter City,17,12,17,56,53,3,63,10
497,Charlton Ath,16,14,16,63,62,1,62,11
497,Shrewsbury,18,8,20,51,57,-6,62,12
497,Fleetwood Town,15,15,16,51,49,2,60,13
497,Lincoln City,13,21,12,44,51,-7,60,14
497,Cheltenham,16,8,22,40,57,-17,56,15
497,Port Vale,13,14,19,52,67,-15,53,16
497,Bristol Rovers,13,13,20,64,79,-15,52,17
497,Morecambe,12,13,21,47,70,-23,49,18
497,Burton Albion,13,10,23,59,85,-26,49,19
497,Oxford United,11,13,22,52,66,-14,46,20
497,Acc'ton Stanley,10,13,23,40,77,-37,43,21
497,MK Dons,9,9,28,42,76,-34,36,22
497,Cambridge Utd,8,10,28,30,79,-49,34,23
497,FG Rovers,7,12,27,37,83,-46,33,24
498,Sheffield Weds,28,13,5,84,33,51,97,1
498,Plymouth Argyle,29,9,8,87,48,39,96,2
498,Barnsley,28,7,11,77,40,37,91,3
498,Ipswich Town,25,12,9,88,52,36,87,4
498,Bolton,25,11,10,74,34,40,86,5
498,Derby County,23,13,10,77,42,35,82,6
498,Wycombe,23,9,14,62,43,19,78,7
498,P'borough Utd,24,4,18,79,62,17,76,8
498,Portsmouth,19,15,12,64,52,12,72,9
498,Shrewsbury,19,8,19,55,51,4,65,10
498,Fleetwood Town,15,18,13,53,45,8,63,11
498,Lincoln City,13,19,14,46,46,0,58,12
498,Charlton Ath,15,13,18,62,67,-5,58,13
498,Bristol Rovers,16,9,21,63,82,-19,57,14
498,Exeter City,14,14,18,61,64,-3,56,15
498,Port Vale,16,8,22,48,68,-20,56,16
498,Burton Albion,14,12,20,57,80,-23,54,17
498,Oxford United,13,12,21,51,62,-11,51,18
498,Cheltenham,12,8,26,37,75,-38,44,19
498,Morecambe,10,13,23,42,71,-29,43,20
498,MK Dons,10,12,24,43,68,-25,42,21
498,Acc'ton Stanley,9,14,23,40,72,-32,41,22
498,Cambridge Utd,10,8,28,36,73,-37,38,23
498,FG Rovers,6,11,29,33,89,-56,29,24
499,Sheffield Weds,30,11,5,81,31,50,101,1
499,Plymouth Argyle,28,12,6,83,47,36,96,2
499,Ipswich Town,22,19,5,82,40,42,85,3
499,Barnsley,26,7,13,71,44,27,85,4
499,Derby County,23,10,13,71,47,24,79,5
499,Bolton,21,13,12,67,43,24,76,6
499,Shrewsbury,22,7,17,63,51,12,73,7
499,Wycombe,21,10,15,58,46,12,73,8
499,P'borough Utd,22,6,18,67,58,9,72,9
499,Portsmouth,18,16,12,66,50,16,70,10
499,Exeter City,17,14,15,67,57,10,65,11
499,Charlton Ath,16,14,16,65,61,4,62,12
499,Port Vale,16,11,19,54,67,-13,59,13
499,Lincoln City,13,19,14,52,54,-2,58,14
499,Bristol Rovers,15,12,19,65,80,-15,57,15
499,Fleetwood Town,13,17,16,48,50,-2,56,16
499,Oxford United,13,13,20,49,54,-5,52,17
499,Burton Albion,12,13,21,58,88,-30,49,18
499,Morecambe,11,13,22,53,75,-22,46,19
499,Acc'ton Stanley,10,15,21,36,62,-26,45,20
499,Cambridge Utd,11,8,27,36,73,-37,41,21
499,MK Dons,9,12,25,38,67,-29,39,22
499,Cheltenham,10,7,29,32,70,-38,37,23
499,FG Rovers,8,11,27,36,83,-47,35,24
500,Sheffield Weds,31,9,6,87,33,54,102,1
500,Plymouth Argyle,27,13,6,85,47,38,94,2
500,Ipswich Town,24,16,6,83,40,43,88,3
500,Derby County,24,13,9,74,34,40,85,4
500,Bolton,25,9,12,68,35,33,84,5
500,Barnsley,23,10,13,73,44,29,79,6
500,Wycombe,23,9,14,63,41,22,78,7
500,P'borough Utd,22,8,16,76,58,18,74,8
500,Portsmouth,18,15,13,60,54,6,69,9
500,Fleetwood Town,18,14,14,52,45,7,68,10
500,Shrewsbury,19,11,16,50,46,4,68,11
500,Lincoln City,13,21,12,44,49,-5,60,12
500,Bristol Rovers,15,11,20,68,82,-14,56,13
500,Charlton Ath,12,18,16,59,61,-2,54,14
500,Exeter City,13,14,19,55,67,-12,53,15
500,Cheltenham,13,11,22,40,59,-19,50,16
500,Oxford United,12,13,21,46,56,-10,49,17
500,Port Vale,13,10,23,46,75,-29,49,18
500,Burton Albion,13,9,24,54,87,-33,48,19
500,Acc'ton Stanley,11,14,21,41,67,-26,47,20
500,MK Dons,12,10,24,42,64,-22,46,21
500,Morecambe,10,14,22,43,76,-33,44,22
500,Cambridge Utd,9,9,28,33,75,-42,36,23
500,FG Rovers,6,11,29,30,77,-47,29,24
501,Sheffield Weds,30,11,5,83,30,53,101,1
501,Plymouth Argyle,28,11,7,78,45,33,95,2
501,Derby County,24,14,8,81,39,42,86,3
501,Bolton,25,11,10,72,37,35,86,4
501,Ipswich Town,23,16,7,80,43,37,85,5
501,Barnsley,24,12,10,70,42,28,84,6
501,P'borough Utd,24,5,17,76,53,23,77,7
501,Portsmouth,19,16,11,64,49,15,73,8
501,Wycombe,20,10,16,64,52,12,70,9
501,Shrewsbury,19,12,15,55,46,9,69,10
501,Charlton Ath,16,14,16,62,59,3,62,11
501,Lincoln City,13,22,11,44,45,-1,61,12
501,Fleetwood Town,15,15,16,48,45,3,60,13
501,Bristol Rovers,15,9,22,57,85,-28,54,14
501,Burton Albion,13,10,23,54,81,-27,49,15
501,Port Vale,13,9,24,42,67,-25,48,16
501,Exeter City,11,13,22,51,67,-16,46,17
501,Acc'ton Stanley,10,16,20,45,70,-25,46,18
501,Cheltenham,11,13,22,31,59,-28,46,19
501,Cambridge Utd,12,10,24,40,72,-32,46,20
501,Oxford United,10,14,22,46,60,-14,44,21
501,Morecambe,10,14,22,45,72,-27,44,22
501,MK Dons,10,12,24,38,62,-24,42,23
501,FG Rovers,6,13,27,38,84,-46,31,24
502,Sheffield Weds,30,11,5,86,33,53,101,1
502,Plymouth Argyle,28,10,8,87,50,37,94,2
502,Ipswich Town,23,15,8,85,47,38,84,3
502,Derby County,23,14,9,73,42,31,83,4
502,Barnsley,24,9,13,77,49,28,81,5
502,Wycombe,24,9,13,71,46,25,81,6
502,Bolton,22,11,13,67,41,26,77,7
502,Portsmouth,19,16,11,65,47,18,73,8
502,P'borough Utd,22,7,17,73,57,16,73,9
502,Shrewsbury,19,10,17,54,44,10,67,10
502,Fleetwood Town,16,14,16,53,50,3,62,11
502,Exeter City,17,10,19,58,60,-2,61,12
502,Charlton Ath,15,15,16,63,59,4,60,13
502,Lincoln City,14,18,14,47,47,0,60,14
502,Bristol Rovers,15,12,19,65,78,-13,57,15
502,Oxford United,13,14,19,50,58,-8,53,16
502,Burton Albion,13,12,21,59,86,-27,51,17
502,Port Vale,13,10,23,45,75,-30,49,18
502,Morecambe,12,12,22,50,74,-24,48,19
502,Cheltenham,12,9,25,35,63,-28,45,20
502,Cambridge Utd,11,10,25,41,76,-35,43,21
502,MK Dons,10,12,24,39,65,-26,42,22
502,Acc'ton Stanley,9,12,25,36,77,-41,39,23
502,FG Rovers,6,12,28,36,91,-55,30,24
503,Sheffield Weds,29,10,7,78,32,46,97,1
503,Plymouth Argyle,28,10,8,84,48,36,94,2
503,Ipswich Town,23,17,6,87,43,44,86,3
503,Barnsley,24,11,11,70,46,24,83,4
503,Derby County,23,12,11,69,43,26,81,5
503,Bolton,23,12,11,62,37,25,81,6
503,Wycombe,21,10,15,59,42,17,73,7
503,Shrewsbury,21,8,17,55,52,3,71,8
503,Charlton Ath,18,15,13,60,49,11,69,9
503,P'borough Utd,20,7,19,74,59,15,67,10
503,Fleetwood Town,15,19,12,52,45,7,64,11
503,Oxford United,16,11,19,50,52,-2,59,12
503,Portsmouth,14,17,15,54,57,-3,59,13
503,Exeter City,14,15,17,60,64,-4,57,14
503,Bristol Rovers,15,11,20,65,75,-10,56,15
503,Port Vale,15,10,21,46,61,-15,55,16
503,Lincoln City,11,21,14,48,56,-8,54,17
503,Burton Albion,12,12,22,55,78,-23,48,18
503,Cheltenham,12,11,23,35,57,-22,47,19
503,MK Dons,12,11,23,40,65,-25,47,20
503,Morecambe,9,16,21,42,68,-26,43,21
503,Acc'ton Stanley,10,13,23,40,69,-29,43,22
503,Cambridge Utd,10,13,23,37,67,-30,43,23
503,FG Rovers,5,12,29,30,87,-57,27,24
504,Sheffield Weds,31,11,4,83,30,53,104,1
504,Ipswich Town,25,16,5,88,43,45,91,2
504,Bolton,26,10,10,71,31,40,88,3
504,Derby County,25,13,8,73,38,35,88,4
504,Plymouth Argyle,26,9,11,81,59,22,87,5
504,Barnsley,24,9,13,72,44,28,81,6
504,Wycombe,23,10,13,67,42,25,79,7
504,P'borough Utd,23,7,16,72,54,18,76,8
504,Charlton Ath,18,14,14,72,58,14,68,9
504,Portsmouth,17,17,12,68,63,5,68,10
504,Shrewsbury,19,9,18,58,53,5,66,11
504,Bristol Rovers,16,12,18,64,73,-9,60,12
504,Lincoln City,11,24,11,41,43,-2,57,13
504,Oxford United,14,13,19,46,57,-11,55,14
504,Exeter City,13,13,20,53,57,-4,52,15
504,Acc'ton Stanley,13,12,21,43,67,-24,51,16
504,Burton Albion,13,11,22,57,85,-28,50,17
504,Fleetwood Town,11,16,19,39,47,-8,49,18
504,Port Vale,13,10,23,41,68,-27,49,19
504,Cheltenham,12,11,23,35,60,-25,47,20
504,Morecambe,10,13,23,47,79,-32,43,21
504,MK Dons,10,8,28,40,75,-35,38,22
504,Cambridge Utd,9,9,28,43,77,-34,36,23
504,FG Rovers,5,13,28,38,89,-51,28,24
505,Sheffield Weds,33,9,4,90,33,57,108,1
505,Plymouth Argyle,28,9,9,80,50,30,93,2
505,Ipswich Town,24,16,6,85,45,40,88,3
505,Derby County,24,12,10,77,40,37,84,4
505,Bolton,24,12,10,71,36,35,84,5
505,P'borough Utd,27,3,16,92,60,32,84,6
505,Wycombe,24,6,16,70,45,25,78,7
505,Barnsley,23,9,14,62,46,16,78,8
505,Portsmouth,20,16,10,71,49,22,76,9
505,Lincoln City,15,19,12,48,44,4,64,10
505,Fleetwood Town,17,12,17,54,45,9,63,11
505,Shrewsbury,17,9,20,52,57,-5,60,12
505,Exeter City,16,12,18,57,64,-7,60,13
505,Charlton Ath,14,14,18,59,61,-2,56,14
505,Port Vale,13,12,21,48,71,-23,51,15
505,Bristol Rovers,13,11,22,62,85,-23,50,16
505,Oxford United,12,12,22,47,57,-10,48,17
505,Cheltenham,13,9,24,37,65,-28,48,18
505,Cambridge Utd,13,8,25,41,75,-34,47,19
505,Acc'ton Stanley,11,12,23,35,67,-32,45,20
505,Burton Albion,12,9,25,57,94,-37,45,21
505,MK Dons,12,8,26,46,69,-23,44,22
505,Morecambe,10,14,22,44,70,-26,44,23
505,FG Rovers,5,11,30,30,87,-57,26,24
506,Sheffield Weds,31,10,5,82,29,53,103,1
506,Plymouth Argyle,31,9,6,89,48,41,102,2
506,Ipswich Town,26,16,4,86,40,46,94,3
506,Barnsley,27,8,11,82,48,34,89,4
506,Derby County,25,10,11,75,45,30,85,5
506,Bolton,23,12,11,71,36,35,81,6
506,Wycombe,24,7,15,65,46,19,79,7
506,Portsmouth,18,17,11,59,48,11,71,8
506,P'borough Utd,20,6,20,64,60,4,66,9
506,Shrewsbury,17,13,16,47,43,4,64,10
506,Port Vale,18,10,18,51,61,-10,64,11
506,Charlton Ath,15,18,13,68,57,11,63,12
506,Fleetwood Town,15,15,16,53,49,4,60,13
506,Lincoln City,14,18,14,45,50,-5,60,14
506,Exeter City,15,12,19,58,58,0,57,15
506,Cheltenham,14,9,23,34,55,-21,51,16
506,Bristol Rovers,13,10,23,62,85,-23,49,17
506,Morecambe,10,14,22,46,74,-28,44,18
506,MK Dons,11,9,26,39,69,-30,42,19
506,Burton Albion,11,9,26,53,85,-32,42,20
506,Oxford United,10,10,26,42,64,-22,40,21
506,Cambridge Utd,10,10,26,41,74,-33,40,22
506,Acc'ton Stanley,9,13,24,31,73,-42,40,23
506,FG Rovers,8,9,29,36,82,-46,33,24
507,Sheffield Weds,32,9,5,81,30,51,105,1
507,Plymouth Argyle,27,13,6,88,51,37,94,2
507,Wycombe,27,6,13,69,44,25,87,3
507,Ipswich Town,23,16,7,85,43,42,85,4
507,Derby County,25,10,11,70,39,31,85,5
507,Barnsley,25,9,12,71,41,30,84,6
507,Bolton,23,12,11,69,38,31,81,7
507,Shrewsbury,20,10,16,55,46,9,70,8
507,Charlton Ath,18,14,14,68,53,15,68,9
507,Fleetwood Town,17,15,14,52,41,11,66,10
507,Portsmouth,17,15,14,65,56,9,66,11
507,P'borough Utd,19,5,22,63,60,3,62,12
507,Lincoln City,12,25,9,45,44,1,61,13
507,Port Vale,17,7,22,48,64,-16,58,14
507,Exeter City,14,11,21,54,61,-7,53,15
507,Burton Albion,14,11,21,57,84,-27,53,16
507,Bristol Rovers,14,9,23,66,86,-20,51,17
507,Oxford United,12,14,20,51,60,-9,50,18
507,Acc'ton Stanley,12,14,20,39,69,-30,50,19
507,MK Dons,13,6,27,43,69,-26,45,20
507,Morecambe,9,14,23,49,78,-29,41,21
507,Cheltenham,11,8,27,34,73,-39,41,22
507,Cambridge Utd,9,6,31,31,76,-45,33,23
507,FG Rovers,8,9,29,36,83,-47,33,24
508,Sheffield Weds,29,13,4,74,29,45,100,1
508,Plymouth Argyle,28,10,8,81,50,31,94,2
508,Ipswich Town,26,13,7,93,44,49,91,3
508,Derby County,25,12,9,84,46,38,87,4
508,Barnsley,26,9,11,75,47,28,87,5
508,Wycombe,24,10,12,71,44,27,82,6
508,Bolton,23,12,11,67,40,27,81,7
508,P'borough Utd,23,6,17,78,57,21,75,8
508,Shrewsbury,20,9,17,63,54,9,69,9
508,Fleetwood Town,17,15,14,61,49,12,66,10
508,Portsmouth,16,16,14,59,53,6,64,11
508,Charlton Ath,17,12,17,65,58,7,63,12
508,Port Vale,18,8,20,51,67,-16,62,13
508,Exeter City,14,15,17,58,57,1,57,14
508,Morecambe,13,13,20,54,69,-15,52,15
508,Lincoln City,11,19,16,40,55,-15,52,16
508,Oxford United,13,12,21,55,60,-5,51,17
508,Bristol Rovers,13,12,21,61,80,-19,51,18
508,Burton Albion,13,10,23,53,86,-33,49,19
508,Cheltenham,11,10,25,36,62,-26,43,20
508,MK Dons,10,10,26,43,79,-36,40,21
508,Acc'ton Stanley,8,13,25,31,76,-45,37,22
508,Cambridge Utd,10,6,30,36,78,-42,36,23
508,FG Rovers,7,9,30,35,84,-49,30,24
509,Sheffield Weds,28,12,6,85,32,53,96,1
509,Plymouth Argyle,29,9,8,87,50,37,96,2
509,Barnsley,28,7,11,81,39,42,91,3
509,Wycombe,26,8,12,72,41,31,86,4
509,Ipswich Town,24,13,9,83,43,40,85,5
509,Bolton,25,10,11,71,39,32,85,6
509,Derby County,24,12,10,74,41,33,84,7
509,P'borough Utd,23,7,16,76,51,25,76,8
509,Shrewsbury,21,8,17,58,56,2,71,9
509,Charlton Ath,18,13,15,76,63,13,67,10
509,Portsmouth,17,16,13,60,49,11,67,11
509,Fleetwood Town,16,16,14,50,47,3,64,12
509,Oxford United,15,11,20,47,61,-14,56,13
509,Lincoln City,11,19,16,38,59,-21,52,14
509,Morecambe,12,14,20,55,71,-16,50,15
509,Port Vale,13,11,22,43,64,-21,50,16
509,Exeter City,12,11,23,51,63,-12,47,17
509,Bristol Rovers,12,11,23,56,83,-27,47,18
509,Burton Albion,12,11,23,60,90,-30,47,19
509,Cheltenham,12,9,25,37,66,-29,45,20
509,Acc'ton Stanley,11,11,24,37,69,-32,44,21
509,MK Dons,11,10,25,42,74,-32,43,22
509,Cambridge Utd,11,7,28,35,73,-38,40,23
509,FG Rovers,7,12,27,36,86,-50,33,24
510,Sheffield Weds,34,9,3,87,28,59,111,1
510,Barnsley,28,9,9,79,38,41,93,2
510,Plymouth Argyle,28,8,10,85,55,30,92,3
510,Bolton,26,10,10,67,35,32,88,4
510,Ipswich Town,23,15,8,84,43,41,84,5
510,Wycombe,25,8,13,72,38,34,83,6
510,Derby County,23,12,11,69,41,28,81,7
510,Shrewsbury,20,12,14,60,50,10,72,8
510,Portsmouth,17,16,13,59,57,2,67,9
510,P'borough Utd,20,6,20,73,68,5,66,10
510,Charlton Ath,15,14,17,69,69,0,59,11
510,Lincoln City,13,20,13,46,46,0,59,12
510,Fleetwood Town,14,14,18,50,52,-2,56,13
510,Bristol Rovers,15,11,20,68,80,-12,56,14
510,Port Vale,14,13,19,48,64,-16,55,15
510,Exeter City,13,14,19,57,61,-4,53,16
510,Morecambe,12,13,21,47,68,-21,49,17
510,Burton Albion,12,11,23,58,87,-29,47,18
510,Oxford United,11,13,22,43,60,-17,46,19
510,Cheltenham,11,13,22,33,64,-31,46,20
510,MK Dons,12,8,26,45,73,-28,44,21
510,Acc'ton Stanley,9,15,22,39,68,-29,42,22
510,Cambridge Utd,10,8,28,40,81,-41,38,23
510,FG Rovers,5,12,29,31,83,-52,27,24
511,Sheffield Weds,31,12,3,90,28,62,105,1
511,Plymouth Argyle,29,11,6,96,52,44,98,2
511,Barnsley,27,6,13,71,41,30,87,3
511,Ipswich Town,23,16,7,88,48,40,85,4
511,Derby County,23,10,13,75,46,29,79,5
511,P'borough Utd,24,6,16,70,50,20,78,6
511,Bolton,22,11,13,65,40,25,77,7
511,Wycombe,23,8,15,64,41,23,77,8
511,Portsmouth,20,16,10,69,50,19,76,9
511,Fleetwood Town,17,15,14,51,46,5,66,10
511,Shrewsbury,19,8,19,49,49,0,65,11
511,Charlton Ath,14,17,15,58,54,4,59,12
511,Bristol Rovers,17,8,21,63,74,-11,59,13
511,Lincoln City,12,22,12,41,48,-7,58,14
511,Exeter City,15,11,20,60,68,-8,56,15
511,Cheltenham,13,10,23,38,61,-23,49,16
511,Port Vale,12,12,22,46,73,-27,48,17
511,Acc'ton Stanley,12,12,22,40,72,-32,48,18
511,Morecambe,11,14,21,50,73,-23,47,19
511,Burton Albion,11,12,23,47,79,-32,45,20
511,Oxford United,10,14,22,44,62,-18,44,21
511,MK Dons,12,8,26,39,63,-24,44,22
511,Cambridge Utd,9,9,28,36,77,-41,36,23
511,FG Rovers,7,10,29,34,89,-55,31,24
512,Sheffield Weds,28,13,5,73,30,43,97,1
512,Ipswich Town,26,15,5,98,45,53,93,2
512,Plymouth Argyle,28,9,9,85,50,35,93,3
512,Bolton,27,9,10,68,33,35,90,4
512,Derby County,24,12,10,75,40,35,84,5
512,Barnsley,23,12,11,66,40,26,81,6
512,Wycombe,23,8,15,59,46,13,77,7
512,Portsmouth,20,16,10,66,48,18,76,8
512,P'borough Utd,22,7,17,71,55,16,73,9
512,Fleetwood Town,17,15,14,53,47,6,66,10
512,Charlton Ath,16,16,14,67,59,8,64,11
512,Lincoln City,13,23,10,39,41,-2,62,12
512,Shrewsbury,17,10,19,53,54,-1,61,13
512,Bristol Rovers,16,10,20,65,77,-12,58,14
512,Exeter City,14,14,18,55,55,0,56,15
512,Acc'ton Stanley,12,13,21,49,73,-24,49,16
512,Port Vale,12,12,22,41,64,-23,48,17
512,Oxford United,11,13,22,43,61,-18,46,18
512,MK Dons,11,11,24,44,64,-20,44,19
512,Cheltenham,11,11,24,33,57,-24,44,20
512,Burton Albion,10,13,23,52,86,-34,43,21
512,Morecambe,9,13,24,42,78,-36,40,22
512,Cambridge Utd,8,11,27,33,71,-38,35,23
512,FG Rovers,5,12,29,27,83,-56,27,24
513,Sheffield Weds,30,11,5,86,33,53,101,1
513,Plymouth Argyle,29,10,7,90,48,42,97,2
513,Ipswich Town,26,14,6,85,42,43,92,3
513,Wycombe,27,7,12,67,38,29,88,4
513,Bolton,24,11,11,67,37,30,83,5
513,Barnsley,25,8,13,68,41,27,83,6
513,Derby County,21,13,12,71,45,26,76,7
513,Portsmouth,19,17,10,72,53,19,74,8
513,P'borough Utd,22,6,18,74,63,11,72,9
513,Fleetwood Town,19,13,14,56,43,13,70,10
513,Charlton Ath,18,13,15,65,57,8,67,11
513,Shrewsbury,16,13,17,48,47,1,61,12
513,Lincoln City,11,23,12,38,45,-7,56,13
513,Bristol Rovers,13,14,19,63,75,-12,53,14
513,Port Vale,15,8,23,47,65,-18,53,15
513,Exeter City,13,11,22,52,69,-17,50,16
513,Morecambe,11,15,20,47,65,-18,48,17
513,Oxford United,11,13,22,47,61,-14,46,18
513,MK Dons,12,10,24,44,69,-25,46,19
513,Acc'ton Stanley,11,11,24,40,77,-37,44,20
513,Burton Albion,10,13,23,54,85,-31,43,21
513,Cheltenham,10,12,24,31,57,-26,42,22
513,Cambridge Utd,9,8,29,36,79,-43,35,23
513,FG Rovers,8,10,28,40,94,-54,34,24
514,Plymouth Argyle,30,10,6,95,47,48,100,1
514,Sheffield Weds,28,13,5,79,32,47,97,2
514,Ipswich Town,24,16,6,78,39,39,88,3
514,Bolton,24,10,12,70,36,34,82,4
514,Wycombe,24,8,14,64,41,23,80,5
514,Barnsley,23,11,12,64,41,23,80,6
514,P'borough Utd,24,6,16,76,57,19,78,7
514,Derby County,21,13,12,68,41,27,76,8
514,Shrewsbury,22,10,14,63,47,16,76,9
514,Portsmouth,20,15,11,62,48,14,75,10
514,Fleetwood Town,17,15,14,54,40,14,66,11
514,Lincoln City,13,20,13,50,50,0,59,12
514,Charlton Ath,15,13,18,59,61,-2,58,13
514,Port Vale,15,11,20,51,69,-18,56,14
514,Exeter City,12,14,20,55,66,-11,50,15
514,Bristol Rovers,12,14,20,64,82,-18,50,16
514,Burton Albion,12,12,22,55,91,-36,48,17
514,Cheltenham,12,11,23,36,63,-27,47,18
514,Acc'ton Stanley,11,14,21,39,69,-30,47,19
514,Morecambe,10,15,21,44,66,-22,45,20
514,Oxford United,10,13,23,48,59,-11,43,21
514,Cambridge Utd,10,9,27,35,76,-41,39,22
514,MK Dons,9,11,26,35,64,-29,38,23
514,FG Rovers,7,10,29,34,93,-59,31,24
515,Plymouth Argyle,30,9,7,89,48,41,99,1
515,Sheffield Weds,27,13,6,77,34,43,94,2
515,Derby County,27,11,8,79,38,41,92,3
515,Bolton,27,10,9,71,30,41,91,4
515,Ipswich Town,24,16,6,81,43,38,88,5
515,Wycombe,26,8,12,75,41,34,86,6
515,Barnsley,26,8,12,66,40,26,86,7
515,P'borough Utd,23,6,17,81,61,20,75,8
515,Portsmouth,19,15,12,65,50,15,72,9
515,Charlton Ath,15,15,16,59,60,-1,60,10
515,Exeter City,15,13,18,61,65,-4,58,11
515,Shrewsbury,16,10,20,53,57,-4,58,12
515,Fleetwood Town,14,15,17,48,45,3,57,13
515,Port Vale,15,9,22,46,70,-24,54,14
515,Bristol Rovers,14,11,21,62,78,-16,53,15
515,Lincoln City,10,20,16,43,54,-11,50,16
515,MK Dons,13,10,23,43,64,-21,49,17
515,Cambridge Utd,13,10,23,38,65,-27,49,18
515,Oxford United,10,16,20,42,54,-12,46,19
515,Burton Albion,11,12,23,53,80,-27,45,20
515,Morecambe,9,17,20,42,70,-28,44,21
515,Cheltenham,11,9,26,34,64,-30,42,22
515,Acc'ton Stanley,7,15,24,35,75,-40,36,23
515,FG Rovers,5,12,29,32,89,-57,27,24
516,Plymouth Argyle,30,8,8,85,50,35,98,1
516,Ipswich Town,28,12,6,97,41,56,96,2
516,Sheffield Weds,26,14,6,86,40,46,92,3
516,Derby County,26,11,9,81,42,39,89,4
516,Barnsley,26,8,12,71,43,28,86,5
516,Bolton,25,9,12,70,33,37,84,6
516,P'borough Utd,23,6,17,79,61,18,75,7
516,Wycombe,20,9,17,58,46,12,69,8
516,Portsmouth,17,18,11,60,49,11,69,9
516,Fleetwood Town,17,15,14,54,45,9,66,10
516,Shrewsbury,18,9,19,53,51,2,63,11
516,Charlton Ath,16,14,16,62,66,-4,62,12
516,Lincoln City,13,22,11,41,42,-1,61,13
516,Exeter City,15,11,20,56,63,-7,56,14
516,Burton Albion,16,8,22,56,79,-23,56,15
516,Bristol Rovers,14,11,21,63,82,-19,53,16
516,Port Vale,14,9,23,47,70,-23,51,17
516,Oxford United,12,14,20,48,58,-10,50,18
516,Cheltenham,12,11,23,36,62,-26,47,19
516,Cambridge Utd,13,8,25,43,73,-30,47,20
516,Acc'ton Stanley,11,13,22,36,70,-34,46,21
516,Morecambe,8,14,24,41,78,-37,38,22
516,MK Dons,10,7,29,41,69,-28,37,23
516,FG Rovers,6,11,29,38,89,-51,29,24
517,Sheffield Weds,29,14,3,76,28,48,101,1
517,Barnsley,29,9,8,74,36,38,96,2
517,Plymouth Argyle,26,10,10,87,49,38,88,3
517,Bolton,24,11,11,69,35,34,83,4
517,Ipswich Town,23,14,9,76,45,31,83,5
517,Derby County,24,11,11,72,41,31,83,6
517,Wycombe,23,11,12,74,42,32,80,7
517,P'borough Utd,23,6,17,81,58,23,75,8
517,Shrewsbury,19,12,15,56,51,5,69,9
517,Charlton Ath,17,15,14,69,56,13,66,10
517,Portsmouth,16,18,12,57,49,8,66,11
517,Lincoln City,15,21,10,48,44,4,66,12
517,Exeter City,17,12,17,67,58,9,63,13
517,Fleetwood Town,14,14,18,53,53,0,56,14
517,Port Vale,15,9,22,48,69,-21,54,15
517,Bristol Rovers,13,14,19,62,75,-13,53,16
517,Oxford United,12,14,20,44,54,-10,50,17
517,Cheltenham,13,9,24,33,58,-25,48,18
517,Acc'ton Stanley,10,14,22,39,72,-33,44,19
517,MK Dons,12,7,27,43,77,-34,43,20
517,Cambridge Utd,12,6,28,37,77,-40,42,21
517,Morecambe,8,15,23,41,73,-32,39,22
517,Burton Albion,9,11,26,47,98,-51,38,23
517,FG Rovers,6,9,31,35,90,-55,27,24
518,Sheffield Weds,30,11,5,89,31,58,101,1
518,Plymouth Argyle,27,13,6,84,47,37,94,2
518,Bolton,27,8,11,71,32,39,89,3
518,Ipswich Town,24,14,8,80,46,34,86,4
518,Derby County,24,13,9,80,44,36,85,5
518,Barnsley,25,10,11,72,42,30,85,6
518,P'borough Utd,23,7,16,75,52,23,76,7
518,Wycombe,22,7,17,60,44,16,73,8
518,Shrewsbury,19,10,17,55,54,1,67,9
518,Portsmouth,17,14,15,63,54,9,65,10
518,Fleetwood Town,16,14,16,55,49,6,62,11
518,Exeter City,16,12,18,59,59,0,60,12
518,Bristol Rovers,16,12,18,63,72,-9,60,13
518,Charlton Ath,15,14,17,69,64,5,59,14
518,Cheltenham,14,11,21,36,51,-15,53,15
518,Lincoln City,10,22,14,40,52,-12,52,16
518,Port Vale,13,10,23,44,80,-36,49,17
518,Oxford United,12,11,23,46,65,-19,47,18
518,Acc'ton Stanley,11,13,22,38,66,-28,46,19
518,Morecambe,11,12,23,49,72,-23,45,20
518,Cambridge Utd,13,6,27,43,76,-33,45,21
518,Burton Albion,12,9,25,53,92,-39,45,22
518,MK Dons,11,8,27,41,72,-31,41,23
518,FG Rovers,8,11,27,38,87,-49,35,24
519,Sheffield Weds,32,10,4,95,32,63,106,1
519,Plymouth Argyle,28,10,8,82,48,34,94,2
519,Ipswich Town,25,15,6,82,39,43,90,3
519,Barnsley,26,10,10,71,42,29,88,4
519,Derby County,25,11,10,76,44,32,86,5
519,Bolton,23,11,12,67,44,23,80,6
519,Wycombe,24,8,14,62,43,19,80,7
519,P'borough Utd,23,5,18,79,63,16,74,8
519,Portsmouth,18,16,12,67,50,17,70,9
519,Charlton Ath,18,12,16,70,58,12,66,10
519,Shrewsbury,18,8,20,65,60,5,62,11
519,Exeter City,16,11,19,60,64,-4,59,12
519,Lincoln City,11,24,11,44,49,-5,57,13
519,Fleetwood Town,12,20,14,50,48,2,56,14
519,Oxford United,15,11,20,53,59,-6,56,15
519,Port Vale,15,10,21,45,63,-18,55,16
519,Cheltenham,12,11,23,33,61,-28,47,17
519,Bristol Rovers,12,10,24,58,84,-26,46,18
519,Burton Albion,10,14,22,53,84,-31,44,19
519,Morecambe,10,13,23,45,76,-31,43,20
519,Acc'ton Stanley,9,16,21,40,73,-33,43,21
519,MK Dons,10,11,25,41,68,-27,41,22
519,Cambridge Utd,10,10,26,39,74,-35,40,23
519,FG Rovers,5,13,28,34,85,-51,28,24
520,Plymouth Argyle,29,10,7,86,51,35,97,1
520,Sheffield Weds,28,12,6,83,37,46,96,2
520,Bolton,27,10,9,75,36,39,91,3
520,Ipswich Town,22,14,10,82,49,33,80,4
520,Barnsley,23,11,12,70,42,28,80,5
520,Derby County,23,11,12,75,49,26,80,6
520,P'borough Utd,23,7,16,75,53,22,76,7
520,Wycombe,22,9,15,63,43,20,75,8
520,Portsmouth,18,16,12,61,50,11,70,9
520,Lincoln City,15,21,10,47,43,4,66,10
520,Exeter City,17,13,16,61,57,4,64,11
520,Fleetwood Town,16,15,15,52,44,8,63,12
520,Charlton Ath,16,15,15,69,63,6,63,13
520,Shrewsbury,17,10,19,50,49,1,61,14
520,Oxford United,15,13,18,48,52,-4,58,15
520,Port Vale,15,9,22,48,67,-19,54,16
520,Bristol Rovers,13,13,20,66,82,-16,52,17
520,Burton Albion,13,9,24,60,91,-31,48,18
520,Cheltenham,12,11,23,33,64,-31,47,19
520,MK Dons,12,8,26,46,70,-24,44,20
520,Cambridge Utd,11,11,24,38,70,-32,44,21
520,Acc'ton Stanley,8,16,22,38,70,-32,40,22
520,Morecambe,7,15,24,41,81,-40,36,23
520,FG Rovers,5,11,30,29,83,-54,26,24
521,Sheffield Weds,28,10,8,86,36,50,94,1
521,Plymouth Argyle,27,12,7,83,47,36,93,2
521,Derby County,25,12,9,69,37,32,87,3
521,Bolton,26,8,12,74,42,32,86,4
521,Barnsley,27,5,14,65,42,23,86,5
521,Ipswich Town,21,18,7,78,45,33,81,6
521,P'borough Utd,25,6,15,80,48,32,81,7
521,Wycombe,23,8,15,64,41,23,77,8
521,Portsmouth,20,14,12,59,45,14,74,9
521,Shrewsbury,20,11,15,54,44,10,71,10
521,Charlton Ath,16,16,14,68,54,14,64,11
521,Fleetwood Town,15,16,15,48,47,1,61,12
521,Exeter City,15,11,20,60,68,-8,56,13
521,Port Vale,15,11,20,43,58,-15,56,14
521,Bristol Rovers,14,11,21,62,80,-18,53,15
521,Lincoln City,10,20,16,35,50,-15,50,16
521,Burton Albion,13,11,22,55,82,-27,50,17
521,Cheltenham,13,10,23,34,57,-23,49,18
521,Acc'ton Stanley,13,10,23,37,72,-35,49,19
521,Oxford United,12,11,23,41,55,-14,47,20
521,Cambridge Utd,13,7,26,45,72,-27,46,21
521,MK Dons,11,11,24,42,68,-26,44,22
521,Morecambe,9,11,26,42,81,-39,38,23
521,FG Rovers,7,8,31,38,91,-53,29,24
522,Sheffield Weds,29,12,5,79,30,49,99,1
522,Derby County,27,11,8,76,35,41,92,2
522,Barnsley,27,8,11,74,38,36,89,3
522,Ipswich Town,24,16,6,83,45,38,88,4
522,Bolton,26,9,11,70,36,34,87,5
522,Plymouth Argyle,23,13,10,74,52,22,82,6
522,P'borough Utd,24,5,17,85,62,23,77,7
522,Wycombe,21,11,14,63,42,21,74,8
522,Charlton Ath,19,13,14,77,65,12,70,9
522,Portsmouth,18,16,12,60,49,11,70,10
522,Shrewsbury,18,10,18,53,47,6,64,11
522,Lincoln City,13,23,10,43,41,2,62,12
522,Exeter City,16,13,17,58,55,3,61,13
522,Port Vale,16,13,17,54,60,-6,61,14
522,Bristol Rovers,14,13,19,62,74,-12,55,15
522,Fleetwood Town,12,16,18,47,53,-6,52,16
522,Acc'ton Stanley,13,13,20,46,67,-21,52,17
522,Oxford United,13,11,22,48,61,-13,50,18
522,Cheltenham,11,10,25,35,65,-30,43,19
522,Burton Albion,11,9,26,49,94,-45,42,20
522,Cambridge Utd,10,8,28,36,76,-40,38,21
522,Morecambe,9,10,27,39,80,-41,37,22
522,MK Dons,9,9,28,41,76,-35,36,23
522,FG Rovers,8,10,28,34,83,-49,34,24
523,Sheffield Weds,28,12,6,87,34,53,96,1
523,Plymouth Argyle,28,12,6,88,48,40,96,2
523,Barnsley,26,9,11,72,44,28,87,3
523,Bolton,26,8,12,69,33,36,86,4
523,Ipswich Town,21,20,5,84,42,42,83,5
523,Wycombe,24,7,15,68,46,22,79,6
523,Derby County,20,15,11,68,42,26,75,7
523,Portsmouth,19,17,10,68,52,16,74,8
523,P'borough Utd,22,7,17,74,56,18,73,9
523,Shrewsbury,21,10,15,58,47,11,73,10
523,Fleetwood Town,15,16,15,50,47,3,61,11
523,Port Vale,17,10,19,52,62,-10,61,12
523,Charlton Ath,14,18,14,68,62,6,60,13
523,Exeter City,15,13,18,57,60,-3,58,14
523,Oxford United,15,11,20,51,58,-7,56,15
523,Lincoln City,11,22,13,48,51,-3,55,16
523,Bristol Rovers,14,11,21,60,82,-22,53,17
523,Cheltenham,12,11,23,36,64,-28,47,18
523,Acc'ton Stanley,11,14,21,39,68,-29,47,19
523,Burton Albion,12,11,23,52,84,-32,47,20
523,Morecambe,9,11,26,41,78,-37,38,21
523,Cambridge Utd,10,8,28,39,81,-42,38,22
523,MK Dons,9,10,27,37,69,-32,37,23
523,FG Rovers,7,9,30,32,88,-56,30,24
524,Sheffield Weds,29,13,4,77,30,47,100,1
524,Plymouth Argyle,25,15,6,78,46,32,90,2
524,Ipswich Town,24,16,6,84,43,41,88,3
524,Bolton,25,12,9,66,32,34,87,4
524,Barnsley,26,9,11,74,43,31,87,5
524,Derby County,24,12,10,71,44,27,84,6
524,Wycombe,23,9,14,58,42,16,78,7
524,P'borough Utd,23,3,20,72,52,20,72,8
524,Portsmouth,17,17,12,64,56,8,68,9
524,Charlton Ath,17,14,15,65,52,13,65,10
524,Shrewsbury,17,10,19,51,57,-6,61,11
524,Fleetwood Town,13,19,14,46,44,2,58,12
524,Exeter City,15,11,20,58,62,-4,56,13
524,Lincoln City,11,22,13,42,49,-7,55,14
524,Acc'ton Stanley,14,11,21,46,72,-26,53,15
524,Morecambe,13,13,20,48,66,-18,52,16
524,Port Vale,13,13,20,46,64,-18,52,17
524,Oxford United,13,11,22,47,58,-11,50,18
524,Bristol Rovers,13,10,23,61,81,-20,49,19
524,Burton Albion,12,12,22,55,79,-24,48,20
524,MK Dons,12,10,24,40,64,-24,46,21
524,Cheltenham,12,7,27,31,63,-32,43,22
524,Cambridge Utd,9,9,28,37,77,-40,36,23
524,FG Rovers,8,10,28,35,76,-41,34,24
525,Sheffield Weds,32,11,3,91,31,60,107,1
525,Ipswich Town,25,16,5,93,43,50,91,2
525,Barnsley,27,10,9,79,37,42,91,3
525,Plymouth Argyle,27,10,9,82,55,27,91,4
525,Derby County,26,11,9,77,39,38,89,5
525,Bolton,20,15,11,64,37,27,75,6
525,Wycombe,23,6,17,62,47,15,75,7
525,P'borough Utd,22,4,20,76,66,10,70,8
525,Bristol Rovers,19,10,17,68,70,-2,67,9
525,Portsmouth,17,15,14,57,58,-1,66,10
525,Charlton Ath,17,11,18,66,59,7,62,11
525,Fleetwood Town,15,16,15,51,45,6,61,12
525,Shrewsbury,17,10,19,54,56,-2,61,13
525,Lincoln City,13,21,12,44,50,-6,60,14
525,Exeter City,15,13,18,65,66,-1,58,15
525,Port Vale,15,10,21,45,64,-19,55,16
525,MK Dons,15,6,25,50,65,-15,51,17
525,Oxford United,12,14,20,43,54,-11,50,18
525,Burton Albion,12,13,21,58,83,-25,49,19
525,Morecambe,11,13,22,43,73,-30,46,20
525,Acc'ton Stanley,10,11,25,42,78,-36,41,21
525,Cambridge Utd,11,7,28,37,81,-44,40,22
525,Cheltenham,10,8,28,35,68,-33,38,23
525,FG Rovers,6,9,31,31,88,-57,27,24
526,Sheffield Weds,28,14,4,79,31,48,98,1
526,Barnsley,27,10,9,75,38,37,91,2
526,Ipswich Town,23,15,8,82,43,39,84,3
526,Plymouth Argyle,24,12,10,73,52,21,84,4
526,Bolton,24,10,12,69,40,29,82,5
526,P'borough Utd,25,4,17,78,58,20,79,6
526,Derby County,21,13,12,70,44,26,76,7
526,Wycombe,22,9,15,66,49,17,75,8
526,Portsmouth,17,16,13,68,57,11,67,9
526,Shrewsbury,18,11,17,53,47,6,65,10
526,Charlton Ath,16,14,16,63,58,5,62,11
526,Exeter City,15,14,17,55,62,-7,59,12
526,Fleetwood Town,14,16,16,49,45,4,58,13
526,Oxford United,15,12,19,51,53,-2,57,14
526,Lincoln City,12,21,13,50,52,-2,57,15
526,Port Vale,15,11,20,47,62,-15,56,16
526,Bristol Rovers,14,11,21,63,80,-17,53,17
526,MK Dons,15,8,23,46,68,-22,53,18
526,Acc'ton Stanley,11,14,21,35,62,-27,47,19
526,Cheltenham,12,11,23,33,60,-27,47,20
526,Burton Albion,11,11,24,55,89,-34,44,21
526,Cambridge Utd,12,8,26,40,74,-34,44,22
526,Morecambe,10,13,23,47,78,-31,43,23
526,FG Rovers,6,12,28,36,81,-45,30,24
527,Sheffield Weds,30,12,4,79,26,53,102,1
527,Plymouth Argyle,27,11,8,96,53,43,92,2
527,Derby County,27,11,8,88,46,42,92,3
527,Barnsley,28,8,10,78,40,38,92,4
527,Bolton,26,10,10,77,36,41,88,5
527,Ipswich Town,24,16,6,78,43,35,88,6
527,Wycombe,25,7,14,68,43,25,82,7
527,P'borough Utd,24,7,15,78,54,24,79,8
527,Portsmouth,21,14,11,77,54,23,77,9
527,Lincoln City,17,17,12,47,49,-2,68,10
527,Shrewsbury,18,12,16,59,54,5,66,11
527,Fleetwood Town,17,14,15,54,46,8,65,12
527,Charlton Ath,18,11,17,63,56,7,65,13
527,Exeter City,15,10,21,60,65,-5,55,14
527,Bristol Rovers,14,10,22,62,86,-24,52,15
527,MK Dons,13,8,25,48,72,-24,47,16
527,Port Vale,13,7,26,51,78,-27,46,17
527,Oxford United,11,12,23,45,64,-19,45,18
527,Morecambe,9,14,23,40,76,-36,41,19
527,Cheltenham,11,7,28,34,59,-25,40,20
527,Cambridge Utd,11,7,28,39,81,-42,40,21
527,Burton Albion,10,9,27,54,93,-39,39,22
527,Acc'ton Stanley,9,12,25,34,75,-41,39,23
527,FG Rovers,6,10,30,37,97,-60,28,24
528,Plymouth Argyle,29,11,6,86,49,37,98,1
528,Sheffield Weds,28,11,7,81,35,46,95,2
528,Ipswich Town,25,15,6,87,42,45,90,3
528,Bolton,26,11,9,72,34,38,89,4
528,Derby County,24,12,10,74,41,33,84,5
528,Barnsley,24,11,11,72,42,30,83,6
528,Wycombe,24,10,12,68,41,27,82,7
528,Portsmouth,21,16,9,69,48,21,79,8
528,P'borough Utd,21,6,19,68,56,12,69,9
528,Charlton Ath,17,13,16,75,57,18,64,10
528,Fleetwood Town,15,16,15,45,43,2,61,11
528,Shrewsbury,16,11,19,55,57,-2,59,12
528,Lincoln City,12,21,13,42,50,-8,57,13
528,Exeter City,14,14,18,58,59,-1,56,14
528,Port Vale,15,10,21,47,67,-20,55,15
528,Oxford United,13,14,19,45,52,-7,53,16
528,Burton Albion,12,11,23,56,94,-38,47,17
528,Cheltenham,12,10,24,30,58,-28,46,18
528,Morecambe,11,12,23,47,72,-25,45,19
528,Bristol Rovers,11,12,23,58,86,-28,45,20
528,Acc'ton Stanley,11,12,23,39,68,-29,45,21
528,MK Dons,10,12,24,41,69,-28,42,22
528,Cambridge Utd,9,11,26,34,72,-38,38,23
528,FG Rovers,6,10,30,30,87,-57,28,24
529,Sheffield Weds,29,10,7,81,29,52,97,1
529,Plymouth Argyle,29,9,8,88,53,35,96,2
529,Barnsley,29,7,10,75,35,40,94,3
529,Derby County,28,10,8,78,40,38,94,4
529,Ipswich Town,25,13,8,82,39,43,88,5
529,Bolton,25,10,11,64,35,29,85,6
529,Wycombe,23,11,12,64,42,22,80,7
529,P'borough Utd,24,5,17,82,59,23,77,8
529,Portsmouth,19,14,13,66,53,13,71,9
529,Fleetwood Town,17,16,13,50,41,9,67,10
529,Charlton Ath,16,13,17,62,63,-1,61,11
529,Exeter City,15,14,17,59,58,1,59,12
529,Shrewsbury,17,8,21,53,59,-6,59,13
529,Lincoln City,12,20,14,44,51,-7,56,14
529,Port Vale,15,11,20,47,63,-16,56,15
529,Bristol Rovers,14,10,22,61,83,-22,52,16
529,MK Dons,13,8,25,50,70,-20,47,17
529,Morecambe,12,11,23,50,76,-26,47,18
529,Oxford United,11,13,22,47,61,-14,46,19
529,Acc'ton Stanley,10,13,23,37,71,-34,43,20
529,Cambridge Utd,11,9,26,40,71,-31,42,21
529,Burton Albion,11,8,27,52,90,-38,41,22
529,Cheltenham,10,9,27,34,68,-34,39,23
529,FG Rovers,6,10,30,34,90,-56,28,24
530,Sheffield Weds,28,14,4,78,32,46,98,1
530,Ipswich Town,26,16,4,96,44,52,94,2
530,Plymouth Argyle,27,13,6,84,52,32,94,3
530,Bolton,25,11,10,72,37,35,86,4
530,Wycombe,26,7,13,64,40,24,85,5
530,Barnsley,23,11,12,59,40,19,80,6
530,P'borough Utd,23,8,15,77,53,24,77,7
530,Derby County,21,13,12,72,50,22,76,8
530,Portsmouth,18,15,13,63,53,10,69,9
530,Fleetwood Town,16,17,13,51,46,5,65,10
530,Shrewsbury,17,10,19,54,61,-7,61,11
530,Charlton Ath,15,13,18,59,59,0,58,12
530,Exeter City,16,10,20,62,63,-1,58,13
530,Lincoln City,12,21,13,43,41,2,57,14
530,Bristol Rovers,13,15,18,59,69,-10,54,15
530,Burton Albion,14,11,21,63,83,-20,53,16
530,Acc'ton Stanley,12,13,21,46,71,-25,49,17
530,Cheltenham,13,10,23,38,63,-25,49,18
530,Cambridge Utd,13,10,23,42,71,-29,49,19
530,Oxford United,11,13,22,41,55,-14,46,20
530,Port Vale,11,10,25,39,72,-33,43,21
530,Morecambe,10,12,24,43,68,-25,42,22
530,MK Dons,10,9,27,41,72,-31,39,23
530,FG Rovers,6,10,30,33,84,-51,28,24
531,Sheffield Weds,29,11,6,88,32,56,98,1
531,Plymouth Argyle,29,9,8,95,54,41,96,2
531,Ipswich Town,23,19,4,79,39,40,88,3
531,Derby County,24,14,8,79,44,35,86,4
531,Barnsley,25,7,14,74,44,30,82,5
531,Wycombe,24,9,13,69,41,28,81,6
531,Bolton,22,13,11,62,36,26,79,7
531,P'borough Utd,23,6,17,75,56,19,75,8
531,Portsmouth,19,15,12,68,48,20,72,9
531,Shrewsbury,19,12,15,52,45,7,69,10
531,Charlton Ath,16,17,13,71,58,13,65,11
531,Lincoln City,12,22,12,41,48,-7,58,12
531,Port Vale,14,12,20,46,63,-17,54,13
531,Oxford United,14,11,21,47,55,-8,53,14
531,Exeter City,14,11,21,55,66,-11,53,15
531,Bristol Rovers,13,14,19,63,79,-16,53,16
531,Fleetwood Town,12,16,18,46,50,-4,52,17
531,MK Dons,13,9,24,41,64,-23,48,18
531,Burton Albion,11,13,22,56,80,-24,46,19
531,Acc'ton Stanley,11,11,24,37,85,-48,44,20
531,Morecambe,10,13,23,45,76,-31,43,21
531,Cheltenham,11,10,25,33,68,-35,43,22
531,Cambridge Utd,10,9,27,38,75,-37,39,23
531,FG Rovers,8,9,29,33,87,-54,33,24
532,Sheffield Weds,32,11,3,95,29,66,107,1
532,Plymouth Argyle,31,10,5,90,45,45,103,2
532,Ipswich Town,27,14,5,94,39,55,95,3
532,Barnsley,27,7,12,75,40,35,88,4
532,Derby County,25,11,10,72,38,34,86,5
532,Bolton,24,10,12,71,41,30,82,6
532,Wycombe,24,8,14,63,41,22,80,7
532,Portsmouth,20,15,11,65,51,14,75,8
532,Shrewsbury,19,10,17,56,49,7,67,9
532,P'borough Utd,21,4,21,70,65,5,67,10
532,Fleetwood Town,14,16,16,46,45,1,58,11
532,Lincoln City,12,22,12,43,46,-3,58,12
532,Charlton Ath,15,12,19,68,68,0,57,13
532,Port Vale,16,9,21,52,70,-18,57,14
532,Exeter City,15,11,20,54,66,-12,56,15
532,Oxford United,13,13,20,53,59,-6,52,16
532,Bristol Rovers,13,13,20,62,77,-15,52,17
532,Acc'ton Stanley,10,14,22,35,63,-28,44,18
532,MK Dons,12,7,27,37,73,-36,43,19
532,Burton Albion,11,10,25,58,95,-37,43,20
532,Cambridge Utd,11,9,26,35,73,-38,42,21
532,Morecambe,10,11,25,46,78,-32,41,22
532,Cheltenham,10,9,27,30,61,-31,39,23
532,FG Rovers,7,10,29,33,91,-58,31,24
533,Sheffield Weds,32,11,3,80,24,56,107,1
533,Plymouth Argyle,30,10,6,93,42,51,100,2
533,Ipswich Town,25,14,7,75,40,35,89,3
533,Barnsley,27,7,12,75,44,31,88,4
533,Bolton,22,11,13,64,40,24,77,5
533,Portsmouth,21,14,11,71,52,19,77,6
533,Derby County,22,9,15,69,47,22,75,7
533,Wycombe,20,12,14,59,41,18,72,8
533,Fleetwood Town,19,13,14,61,43,18,70,9
533,P'borough Utd,19,9,18,71,59,12,66,10
533,Shrewsbury,18,9,19,52,52,0,63,11
533,Exeter City,16,11,19,58,59,-1,59,12
533,Charlton Ath,14,17,15,61,64,-3,59,13
533,Lincoln City,12,21,13,46,49,-3,57,14
533,Oxford United,14,12,20,56,60,-4,54,15
533,Acc'ton Stanley,13,14,19,39,64,-25,53,16
533,Burton Albion,13,12,21,57,80,-23,51,17
533,Bristol Rovers,13,11,22,60,80,-20,50,18
533,Cheltenham,13,11,22,37,62,-25,50,19
533,MK Dons,13,9,24,43,64,-21,48,20
533,Port Vale,13,9,24,44,68,-24,48,21
533,Cambridge Utd,11,6,29,39,82,-43,39,22
533,Morecambe,7,12,27,42,82,-40,33,23
533,FG Rovers,7,12,27,38,92,-54,33,24
534,Sheffield Weds,30,12,4,88,33,55,102,1
534,Plymouth Argyle,28,11,7,86,49,37,95,2
534,Ipswich Town,25,16,5,90,44,46,91,3
534,Wycombe,25,9,12,69,39,30,84,4
534,Barnsley,24,9,13,72,44,28,81,5
534,Bolton,23,9,14,64,39,25,78,6
534,P'borough Utd,23,8,15,79,54,25,77,7
534,Derby County,22,11,13,67,47,20,77,8
534,Portsmouth,18,17,11,64,52,12,71,9
534,Shrewsbury,19,9,18,52,49,3,66,10
534,Lincoln City,15,20,11,51,48,3,65,11
534,Charlton Ath,15,14,17,58,60,-2,59,12
534,Bristol Rovers,16,11,19,71,76,-5,59,13
534,Exeter City,15,11,20,55,61,-6,56,14
534,Fleetwood Town,13,15,18,49,47,2,54,15
534,Cheltenham,15,8,23,40,62,-22,53,16
534,Oxford United,12,13,21,43,55,-12,49,17
534,Port Vale,13,10,23,45,69,-24,49,18
534,Acc'ton Stanley,12,13,21,41,68,-27,49,19
534,Morecambe,12,12,22,45,68,-23,48,20
534,MK Dons,13,7,26,45,72,-27,46,21
534,Burton Albion,12,9,25,54,95,-41,45,22
534,Cambridge Utd,10,9,27,37,70,-33,39,23
534,FG Rovers,6,9,31,32,96,-64,27,24
535,Sheffield Weds,29,12,5,83,34,49,99,1
535,Plymouth Argyle,29,11,6,96,51,45,98,2
535,Barnsley,26,9,11,72,43,29,87,3
535,Derby County,24,14,8,78,43,35,86,4
535,Bolton,24,12,10,69,33,36,84,5
535,Ipswich Town,22,16,8,76,42,34,82,6
535,Wycombe,23,9,14,62,44,18,78,7
535,P'borough Utd,24,3,19,79,57,22,75,8
535,Shrewsbury,20,11,15,58,47,11,71,9
535,Charlton Ath,18,13,15,65,56,9,67,10
535,Fleetwood Town,16,17,13,48,40,8,65,11
535,Portsmouth,16,16,14,61,54,7,64,12
535,Lincoln City,11,23,12,49,53,-4,56,13
535,Exeter City,13,14,19,58,65,-7,53,14
535,Burton Albion,13,14,19,54,74,-20,53,15
535,Port Vale,14,10,22,46,62,-16,52,16
535,Bristol Rovers,14,10,22,56,84,-28,52,17
535,Oxford United,13,12,21,47,59,-12,51,18
535,Cheltenham,12,9,25,30,61,-31,45,19
535,Cambridge Utd,11,9,26,37,76,-39,42,20
535,MK Dons,10,9,27,39,72,-33,39,21
535,Acc'ton Stanley,8,14,24,36,68,-32,38,22
535,Morecambe,8,13,25,39,77,-38,37,23
535,FG Rovers,8,12,26,33,76,-43,36,24
536,Sheffield Weds,29,14,3,82,29,53,101,1
536,Plymouth Argyle,28,9,9,90,58,32,93,2
536,Derby County,26,11,9,84,41,43,89,3
536,Ipswich Town,23,16,7,84,44,40,85,4
536,Barnsley,22,11,13,65,46,19,77,5
536,Wycombe,21,12,13,61,43,18,75,6
536,P'borough Utd,22,7,17,79,62,17,73,7
536,Bolton,20,12,14,59,42,17,72,8
536,Fleetwood Town,18,16,12,58,44,14,70,9
536,Charlton Ath,17,15,14,68,61,7,66,10
536,Portsmouth,16,16,14,60,54,6,64,11
536,Exeter City,17,12,17,61,58,3,63,12
536,Shrewsbury,18,9,19,51,51,0,63,13
536,Lincoln City,12,23,11,49,48,1,59,14
536,Bristol Rovers,13,14,19,65,77,-12,53,15
536,Oxford United,14,10,22,55,61,-6,52,16
536,Port Vale,13,11,22,44,70,-26,50,17
536,Burton Albion,12,13,21,53,82,-29,49,18
536,Cheltenham,12,11,23,38,64,-26,47,19
536,Morecambe,11,12,23,43,73,-30,45,20
536,Acc'ton Stanley,10,15,21,40,70,-30,45,21
536,Cambridge Utd,11,9,26,37,73,-36,42,22
536,MK Dons,9,10,27,39,69,-30,37,23
536,FG Rovers,8,12,26,43,88,-45,36,24
537,Barnsley,30,6,10,84,42,42,96,1
537,Sheffield Weds,28,11,7,81,38,43,95,2
537,Plymouth Argyle,27,12,7,85,51,34,93,3
537,Derby County,27,9,10,77,39,38,90,4
537,Ipswich Town,23,17,6,76,39,37,86,5
537,Bolton,25,10,11,71,39,32,85,6
537,Wycombe,24,8,14,66,46,20,80,7
537,P'borough Utd,24,5,17,78,57,21,77,8
537,Portsmouth,16,19,11,59,48,11,67,9
537,Lincoln City,13,23,10,46,42,4,62,10
537,Port Vale,17,10,19,52,62,-10,61,11
537,Fleetwood Town,15,15,16,50,49,1,60,12
537,Shrewsbury,17,9,20,49,56,-7,60,13
537,Charlton Ath,14,16,16,64,60,4,58,14
537,Burton Albion,15,9,22,64,80,-16,54,15
537,Exeter City,14,11,21,59,66,-7,53,16
537,Oxford United,13,11,22,49,65,-16,50,17
537,Bristol Rovers,13,11,22,62,79,-17,50,18
537,Cheltenham,13,11,22,37,60,-23,50,19
537,Acc'ton Stanley,12,12,22,35,61,-26,48,20
537,Cambridge Utd,11,8,27,35,77,-42,41,21
537,Morecambe,9,12,25,43,78,-35,39,22
537,MK Dons,9,10,27,47,79,-32,37,23
537,FG Rovers,6,9,31,36,92,-56,27,24
538,Sheffield Weds,32,9,5,82,27,55,105,1
538,Plymouth Argyle,26,11,9,83,56,27,89,2
538,Ipswich Town,25,13,8,89,50,39,88,3
538,Bolton,26,10,10,71,34,37,88,4
538,Barnsley,27,7,12,77,44,33,88,5
538,Derby County,24,13,9,75,43,32,85,6
538,P'borough Utd,22,8,16,72,55,17,74,7
538,Wycombe,21,9,16,63,46,17,72,8
538,Shrewsbury,19,11,16,54,41,13,68,9
538,Fleetwood Town,18,14,14,56,48,8,68,10
538,Portsmouth,17,13,16,65,56,9,64,11
538,Charlton Ath,15,15,16,71,63,8,60,12
538,Lincoln City,13,21,12,46,47,-1,60,13
538,Exeter City,16,11,19,66,67,-1,59,14
538,Port Vale,16,11,19,56,69,-13,59,15
538,Oxford United,14,12,20,48,54,-6,54,16
538,Cambridge Utd,14,8,24,44,71,-27,50,17
538,Acc'ton Stanley,11,13,22,46,71,-25,46,18
538,Cheltenham,12,10,24,33,64,-31,46,19
538,Burton Albion,12,10,24,53,88,-35,46,20
538,MK Dons,11,10,25,44,72,-28,43,21
538,Bristol Rovers,11,9,26,56,91,-35,42,22
538,Morecambe,8,14,24,43,81,-38,38,23
538,FG Rovers,6,10,30,35,90,-55,28,24
539,Sheffield Weds,32,9,5,83,29,54,105,1
539,Plymouth Argyle,30,10,6,90,47,43,100,2
539,Barnsley,29,7,10,76,40,36,94,3
539,Ipswich Town,23,16,7,84,43,41,85,4
539,Bolton,23,11,12,70,37,33,80,5
539,P'borough Utd,24,4,18,76,56,20,76,6
539,Derby County,21,11,14,66,41,25,74,7
539,Wycombe,21,10,15,63,41,22,73,8
539,Shrewsbury,21,9,16,58,45,13,72,9
539,Portsmouth,18,17,11,59,48,11,71,10
539,Fleetwood Town,17,14,15,52,46,6,65,11
539,Charlton Ath,16,15,15,65,53,12,63,12
539,Port Vale,17,10,19,53,66,-13,61,13
539,Lincoln City,14,18,14,49,49,0,60,14
539,Cheltenham,15,8,23,41,58,-17,53,15
539,Bristol Rovers,14,9,23,58,86,-28,51,16
539,Oxford United,13,11,22,49,62,-13,50,17
539,Exeter City,13,11,22,55,69,-14,50,18
539,Burton Albion,12,10,24,54,91,-37,46,19
539,Acc'ton Stanley,10,14,22,38,70,-32,44,20
539,Morecambe,10,12,24,46,81,-35,42,21
539,MK Dons,10,10,26,41,66,-25,40,22
539,Cambridge Utd,10,6,30,33,81,-48,36,23
539,FG Rovers,9,8,29,36,90,-54,35,24
540,Sheffield Weds,29,13,4,80,30,50,100,1
540,Plymouth Argyle,27,12,7,80,47,33,93,2
540,Ipswich Town,25,16,5,81,39,42,91,3
540,Barnsley,27,8,11,74,43,31,89,4
540,Bolton,24,9,13,68,39,29,81,5
540,Derby County,22,14,10,74,45,29,80,6
540,Wycombe,22,9,15,57,44,13,75,7
540,Portsmouth,19,15,12,58,50,8,72,8
540,Shrewsbury,19,9,18,57,54,3,66,9
540,P'borough Utd,20,5,21,71,66,5,65,10
540,Charlton Ath,17,13,16,67,59,8,64,11
540,Fleetwood Town,15,16,15,56,46,10,61,12
540,Lincoln City,12,24,10,46,46,0,60,13
540,Exeter City,15,14,17,57,54,3,59,14
540,Burton Albion,15,11,20,60,78,-18,56,15
540,Oxford United,14,13,19,53,59,-6,55,16
540,Port Vale,15,10,21,52,66,-14,55,17
540,Bristol Rovers,13,13,20,60,79,-19,52,18
540,Cheltenham,12,10,24,36,60,-24,46,19
540,MK Dons,10,13,23,42,67,-25,43,20
540,Morecambe,9,13,24,46,79,-33,40,21
540,Cambridge Utd,9,10,27,37,76,-39,37,22
540,Acc'ton Stanley,7,15,24,35,72,-37,36,23
540,FG Rovers,6,13,27,38,87,-49,31,24
541,Sheffield Weds,30,12,4,90,31,59,102,1
541,Ipswich Town,26,14,6,89,43,46,92,2
541,Derby County,26,10,10,75,43,32,88,3
541,Plymouth Argyle,26,10,10,77,51,26,88,4
541,Bolton,22,14,10,61,33,28,80,5
541,P'borough Utd,24,7,15,84,55,29,79,6
541,Barnsley,22,13,11,64,43,21,79,7
541,Wycombe,23,7,16,62,44,18,76,8
541,Portsmouth,20,14,12,63,48,15,74,9
541,Charlton Ath,18,11,17,66,59,7,65,10
541,Shrewsbury,19,8,19,54,55,-1,65,11
541,Fleetwood Town,16,15,15,50,43,7,63,12
541,Lincoln City,12,23,11,38,45,-7,59,13
541,Bristol Rovers,15,13,18,67,78,-11,58,14
541,Exeter City,15,12,19,55,59,-4,57,15
541,Port Vale,16,8,22,51,68,-17,56,16
541,Oxford United,13,12,21,47,56,-9,51,17
541,Morecambe,12,12,22,47,71,-24,48,18
541,Burton Albion,12,12,22,53,80,-27,48,19
541,Acc'ton Stanley,11,11,24,34,72,-38,44,20
541,MK Dons,11,9,26,47,71,-24,42,21
541,Cheltenham,11,8,27,33,69,-36,41,22
541,Cambridge Utd,11,6,29,43,76,-33,39,23
541,FG Rovers,6,9,31,34,91,-57,27,24
542,Sheffield Weds,32,10,4,92,26,66,106,1
542,Plymouth Argyle,30,10,6,88,46,42,100,2
542,Ipswich Town,24,16,6,78,39,39,88,3
542,Derby County,25,11,10,74,44,30,86,4
542,Barnsley,25,10,11,70,43,27,85,5
542,Bolton,24,10,12,66,39,27,82,6
542,Wycombe,24,7,15,68,42,26,79,7
542,P'borough Utd,21,10,15,74,52,22,73,8
542,Portsmouth,17,15,14,65,59,6,66,9
542,Charlton Ath,17,14,15,68,57,11,65,10
542,Lincoln City,14,23,9,47,43,4,65,11
542,Fleetwood Town,16,15,15,54,48,6,63,12
542,Shrewsbury,17,9,20,53,54,-1,60,13
542,Exeter City,14,12,20,56,60,-4,54,14
542,Port Vale,15,8,23,46,68,-22,53,15
542,Acc'ton Stanley,12,14,20,37,65,-28,50,16
542,Oxford United,12,13,21,50,59,-9,49,17
542,Morecambe,12,12,22,49,73,-24,48,18
542,Cambridge Utd,14,6,26,39,73,-34,48,19
542,Burton Albion,12,9,25,53,86,-33,45,20
542,Cheltenham,11,11,24,34,66,-32,44,21
542,Bristol Rovers,11,9,26,64,91,-27,42,22
542,MK Dons,10,10,26,36,64,-28,40,23
542,FG Rovers,6,10,30,32,96,-64,28,24
543,Sheffield Weds,27,13,6,82,35,47,94,1
543,Ipswich Town,25,16,5,83,40,43,91,2
543,Derby County,26,11,9,80,41,39,89,3
543,Plymouth Argyle,26,11,9,86,54,32,89,4
543,Bolton,22,12,12,67,41,26,78,5
543,Barnsley,21,12,13,63,45,18,75,6
543,Portsmouth,19,16,11,67,51,16,73,7
543,P'borough Utd,22,6,18,77,59,18,72,8
543,Wycombe,20,8,18,56,49,7,68,9
543,Shrewsbury,17,13,16,54,49,5,64,10
543,Charlton Ath,16,15,15,65,59,6,63,11
543,Exeter City,15,17,14,58,54,4,62,12
543,Lincoln City,12,23,11,42,43,-1,59,13
543,Fleetwood Town,14,16,16,46,45,1,58,14
543,Port Vale,15,11,20,49,65,-16,56,15
543,Bristol Rovers,15,10,21,66,85,-19,55,16
543,Burton Albion,14,12,20,54,77,-23,54,17
543,Oxford United,13,12,21,45,59,-14,51,18
543,Morecambe,11,17,18,49,66,-17,50,19
543,MK Dons,12,11,23,39,65,-26,47,20
543,Acc'ton Stanley,11,13,22,40,70,-30,46,21
543,Cheltenham,11,12,23,35,60,-25,45,22
543,Cambridge Utd,9,7,30,33,77,-44,34,23
543,FG Rovers,7,10,29,34,81,-47,31,24
544,Plymouth Argyle,29,11,6,99,50,49,98,1
544,Sheffield Weds,28,13,5,82,36,46,97,2
544,Barnsley,28,8,10,86,43,43,92,3
544,Ipswich Town,24,16,6,82,43,39,88,4
544,Bolton,24,9,13,70,41,29,81,5
544,Derby County,21,14,11,72,46,26,77,6
544,Portsmouth,20,15,11,68,55,13,75,7
544,Wycombe,21,9,16,64,47,17,72,8
544,Fleetwood Town,19,12,15,56,47,9,69,9
544,Shrewsbury,18,9,19,64,58,6,63,10
544,P'borough Utd,18,8,20,80,74,6,62,11
544,Lincoln City,12,22,12,46,57,-11,58,12
544,Port Vale,15,12,19,47,62,-15,57,13
544,Charlton Ath,13,16,17,66,63,3,55,14
544,Bristol Rovers,14,12,20,59,77,-18,54,15
544,Acc'ton Stanley,13,15,18,46,70,-24,54,16
544,Exeter City,12,14,20,59,71,-12,50,17
544,Burton Albion,12,12,22,61,88,-27,48,18
544,Cheltenham,12,12,22,33,60,-27,48,19
544,Oxford United,10,16,20,46,59,-13,46,20
544,Cambridge Utd,12,10,24,48,80,-32,46,21
544,Morecambe,9,15,22,48,74,-26,42,22
544,MK Dons,10,11,25,40,69,-29,41,23
544,FG Rovers,6,13,27,37,89,-52,31,24
545,Sheffield Weds,27,14,5,79,32,47,95,1
545,Ipswich Town,27,14,5,87,41,46,95,2
545,Plymouth Argyle,26,14,6,83,48,35,92,3
545,Derby County,23,13,10,74,37,37,82,4
545,Bolton,23,13,10,64,36,28,82,5
545,Barnsley,24,9,13,68,40,28,81,6
545,Wycombe,24,8,14,72,45,27,80,7
545,P'borough Utd,23,6,17,80,55,25,75,8
545,Portsmouth,19,15,12,64,51,13,72,9
545,Charlton Ath,18,14,14,70,61,9,68,10
545,Exeter City,17,14,15,64,56,8,65,11
545,Shrewsbury,17,13,16,54,48,6,64,12
545,Fleetwood Town,15,17,14,56,50,6,62,13
545,Oxford United,16,10,20,52,55,-3,58,14
545,Bristol Rovers,14,14,18,68,82,-14,56,15
545,Port Vale,15,10,21,44,63,-19,55,16
545,Lincoln City,10,23,13,42,49,-7,53,17
545,Acc'ton Stanley,11,13,22,39,74,-35,46,18
545,MK Dons,12,8,26,42,73,-31,44,19
545,Morecambe,9,13,24,44,73,-29,40,20
545,Cheltenham,9,13,24,27,61,-34,40,21
545,Burton Albion,10,10,26,53,94,-41,40,22
545,Cambridge Utd,9,10,27,30,71,-41,37,23
545,FG Rovers,5,10,31,31,92,-61,25,24
546,Sheffield Weds,27,14,5,75,31,44,95,1
546,Plymouth Argyle,26,11,9,84,53,31,89,2
546,Bolton,24,12,10,66,34,32,84,3
546,Ipswich Town,23,14,9,79,49,30,83,4
546,Derby County,23,12,11,77,49,28,81,5
546,Wycombe,24,9,13,63,43,20,81,6
546,Barnsley,24,8,14,72,45,27,80,7
546,P'borough Utd,23,7,16,75,50,25,76,8
546,Portsmouth,19,16,11,69,51,18,73,9
546,Charlton Ath,18,13,15,63,55,8,67,10
546,Fleetwood Town,16,17,13,51,42,9,65,11
546,Lincoln City,14,22,10,46,44,2,64,12
546,Shrewsbury,18,10,18,51,52,-1,64,13
546,Exeter City,14,13,19,56,63,-7,55,14
546,Bristol Rovers,13,11,22,60,78,-18,50,15
546,Port Vale,13,11,22,45,66,-21,50,16
546,Morecambe,12,13,21,52,76,-24,49,17
546,Oxford United,11,15,20,49,60,-11,48,18
546,Acc'ton Stanley,10,16,20,43,66,-23,46,19
546,Cheltenham,11,13,22,34,58,-24,46,20
546,Burton Albion,11,13,22,58,84,-26,46,21
546,Cambridge Utd,11,11,24,34,67,-33,44,22
546,MK Dons,10,9,27,42,74,-32,39,23
546,FG Rovers,5,14,27,31,85,-54,29,24
547,Sheffield Weds,29,11,6,86,33,53,98,1
547,Derby County,26,12,8,79,37,42,90,2
547,Wycombe,28,6,12,70,41,29,90,3
547,Plymouth Argyle,25,12,9,76,52,24,87,4
547,Barnsley,25,11,10,70,38,32,86,5
547,Ipswich Town,22,17,7,79,42,37,83,6
547,Bolton,23,11,12,65,36,29,80,7
547,Portsmouth,21,13,12,70,50,20,76,8
547,P'borough Utd,21,8,17,77,56,21,71,9
547,Lincoln City,15,22,9,46,42,4,67,10
547,Charlton Ath,17,13,16,67,60,7,64,11
547,Fleetwood Town,16,14,16,47,46,1,62,12
547,Shrewsbury,18,7,21,52,59,-7,61,13
547,Cheltenham,16,10,20,39,52,-13,58,14
547,Bristol Rovers,15,10,21,59,75,-16,55,15
547,Port Vale,15,10,21,43,62,-19,55,16
547,Exeter City,12,13,21,52,63,-11,49,17
547,Burton Albion,12,9,25,50,86,-36,45,18
547,MK Dons,10,13,23,42,64,-22,43,19
547,Morecambe,9,16,21,45,70,-25,43,20
547,Cambridge Utd,12,6,28,36,71,-35,42,21
547,Oxford United,9,14,23,41,62,-21,41,22
547,Acc'ton Stanley,9,14,23,37,74,-37,41,23
547,FG Rovers,6,10,30,35,92,-57,28,24
548,Sheffield Weds,29,12,5,84,33,51,99,1
548,Ipswich Town,28,14,4,85,34,51,98,2
548,Plymouth Argyle,26,11,9,82,51,31,89,3
548,Barnsley,26,10,10,72,43,29,88,4
548,Derby County,24,12,10,73,40,33,84,5
548,Bolton,22,11,13,62,39,23,77,6
548,Wycombe,22,9,15,66,44,22,75,7
548,P'borough Utd,21,9,16,73,60,13,72,8
548,Portsmouth,18,17,11,66,50,16,71,9
548,Charlton Ath,17,14,15,70,57,13,65,10
548,Exeter City,18,11,17,60,59,1,65,11
548,Shrewsbury,16,14,16,54,52,2,62,12
548,Lincoln City,13,23,10,44,43,1,62,13
548,Bristol Rovers,17,9,20,69,81,-12,60,14
548,Fleetwood Town,15,14,17,50,50,0,59,15
548,Port Vale,16,9,21,48,69,-21,57,16
548,Burton Albion,12,12,22,60,80,-20,48,17
548,Cambridge Utd,12,10,24,40,69,-29,46,18
548,Acc'ton Stanley,10,13,23,41,74,-33,43,19
548,Cheltenham,11,10,25,34,68,-34,43,20
548,Oxford United,9,14,23,40,58,-18,41,21
548,MK Dons,10,9,27,38,70,-32,39,22
548,Morecambe,8,13,25,40,77,-37,37,23
548,FG Rovers,7,10,29,33,83,-50,31,24
549,Sheffield Weds,28,15,3,75,30,45,99,1
549,Derby County,25,13,8,72,40,32,88,2
549,Plymouth Argyle,24,15,7,81,52,29,87,3
549,Ipswich Town,23,16,7,80,44,36,85,4
549,Barnsley,24,11,11,75,44,31,83,5
549,Wycombe,23,9,14,60,42,18,78,6
549,Bolton,19,15,12,62,39,23,72,7
549,P'borough Utd,22,6,18,71,55,16,72,8
549,Portsmouth,16,18,12,60,50,10,66,9
549,Shrewsbury,18,11,17,52,53,-1,65,10
549,Charlton Ath,16,16,14,71,63,8,64,11
549,Fleetwood Town,15,16,15,51,48,3,61,12
549,Exeter City,15,13,18,61,55,6,58,13
549,Port Vale,16,9,21,50,65,-15,57,14
549,Bristol Rovers,13,13,20,63,78,-15,52,15
549,Lincoln City,9,24,13,41,48,-7,51,16
549,Cheltenham,14,9,23,35,58,-23,51,17
549,Burton Albion,14,9,23,65,93,-28,51,18
549,Morecambe,12,13,21,47,70,-23,49,19
549,Acc'ton Stanley,10,15,21,40,68,-28,45,20
549,MK Dons,11,11,24,42,67,-25,44,21
549,Oxford United,10,13,23,43,59,-16,43,22
549,Cambridge Utd,11,9,26,38,70,-32,42,23
549,FG Rovers,8,13,25,35,79,-44,37,24
550,Sheffield Weds,28,11,7,88,36,52,95,1
550,Plymouth Argyle,27,11,8,90,50,40,92,2
550,Barnsley,28,8,10,80,42,38,92,3
550,Ipswich Town,25,14,7,84,42,42,89,4
550,Derby County,25,10,11,74,42,32,85,5
550,Wycombe,24,8,14,60,41,19,80,6
550,Bolton,22,12,12,66,38,28,78,7
550,Shrewsbury,23,9,14,61,48,13,78,8
550,P'borough Utd,21,8,17,74,59,15,71,9
550,Portsmouth,18,17,11,66,54,12,71,10
550,Charlton Ath,16,14,16,65,63,2,62,11
550,Fleetwood Town,14,16,16,51,49,2,58,12
550,Exeter City,15,12,19,58,62,-4,57,13
550,Bristol Rovers,15,12,19,70,79,-9,57,14
550,Port Vale,15,12,19,45,62,-17,57,15
550,Lincoln City,11,21,14,39,48,-9,54,16
550,Oxford United,12,13,21,44,58,-14,49,17
550,Burton Albion,12,12,22,54,83,-29,48,18
550,Cheltenham,13,6,27,37,65,-28,45,19
550,Acc'ton Stanley,10,13,23,35,76,-41,43,20
550,Morecambe,10,12,24,45,77,-32,42,21
550,Cambridge Utd,11,9,26,38,70,-32,42,22
550,MK Dons,8,11,27,36,69,-33,35,23
550,FG Rovers,7,13,26,37,84,-47,34,24
551,Sheffield Weds,30,12,4,78,28,50,102,1
551,Plymouth Argyle,31,8,7,91,49,42,101,2
551,Ipswich Town,23,17,6,81,40,41,86,3
551,Barnsley,25,9,12,74,44,30,84,4
551,Derby County,24,11,11,78,43,35,83,5
551,Bolton,23,12,11,64,36,28,81,6
551,Wycombe,23,7,16,67,46,21,76,7
551,Fleetwood Town,20,14,12,57,42,15,74,8
551,P'borough Utd,21,8,17,73,59,14,71,9
551,Portsmouth,18,14,14,64,56,8,68,10
551,Shrewsbury,18,10,18,53,52,1,64,11
551,Charlton Ath,17,12,17,63,55,8,63,12
551,Exeter City,17,9,20,58,62,-4,60,13
551,Bristol Rovers,16,10,20,65,75,-10,58,14
551,Lincoln City,12,20,14,43,50,-7,56,15
551,Port Vale,15,11,20,44,60,-16,56,16
551,Oxford United,13,14,19,49,56,-7,53,17
551,Cambridge Utd,13,7,26,38,68,-30,46,18
551,Acc'ton Stanley,10,15,21,40,72,-32,45,19
551,MK Dons,12,8,26,43,72,-29,44,20
551,Cheltenham,11,8,27,28,61,-33,41,21
551,Burton Albion,10,11,25,48,84,-36,41,22
551,Morecambe,9,12,25,45,81,-36,39,23
551,FG Rovers,6,11,29,38,91,-53,29,24
552,Sheffield Weds,29,13,4,83,31,52,100,1
552,Plymouth Argyle,29,11,6,96,49,47,98,2
552,Ipswich Town,26,14,6,84,40,44,92,3
552,Barnsley,27,8,11,79,45,34,89,4
552,Derby County,23,12,11,80,43,37,81,5
552,Bolton,22,13,11,64,36,28,79,6
552,Wycombe,23,8,15,64,44,20,77,7
552,Portsmouth,19,16,11,68,51,17,73,8
552,Shrewsbury,21,9,16,64,49,15,72,9
552,P'borough Utd,21,7,18,71,58,13,70,10
552,Fleetwood Town,17,13,16,55,45,10,64,11
552,Charlton Ath,16,12,18,68,68,0,60,12
552,Lincoln City,11,24,11,43,46,-3,57,13
552,Exeter City,14,12,20,61,70,-9,54,14
552,Port Vale,13,12,21,46,69,-23,51,15
552,Bristol Rovers,13,11,22,62,84,-22,50,16
552,Burton Albion,13,10,23,55,86,-31,49,17
552,Oxford United,12,12,22,47,56,-9,48,18
552,Cheltenham,11,14,21,36,63,-27,47,19
552,Cambridge Utd,12,10,24,39,71,-32,46,20
552,MK Dons,10,10,26,37,71,-34,40,21
552,Acc'ton Stanley,8,15,23,34,73,-39,39,22
552,Morecambe,8,14,24,42,83,-41,38,23
552,FG Rovers,9,10,27,38,85,-47,37,24
553,Sheffield Weds,30,11,5,80,30,50,101,1
553,Plymouth Argyle,27,12,7,84,48,36,93,2
553,Ipswich Town,25,15,6,89,44,45,90,3
553,Derby County,24,13,9,76,41,35,85,4
553,Barnsley,25,9,12,76,44,32,84,5
553,Wycombe,24,10,12,64,41,23,82,6
553,Portsmouth,22,14,10,79,54,25,80,7
553,Bolton,21,12,13,64,42,22,75,8
553,P'borough Utd,21,5,20,75,64,11,68,9
553,Charlton Ath,16,16,14,66,57,9,64,10
553,Lincoln City,14,21,11,51,51,0,63,11
553,Bristol Rovers,17,11,18,67,75,-8,62,12
553,Fleetwood Town,15,16,15,56,48,8,61,13
553,Shrewsbury,17,9,20,53,61,-8,60,14
553,Exeter City,13,16,17,62,62,0,55,15
553,Port Vale,13,12,21,48,72,-24,51,16
553,Oxford United,12,12,22,54,66,-12,48,17
553,Morecambe,11,14,21,49,67,-18,47,18
553,Burton Albion,12,10,24,54,91,-37,46,19
553,Acc'ton Stanley,10,15,21,35,66,-31,45,20
553,Cheltenham,11,10,25,32,63,-31,43,21
553,Cambridge Utd,11,8,27,39,78,-39,41,22
553,MK Dons,9,11,26,38,68,-30,38,23
553,FG Rovers,6,10,30,31,89,-58,28,24
554,Sheffield Weds,30,9,7,85,35,50,99,1
554,Plymouth Argyle,29,10,7,93,49,44,97,2
554,Ipswich Town,24,16,6,83,42,41,88,3
554,Barnsley,27,7,12,73,45,28,88,4
554,Bolton,25,12,9,71,35,36,87,5
554,Derby County,24,14,8,69,35,34,86,6
554,Wycombe,23,8,15,63,40,23,77,7
554,P'borough Utd,22,8,16,76,56,20,74,8
554,Portsmouth,20,13,13,64,54,10,73,9
554,Shrewsbury,21,8,17,57,50,7,71,10
554,Charlton Ath,17,13,16,62,59,3,64,11
554,Port Vale,17,9,20,51,62,-11,60,12
554,Lincoln City,12,23,11,39,42,-3,59,13
554,Fleetwood Town,14,16,16,49,43,6,58,14
554,Oxford United,15,9,22,50,56,-6,54,15
554,Cheltenham,14,7,25,35,60,-25,49,16
554,Exeter City,11,14,21,51,65,-14,47,17
554,Acc'ton Stanley,10,16,20,39,64,-25,46,18
554,Bristol Rovers,12,10,24,57,85,-28,46,19
554,Burton Albion,11,11,24,57,96,-39,44,20
554,MK Dons,11,10,25,41,70,-29,43,21
554,Morecambe,10,11,25,39,71,-32,41,22
554,Cambridge Utd,9,10,27,35,73,-38,37,23
554,FG Rovers,8,8,30,35,87,-52,32,24
555,Plymouth Argyle,30,9,7,91,46,45,99,1
555,Wycombe,27,8,11,78,37,41,89,2
555,Bolton,25,12,9,72,36,36,87,3
555,Sheffield Weds,24,14,8,70,31,39,86,4
555,Derby County,24,13,9,77,45,32,85,5
555,Barnsley,25,8,13,71,45,26,83,6
555,Ipswich Town,22,15,9,83,51,32,81,7
555,P'borough Utd,23,6,17,75,57,18,75,8
555,Portsmouth,18,16,12,61,48,13,70,9
555,Shrewsbury,18,12,16,55,49,6,66,10
555,Fleetwood Town,15,16,15,47,42,5,61,11
555,Port Vale,17,9,20,51,64,-13,60,12
555,Charlton Ath,14,15,17,56,60,-4,57,13
555,Exeter City,15,12,19,56,66,-10,57,14
555,Bristol Rovers,15,9,22,58,77,-19,54,15
555,Lincoln City,9,24,13,37,46,-9,51,16
555,Oxford United,12,14,20,49,59,-10,50,17
555,Acc'ton Stanley,12,12,22,39,65,-26,48,18
555,Burton Albion,12,12,22,59,91,-32,48,19
555,MK Dons,12,10,24,43,67,-24,46,20
555,Cambridge Utd,13,6,27,41,69,-28,45,21
555,Morecambe,9,16,21,44,68,-24,43,22
555,Cheltenham,10,12,24,33,63,-30,42,23
555,FG Rovers,6,10,30,34,98,-64,28,24
556,Plymouth Argyle,29,11,6,84,50,34,98,1
556,Sheffield Weds,27,13,6,79,34,45,94,2
556,Derby County,25,11,10,76,42,34,86,3
556,Bolton,25,11,10,70,37,33,86,4
556,Ipswich Town,23,16,7,82,44,38,85,5
556,Barnsley,25,10,11,76,43,33,85,6
556,Wycombe,24,10,12,67,37,30,82,7
556,P'borough Utd,23,7,16,79,56,23,76,8
556,Charlton Ath,20,12,14,79,51,28,72,9
556,Shrewsbury,19,10,17,56,54,2,67,10
556,Portsmouth,17,15,14,60,55,5,66,11
556,Fleetwood Town,16,14,16,52,50,2,62,12
556,Lincoln City,14,19,13,44,48,-4,61,13
556,Bristol Rovers,14,13,19,65,78,-13,55,14
556,Exeter City,13,14,19,55,62,-7,53,15
556,Port Vale,14,10,22,43,59,-16,52,16
556,Acc'ton Stanley,12,14,20,38,67,-29,50,17
556,Oxford United,12,11,23,49,60,-11,47,18
556,Cheltenham,12,10,24,39,67,-28,46,19
556,Burton Albion,12,8,26,50,94,-44,44,20
556,MK Dons,11,10,25,43,70,-27,43,21
556,Morecambe,9,15,22,45,73,-28,42,22
556,FG Rovers,7,11,28,33,89,-56,32,23
556,Cambridge Utd,8,7,31,33,77,-44,31,24
557,Sheffield Weds,31,12,3,96,32,64,105,1
557,Plymouth Argyle,29,10,7,100,50,50,97,2
557,Ipswich Town,23,16,7,78,42,36,85,3
557,Derby County,24,12,10,82,45,37,84,4
557,Barnsley,26,6,14,67,47,20,84,5
557,Bolton,23,13,10,71,36,35,82,6
557,P'borough Utd,23,7,16,81,59,22,76,7
557,Portsmouth,19,17,10,63,46,17,74,8
557,Wycombe,22,7,17,62,45,17,73,9
557,Shrewsbury,20,10,16,57,47,10,70,10
557,Charlton Ath,16,15,15,67,59,8,63,11
557,Fleetwood Town,14,18,14,49,46,3,60,12
557,Exeter City,16,12,18,62,65,-3,60,13
557,Lincoln City,13,19,14,47,54,-7,58,14
557,Port Vale,14,9,23,47,70,-23,51,15
557,Bristol Rovers,14,9,23,61,86,-25,51,16
557,Acc'ton Stanley,11,16,19,38,63,-25,49,17
557,Morecambe,12,12,22,48,75,-27,48,18
557,Cheltenham,13,7,26,41,71,-30,46,19
557,Oxford United,11,12,23,46,66,-20,45,20
557,Burton Albion,12,9,25,59,95,-36,45,21
557,MK Dons,11,9,26,43,73,-30,42,22
557,Cambridge Utd,10,10,26,38,77,-39,40,23
557,FG Rovers,6,11,29,37,91,-54,29,24
558,Sheffield Weds,31,9,6,93,31,62,102,1
558,Ipswich Town,26,15,5,93,45,48,93,2
558,Plymouth Argyle,26,13,7,85,52,33,91,3
558,Barnsley,26,9,11,78,43,35,87,4
558,Bolton,24,11,11,70,41,29,83,5
558,Derby County,24,11,11,67,41,26,83,6
558,P'borough Utd,23,5,18,73,57,16,74,7
558,Wycombe,21,10,15,60,43,17,73,8
558,Portsmouth,19,15,12,64,52,12,72,9
558,Charlton Ath,16,15,15,68,57,11,63,10
558,Port Vale,18,8,20,50,64,-14,62,11
558,Fleetwood Town,14,19,13,48,41,7,61,12
558,Exeter City,17,10,19,62,73,-11,61,13
558,Shrewsbury,17,8,21,50,52,-2,59,14
558,Lincoln City,11,23,12,41,45,-4,56,15
558,Oxford United,13,13,20,52,59,-7,52,16
558,Bristol Rovers,13,13,20,56,77,-21,52,17
558,Morecambe,11,14,21,48,73,-25,47,18
558,Burton Albion,11,13,22,53,82,-29,46,19
558,Cheltenham,11,12,23,30,58,-28,45,20
558,Acc'ton Stanley,10,13,23,40,80,-40,43,21
558,Cambridge Utd,11,9,26,38,70,-32,42,22
558,MK Dons,10,8,28,45,72,-27,38,23
558,FG Rovers,6,10,30,34,90,-56,28,24
559,Sheffield Weds,31,11,4,86,29,57,104,1
559,Ipswich Town,26,15,5,83,40,43,93,2
559,Plymouth Argyle,27,12,7,81,48,33,93,3
559,Barnsley,27,8,11,73,38,35,89,4
559,Bolton,23,10,13,75,48,27,79,5
559,Wycombe,22,12,12,62,40,22,78,6
559,P'borough Utd,24,5,17,76,57,19,77,7
559,Derby County,20,15,11,64,40,24,75,8
559,Portsmouth,17,17,12,70,54,16,68,9
559,Shrewsbury,18,11,17,59,57,2,65,10
559,Fleetwood Town,15,17,14,53,48,5,62,11
559,Bristol Rovers,17,10,19,67,77,-10,61,12
559,Oxford United,15,12,19,51,54,-3,57,13
559,Exeter City,15,12,19,60,65,-5,57,14
559,Charlton Ath,14,14,18,60,62,-2,56,15
559,Lincoln City,10,21,15,46,57,-11,51,16
559,Port Vale,13,12,21,45,64,-19,51,17
559,Burton Albion,14,9,23,60,83,-23,51,18
559,Morecambe,11,12,23,47,76,-29,45,19
559,Acc'ton Stanley,9,16,21,41,70,-29,43,20
559,Cambridge Utd,12,7,27,39,74,-35,43,21
559,Cheltenham,10,12,24,31,63,-32,42,22
559,MK Dons,11,8,27,43,76,-33,41,23
559,FG Rovers,5,14,27,38,90,-52,29,24
560,Sheffield Weds,29,12,5,92,36,56,99,1
560,Barnsley,29,8,9,77,38,39,95,2
560,Plymouth Argyle,27,13,6,91,52,39,94,3
560,Bolton,26,10,10,77,39,38,88,4
560,Ipswich Town,23,17,6,82,44,38,86,5
560,Derby County,24,12,10,81,45,36,84,6
560,P'borough Utd,25,6,15,85,56,29,81,7
560,Wycombe,21,8,17,58,48,10,71,8
560,Portsmouth,18,16,12,67,51,16,70,9
560,Fleetwood Town,16,15,15,48,44,4,63,10
560,Shrewsbury,18,9,19,52,50,2,63,11
560,Charlton Ath,15,16,15,64,59,5,61,12
560,Lincoln City,12,23,11,38,41,-3,59,13
560,Exeter City,13,14,19,62,75,-13,53,14
560,Port Vale,13,11,22,49,65,-16,50,15
560,MK Dons,13,11,22,48,65,-17,50,16
560,Morecambe,12,12,22,46,73,-27,48,17
560,Acc'ton Stanley,10,16,20,38,67,-29,46,18
560,Bristol Rovers,12,10,24,58,92,-34,46,19
560,Oxford United,10,13,23,40,60,-20,43,20
560,Cheltenham,10,12,24,33,63,-30,42,21
560,Cambridge Utd,10,12,24,37,70,-33,42,22
560,Burton Albion,9,13,24,53,91,-38,40,23
560,FG Rovers,7,11,28,35,87,-52,32,24
561,Sheffield Weds,32,9,5,95,34,61,105,1
561,Plymouth Argyle,29,9,8,84,46,38,96,2
561,Ipswich Town,25,15,6,84,39,45,90,3
561,Bolton,24,11,11,66,41,25,83,4
561,Derby County,24,10,12,74,43,31,82,5
561,Wycombe,24,7,15,72,44,28,79,6
561,Barnsley,23,10,13,70,44,26,79,7
561,P'borough Utd,24,7,15,71,47,24,79,8
561,Portsmouth,20,15,11,65,55,10,75,9
561,Shrewsbury,18,11,17,53,49,4,65,10
561,Fleetwood Town,17,14,15,51,49,2,65,11
561,Charlton Ath,16,14,16,66,59,7,62,12
561,Lincoln City,14,19,13,50,50,0,61,13
561,Port Vale,17,9,20,48,60,-12,60,14
561,Exeter City,15,11,20,62,65,-3,56,15
561,Bristol Rovers,15,9,22,64,83,-19,54,16
561,Oxford United,13,12,21,52,59,-7,51,17
561,Acc'ton Stanley,12,14,20,40,66,-26,50,18
561,Burton Albion,11,13,22,52,83,-31,46,19
561,MK Dons,11,11,24,43,68,-25,44,20
561,Cambridge Utd,11,10,25,37,74,-37,43,21
561,Cheltenham,9,9,28,30,74,-44,36,22
561,Morecambe,7,13,26,45,83,-38,34,23
561,FG Rovers,5,10,31,31,90,-59,25,24
562,Sheffield Weds,31,11,4,83,30,53,104,1
562,Plymouth Argyle,28,11,7,91,49,42,95,2
562,Derby County,27,11,8,85,42,43,92,3
562,Barnsley,27,8,11,78,44,34,89,4
562,Bolton,27,8,11,68,35,33,89,5
562,Ipswich Town,21,17,8,85,48,37,80,6
562,Wycombe,20,9,17,57,46,11,69,7
562,Charlton Ath,17,16,13,73,59,14,67,8
562,P'borough Utd,21,4,21,79,70,9,67,9
562,Shrewsbury,20,7,19,53,52,1,67,10
562,Portsmouth,16,17,13,62,53,9,65,11
562,Fleetwood Town,16,14,16,51,49,2,62,12
562,Lincoln City,12,24,10,45,46,-1,60,13
562,Exeter City,16,11,19,57,67,-10,59,14
562,Bristol Rovers,15,11,20,67,79,-12,56,15
562,Oxford United,14,13,19,48,56,-8,55,16
562,Port Vale,14,11,21,50,68,-18,53,17
562,Burton Albion,14,10,22,59,88,-29,52,18
562,MK Dons,11,9,26,43,67,-24,42,19
562,Cheltenham,11,9,26,36,68,-32,42,20
562,Acc'ton Stanley,9,14,23,36,68,-32,41,21
562,Cambridge Utd,11,8,27,38,75,-37,41,22
562,Morecambe,8,12,26,43,77,-34,36,23
562,FG Rovers,7,13,26,33,84,-51,34,24
563,Sheffield Weds,28,10,8,89,42,47,94,1
563,Barnsley,28,9,9,76,41,35,93,2
563,Derby County,26,11,9,74,40,34,89,3
563,Ipswich Town,24,16,6,81,39,42,88,4
563,Plymouth Argyle,25,13,8,80,55,25,88,5
563,Bolton,26,9,11,71,37,34,87,6
563,Wycombe,24,7,15,63,44,19,79,7
563,P'borough Utd,24,6,16,78,57,21,78,8
563,Portsmouth,21,12,13,74,58,16,75,9
563,Shrewsbury,19,10,17,56,46,10,67,10
563,Fleetwood Town,17,15,14,52,40,12,66,11
563,Charlton Ath,16,15,15,68,55,13,63,12
563,Lincoln City,12,22,12,46,50,-4,58,13
563,Port Vale,15,11,20,44,62,-18,56,14
563,Exeter City,13,13,20,55,62,-7,52,15
563,Bristol Rovers,14,10,22,59,73,-14,52,16
563,Oxford United,12,14,20,48,56,-8,50,17
563,Burton Albion,13,10,23,53,81,-28,49,18
563,Acc'ton Stanley,11,13,22,42,75,-33,46,19
563,Cheltenham,12,9,25,32,65,-33,45,20
563,MK Dons,12,8,26,43,66,-23,44,21
563,Morecambe,8,15,23,48,79,-31,39,22
563,Cambridge Utd,9,8,29,32,79,-47,35,23
563,FG Rovers,5,10,31,34,96,-62,25,24
564,Sheffield Weds,31,11,4,81,28,53,104,1
564,Plymouth Argyle,29,10,7,89,47,42,97,2
564,Derby County,26,11,9,79,40,39,89,3
564,Ipswich Town,23,15,8,84,44,40,84,4
564,Barnsley,25,9,12,73,47,26,84,5
564,P'borough Utd,25,5,16,77,54,23,80,6
564,Bolton,22,12,12,63,35,28,78,7
564,Wycombe,23,8,15,63,44,19,77,8
564,Portsmouth,17,15,14,67,63,4,66,9
564,Charlton Ath,17,14,15,76,65,11,65,10
564,Shrewsbury,18,9,19,58,59,-1,63,11
564,Lincoln City,13,23,10,43,47,-4,62,12
564,Port Vale,16,11,19,56,63,-7,59,13
564,Fleetwood Town,14,16,16,50,48,2,58,14
564,Exeter City,13,15,18,54,58,-4,54,15
564,Oxford United,13,13,20,48,56,-8,52,16
564,MK Dons,14,9,23,52,70,-18,51,17
564,Cheltenham,12,10,24,36,60,-24,46,18
564,Bristol Rovers,12,10,24,57,86,-29,46,19
564,Acc'ton Stanley,11,13,22,44,73,-29,46,20
564,Burton Albion,11,9,26,58,102,-44,42,21
564,Morecambe,8,14,24,48,79,-31,38,22
564,Cambridge Utd,10,8,28,36,82,-46,38,23
564,FG Rovers,8,12,26,42,84,-42,36,24
565,Sheffield Weds,29,11,6,80,30,50,98,1
565,Plymouth Argyle,28,10,8,90,50,40,94,2
565,Ipswich Town,23,15,8,84,46,38,84,3
565,Barnsley,25,9,12,68,37,31,84,4
565,P'borough Utd,25,6,15,76,48,28,81,5
565,Derby County,23,12,11,67,41,26,81,6
565,Bolton,22,11,13,61,39,22,77,7
565,Wycombe,23,7,16,71,44,27,76,8
565,Portsmouth,17,17,12,60,49,11,68,9
565,Fleetwood Town,17,17,12,53,43,10,68,10
565,Shrewsbury,20,8,18,53,51,2,68,11
565,Charlton Ath,15,16,15,62,58,4,61,12
565,Exeter City,16,12,18,57,58,-1,60,13
565,Lincoln City,12,21,13,42,51,-9,57,14
565,Port Vale,14,15,17,49,61,-12,57,15
565,Oxford United,14,13,19,50,53,-3,55,16
565,Bristol Rovers,14,12,20,65,83,-18,54,17
565,Morecambe,13,13,20,48,72,-24,52,18
565,Cambridge Utd,13,7,26,35,73,-38,46,19
565,Cheltenham,11,11,24,35,66,-31,44,20
565,MK Dons,11,9,26,46,67,-21,42,21
565,Acc'ton Stanley,10,12,24,40,76,-36,42,22
565,Burton Albion,10,9,27,52,93,-41,39,23
565,FG Rovers,5,11,30,28,83,-55,26,24
566,Sheffield Weds,31,10,5,84,31,53,103,1
566,Plymouth Argyle,29,11,6,90,46,44,98,2
566,Ipswich Town,25,16,5,83,43,40,91,3
566,Bolton,25,8,13,69,35,34,83,4
566,Barnsley,24,10,12,68,43,25,82,5
566,Wycombe,23,10,13,66,45,21,79,6
566,P'borough Utd,24,5,17,85,58,27,77,7
566,Derby County,21,14,11,71,44,27,77,8
566,Portsmouth,19,14,13,63,51,12,71,9
566,Shrewsbury,19,9,18,57,53,4,66,10
566,Lincoln City,15,20,11,43,41,2,65,11
566,Fleetwood Town,15,15,16,50,50,0,60,12
566,Charlton Ath,15,14,17,68,62,6,59,13
566,Bristol Rovers,15,9,22,65,83,-18,54,14
566,Exeter City,13,14,19,56,62,-6,53,15
566,Acc'ton Stanley,13,14,19,42,68,-26,53,16
566,Cheltenham,13,12,21,37,58,-21,51,17
566,Port Vale,14,9,23,46,68,-22,51,18
566,Burton Albion,12,12,22,57,83,-26,48,19
566,Oxford United,11,11,24,45,61,-16,44,20
566,MK Dons,10,11,25,37,64,-27,41,21
566,Morecambe,8,13,25,42,84,-42,37,22
566,Cambridge Utd,10,7,29,33,79,-46,37,23
566,FG Rovers,8,12,26,34,79,-45,36,24
567,Sheffield Weds,30,11,5,84,35,49,101,1
567,Plymouth Argyle,28,10,8,87,51,36,94,2
567,Ipswich Town,25,16,5,81,38,43,91,3
567,Barnsley,27,7,12,73,42,31,88,4
567,Derby County,24,11,11,73,44,29,83,5
567,Bolton,23,12,11,69,39,30,81,6
567,P'borough Utd,24,5,17,70,54,16,77,7
567,Wycombe,22,9,15,59,42,17,75,8
567,Portsmouth,18,16,12,69,58,11,70,9
567,Shrewsbury,19,7,20,54,56,-2,64,10
567,Fleetwood Town,15,17,14,50,43,7,62,11
567,Exeter City,17,10,19,62,61,1,61,12
567,Charlton Ath,15,15,16,66,58,8,60,13
567,Lincoln City,12,21,13,45,47,-2,57,14
567,Bristol Rovers,14,15,17,63,73,-10,57,15
567,Port Vale,14,11,21,44,63,-19,53,16
567,Morecambe,13,12,21,48,71,-23,51,17
567,Acc'ton Stanley,12,12,22,39,71,-32,48,18
567,Cheltenham,12,11,23,35,63,-28,47,19
567,MK Dons,12,9,25,52,69,-17,45,20
567,Oxford United,9,14,23,42,63,-21,41,21
567,Burton Albion,10,11,25,49,84,-35,41,22
567,Cambridge Utd,9,10,27,37,75,-38,37,23
567,FG Rovers,7,10,29,35,86,-51,31,24
568,Sheffield Weds,33,9,4,86,27,59,108,1
568,Barnsley,28,7,11,81,44,37,91,2
568,Bolton,27,10,9,68,33,35,91,3
568,Plymouth Argyle,26,11,9,80,55,25,89,4
568,Derby County,24,12,10,74,38,36,84,5
568,Wycombe,25,9,12,73,42,31,84,6
568,Ipswich Town,22,15,9,77,44,33,81,7
568,P'borough Utd,21,7,18,79,63,16,70,8
568,Portsmouth,16,18,12,61,58,3,66,9
568,Shrewsbury,19,8,19,54,51,3,65,10
568,Fleetwood Town,16,15,15,51,46,5,63,11
568,Lincoln City,14,20,12,45,47,-2,62,12
568,Charlton Ath,15,15,16,68,60,8,60,13
568,Bristol Rovers,15,11,20,63,79,-16,56,14
568,Exeter City,14,13,19,53,61,-8,55,15
568,Oxford United,12,12,22,45,58,-13,48,16
568,Morecambe,11,15,20,49,69,-20,48,17
568,Port Vale,11,15,20,41,63,-22,48,18
568,Burton Albion,13,9,24,60,90,-30,48,19
568,MK Dons,12,11,23,45,67,-22,47,20
568,Acc'ton Stanley,10,14,22,40,70,-30,44,21
568,Cheltenham,10,11,25,32,66,-34,41,22
568,Cambridge Utd,10,7,29,40,79,-39,37,23
568,FG Rovers,6,10,30,32,87,-55,28,24
569,Sheffield Weds,31,9,6,76,30,46,102,1
569,Ipswich Town,26,14,6,86,43,43,92,2
569,Barnsley,28,7,11,77,39,38,91,3
569,Plymouth Argyle,26,10,10,87,55,32,88,4
569,Derby County,24,11,11,77,42,35,83,5
569,Wycombe,25,7,14,74,50,24,82,6
569,Bolton,22,11,13,62,36,26,77,7
569,P'borough Utd,24,5,17,81,56,25,77,8
569,Portsmouth,19,18,9,69,50,19,75,9
569,Charlton Ath,18,13,15,62,55,7,67,10
569,Fleetwood Town,16,16,14,52,47,5,64,11
569,Exeter City,17,11,18,65,59,6,62,12
569,Oxford United,17,10,19,56,59,-3,61,13
569,Shrewsbury,17,8,21,52,59,-7,59,14
569,Lincoln City,12,22,12,44,45,-1,58,15
569,Bristol Rovers,15,11,20,64,73,-9,56,16
569,Burton Albion,13,11,22,57,89,-32,50,17
569,Port Vale,12,10,24,48,69,-21,46,18
569,MK Dons,11,9,26,39,70,-31,42,19
569,Morecambe,10,11,25,44,73,-29,41,20
569,Cambridge Utd,11,7,28,35,75,-40,40,21
569,Acc'ton Stanley,9,13,24,33,82,-49,40,22
569,Cheltenham,10,7,29,34,72,-38,37,23
569,FG Rovers,9,9,28,38,84,-46,36,24
570,Sheffield Weds,32,8,6,86,36,50,104,1
570,Plymouth Argyle,31,10,5,91,42,49,103,2
570,Ipswich Town,23,18,5,81,39,42,87,3
570,Derby County,23,13,10,77,40,37,82,4
570,Portsmouth,22,15,9,71,47,24,81,5
570,Bolton,22,13,11,67,36,31,79,6
570,Barnsley,23,9,14,65,42,23,78,7
570,Wycombe,22,10,14,65,44,21,76,8
570,Shrewsbury,19,11,16,52,49,3,68,9
570,Lincoln City,13,22,11,48,43,5,61,10
570,Charlton Ath,16,13,17,59,56,3,61,11
570,P'borough Utd,18,7,21,68,68,0,61,12
570,Exeter City,15,13,18,55,58,-3,58,13
570,Fleetwood Town,13,17,16,51,48,3,56,14
570,Port Vale,15,10,21,49,66,-17,55,15
570,Bristol Rovers,14,10,22,62,79,-17,52,16
570,Oxford United,12,14,20,47,59,-12,50,17
570,Cheltenham,14,8,24,37,69,-32,50,18
570,Morecambe,12,12,22,50,69,-19,48,19
570,Burton Albion,13,9,24,56,92,-36,48,20
570,Acc'ton Stanley,10,16,20,37,66,-29,46,21
570,Cambridge Utd,12,7,27,39,74,-35,43,22
570,MK Dons,9,9,28,37,81,-44,36,23
570,FG Rovers,7,10,29,33,80,-47,31,24
571,Sheffield Weds,30,11,5,83,30,53,101,1
571,Barnsley,28,8,10,78,39,39,92,2
571,Plymouth Argyle,26,13,7,84,50,34,91,3
571,Wycombe,25,8,13,72,42,30,83,4
571,Derby County,23,12,11,75,44,31,81,5
571,Ipswich Town,22,15,9,79,50,29,81,6
571,Bolton,23,10,13,63,37,26,79,7
571,P'borough Utd,22,6,18,79,63,16,72,8
571,Shrewsbury,20,10,16,52,44,8,70,9
571,Charlton Ath,18,14,14,66,55,11,68,10
571,Portsmouth,17,17,12,58,49,9,68,11
571,Lincoln City,12,24,10,43,42,1,60,12
571,Oxford United,16,12,18,53,55,-2,60,13
571,Bristol Rovers,14,12,20,64,76,-12,54,14
571,Port Vale,14,10,22,43,69,-26,52,15
571,Fleetwood Town,12,15,19,47,57,-10,51,16
571,Exeter City,11,17,18,56,63,-7,50,17
571,MK Dons,13,9,24,44,71,-27,48,18
571,Morecambe,10,16,20,47,67,-20,46,19
571,Burton Albion,12,10,24,58,89,-31,46,20
571,Cheltenham,13,7,26,38,73,-35,46,21
571,Cambridge Utd,11,9,26,40,76,-36,42,22
571,Acc'ton Stanley,9,13,24,38,73,-35,40,23
571,FG Rovers,7,10,29,36,82,-46,31,24
572,Sheffield Weds,29,12,5,85,32,53,99,1
572,Barnsley,28,9,9,76,37,39,93,2
572,Plymouth Argyle,27,10,9,85,53,32,91,3
572,Ipswich Town,25,15,6,83,41,42,90,4
572,Derby County,25,10,11,82,44,38,85,5
572,Bolton,24,11,11,67,37,30,83,6
572,Portsmouth,21,13,12,62,45,17,76,7
572,Wycombe,22,8,16,64,44,20,74,8
572,P'borough Utd,22,8,16,71,54,17,74,9
572,Shrewsbury,18,11,17,56,52,4,65,10
572,Fleetwood Town,16,15,15,51,44,7,63,11
572,Lincoln City,12,23,11,42,45,-3,59,12
572,Charlton Ath,14,16,16,65,62,3,58,13
572,Port Vale,14,10,22,48,68,-20,52,14
572,Bristol Rovers,14,10,22,64,85,-21,52,15
572,Burton Albion,14,10,22,56,88,-32,52,16
572,Cheltenham,14,9,23,39,62,-23,51,17
572,Oxford United,12,12,22,45,59,-14,48,18
572,Exeter City,12,12,22,57,72,-15,48,19
572,Acc'ton Stanley,11,14,21,41,71,-30,47,20
572,Cambridge Utd,13,8,25,40,70,-30,47,21
572,MK Dons,11,9,26,42,73,-31,42,22
572,Morecambe,9,14,23,50,78,-28,41,23
572,FG Rovers,6,9,31,35,90,-55,27,24
573,Sheffield Weds,31,10,5,90,30,60,103,1
573,Plymouth Argyle,27,11,8,90,54,36,92,2
573,Ipswich Town,25,13,8,84,48,36,88,3
573,Barnsley,26,8,12,78,42,36,86,4
573,Bolton,25,11,10,67,34,33,86,5
573,Derby County,24,11,11,69,40,29,83,6
573,Wycombe,24,8,14,70,45,25,80,7
573,P'borough Utd,23,5,18,79,58,21,74,8
573,Portsmouth,19,16,11,70,51,19,73,9
573,Fleetwood Town,17,14,15,59,47,12,65,10
573,Shrewsbury,19,7,20,52,54,-2,64,11
573,Bristol Rovers,17,10,19,67,78,-11,61,12
573,Lincoln City,11,24,11,44,50,-6,57,13
573,Charlton Ath,13,16,17,55,59,-4,55,14
573,Exeter City,14,12,20,55,66,-11,54,15
573,Port Vale,13,13,20,45,63,-18,52,16
573,Cheltenham,14,10,22,42,61,-19,52,17
573,MK Dons,14,8,24,49,68,-19,50,18
573,Acc'ton Stanley,12,12,22,40,70,-30,48,19
573,Morecambe,10,15,21,41,70,-29,45,20
573,Burton Albion,11,10,25,55,96,-41,43,21
573,Oxford United,10,11,25,43,67,-24,41,22
573,Cambridge Utd,12,5,29,39,83,-44,41,23
573,FG Rovers,6,10,30,34,83,-49,28,24
574,Sheffield Weds,31,12,3,86,32,54,105,1
574,Plymouth Argyle,24,13,9,83,54,29,85,2
574,Ipswich Town,22,15,9,82,44,38,81,3
574,Derby County,23,11,12,71,42,29,80,4
574,Bolton,23,11,12,66,37,29,80,5
574,Barnsley,23,11,12,63,39,24,80,6
574,Wycombe,24,8,14,62,42,20,80,7
574,P'borough Utd,23,9,14,79,53,26,78,8
574,Shrewsbury,20,11,15,63,47,16,71,9
574,Portsmouth,18,15,13,66,56,10,69,10
574,Fleetwood Town,17,16,13,54,41,13,67,11
574,Exeter City,17,12,17,57,57,0,63,12
574,Charlton Ath,15,16,15,61,56,5,61,13
574,Port Vale,15,12,19,49,69,-20,57,14
574,Lincoln City,10,21,15,38,56,-18,51,15
574,Burton Albion,13,12,21,57,86,-29,51,16
574,Bristol Rovers,12,12,22,58,78,-20,48,17
574,Cheltenham,13,8,25,40,62,-22,47,18
574,MK Dons,13,8,25,42,67,-25,47,19
574,Oxford United,10,16,20,46,58,-12,46,20
574,Acc'ton Stanley,10,14,22,44,72,-28,44,21
574,Cambridge Utd,11,9,26,38,73,-35,42,22
574,Morecambe,10,11,25,40,77,-37,41,23
574,FG Rovers,8,11,27,38,85,-47,35,24
575,Sheffield Weds,30,10,6,82,31,51,100,1
575,Plymouth Argyle,29,10,7,94,51,43,97,2
575,Ipswich Town,24,17,5,89,50,39,89,3
575,Barnsley,26,9,11,78,46,32,87,4
575,Bolton,26,9,11,68,37,31,87,5
575,Wycombe,24,10,12,71,46,25,82,6
575,Derby County,22,13,11,70,43,27,79,7
575,P'borough Utd,24,5,17,76,55,21,77,8
575,Shrewsbury,21,7,18,60,54,6,70,9
575,Portsmouth,17,17,12,63,49,14,68,10
575,Fleetwood Town,14,19,13,51,45,6,61,11
575,Lincoln City,13,20,13,42,46,-4,59,12
575,Charlton Ath,14,16,16,69,66,3,58,13
575,Exeter City,15,11,20,56,57,-1,56,14
575,Oxford United,15,10,21,49,52,-3,55,15
575,Port Vale,14,11,21,53,73,-20,53,16
575,Bristol Rovers,13,10,23,60,88,-28,49,17
575,Cheltenham,13,7,26,36,67,-31,46,18
575,Cambridge Utd,13,7,26,44,78,-34,46,19
575,Burton Albion,11,11,24,57,87,-30,44,20
575,Acc'ton Stanley,11,11,24,34,77,-43,44,21
575,Morecambe,10,13,23,50,74,-24,43,22
575,MK Dons,11,10,25,47,72,-25,43,23
575,FG Rovers,5,11,30,32,87,-55,26,24
576,Sheffield Weds,32,9,5,94,31,63,105,1
576,Plymouth Argyle,28,10,8,89,56,33,94,2
576,Ipswich Town,25,15,6,81,43,38,90,3
576,Barnsley,26,10,10,73,35,38,88,4
576,Bolton,26,10,10,68,35,33,88,5
576,Derby County,26,9,11,81,43,38,87,6
576,Wycombe,24,10,12,62,36,26,82,7
576,P'borough Utd,22,5,19,71,62,9,71,8
576,Portsmouth,18,14,14,65,51,14,68,9
576,Shrewsbury,19,7,20,56,53,3,64,10
576,Charlton Ath,16,15,15,68,62,6,63,11
576,Port Vale,17,11,18,54,63,-9,62,12
576,Fleetwood Town,16,13,17,52,47,5,61,13
576,Exeter City,15,14,17,58,62,-4,59,14
576,Lincoln City,11,22,13,42,49,-7,55,15
576,Bristol Rovers,15,10,21,62,79,-17,55,16
576,Oxford United,13,12,21,48,59,-11,51,17
576,Cheltenham,13,9,24,34,62,-28,48,18
576,Burton Albion,11,11,24,59,89,-30,44,19
576,MK Dons,11,10,25,45,74,-29,43,20
576,Morecambe,9,13,24,43,78,-35,40,21
576,Acc'ton Stanley,9,13,24,42,78,-36,40,22
576,Cambridge Utd,8,8,30,30,79,-49,32,23
576,FG Rovers,7,10,29,33,84,-51,31,24
577,Sheffield Weds,32,10,4,89,28,61,106,1
577,Plymouth Argyle,28,11,7,90,50,40,95,2
577,Bolton,27,9,10,73,36,37,90,3
577,Ipswich Town,23,13,10,72,46,26,82,4
577,Derby County,24,9,13,76,47,29,81,5
577,Barnsley,23,11,12,67,42,25,80,6
577,Shrewsbury,22,9,15,68,53,15,75,7
577,P'borough Utd,23,5,18,80,58,22,74,8
577,Wycombe,22,8,16,59,46,13,74,9
577,Exeter City,20,10,16,66,51,15,70,10
577,Port Vale,19,9,18,46,55,-9,66,11
577,Charlton Ath,17,13,16,63,56,7,64,12
577,Portsmouth,16,16,14,57,56,1,64,13
577,Lincoln City,13,20,13,40,49,-9,59,14
577,Fleetwood Town,14,15,17,54,55,-1,57,15
577,Bristol Rovers,14,11,21,62,76,-14,53,16
577,Acc'ton Stanley,12,13,21,40,66,-26,49,17
577,Oxford United,11,13,22,42,59,-17,46,18
577,Burton Albion,11,11,24,50,86,-36,44,19
577,Morecambe,10,13,23,44,74,-30,43,20
577,Cambridge Utd,11,9,26,42,73,-31,42,21
577,Cheltenham,11,7,28,31,67,-36,40,22
577,MK Dons,9,12,25,39,67,-28,39,23
577,FG Rovers,5,13,28,34,88,-54,28,24
578,Sheffield Weds,29,11,6,83,36,47,98,1
578,Plymouth Argyle,28,11,7,91,50,41,95,2
578,Ipswich Town,26,15,5,95,42,53,93,3
578,Barnsley,27,9,10,81,42,39,90,4
578,Bolton,27,9,10,68,32,36,90,5
578,Derby County,24,11,11,82,51,31,83,6
578,P'borough Utd,23,7,16,75,51,24,76,7
578,Portsmouth,18,17,11,62,50,12,71,8
578,Charlton Ath,18,13,15,65,58,7,67,9
578,Wycombe,18,12,16,58,51,7,66,10
578,Exeter City,17,11,18,60,59,1,62,11
578,Lincoln City,12,22,12,48,50,-2,58,12
578,Shrewsbury,15,13,18,50,53,-3,58,13
578,Fleetwood Town,14,16,16,51,55,-4,58,14
578,Port Vale,15,11,20,48,70,-22,56,15
578,Bristol Rovers,15,9,22,69,81,-12,54,16
578,Morecambe,12,14,20,48,69,-21,50,17
578,Oxford United,11,14,21,43,57,-14,47,18
578,Cheltenham,12,10,24,36,60,-24,46,19
578,Cambridge Utd,12,9,25,37,71,-34,45,20
578,Acc'ton Stanley,9,15,22,35,68,-33,42,21
578,Burton Albion,10,11,25,51,88,-37,41,22
578,MK Dons,9,9,28,38,78,-40,36,23
578,FG Rovers,6,11,29,35,87,-52,29,24
579,Sheffield Weds,30,12,4,86,33,53,102,1
579,Plymouth Argyle,29,10,7,96,56,40,97,2
579,Barnsley,27,10,9,81,40,41,91,3
579,Ipswich Town,24,14,8,82,46,36,86,4
579,Derby County,24,10,12,78,52,26,82,5
579,Bolton,24,9,13,71,36,35,81,6
579,Wycombe,23,8,15,63,38,25,77,7
579,P'borough Utd,20,10,16,77,60,17,70,8
579,Shrewsbury,19,10,17,57,55,2,67,9
579,Portsmouth,16,16,14,64,55,9,64,10
579,Charlton Ath,16,13,17,62,55,7,61,11
579,Fleetwood Town,15,16,15,52,50,2,61,12
579,Lincoln City,12,23,11,47,45,2,59,13
579,Exeter City,15,13,18,56,59,-3,58,14
579,Bristol Rovers,15,10,21,66,88,-22,55,15
579,Oxford United,14,12,20,50,58,-8,54,16
579,Port Vale,14,9,23,48,73,-25,51,17
579,MK Dons,13,9,24,46,68,-22,48,18
579,Morecambe,12,12,22,46,73,-27,48,19
579,Burton Albion,12,12,22,57,86,-29,48,20
579,Acc'ton Stanley,9,16,21,36,71,-35,43,21
579,Cambridge Utd,11,9,26,40,76,-36,42,22
579,Cheltenham,10,9,27,32,66,-34,39,23
579,FG Rovers,7,10,29,35,89,-54,31,24
580,Sheffield Weds,29,10,7,84,34,50,97,1
580,Plymouth Argyle,26,12,8,85,58,27,90,2
580,Derby County,25,12,9,78,45,33,87,3
580,Barnsley,25,12,9,73,40,33,87,4
580,Ipswich Town,22,18,6,81,41,40,84,5
580,P'borough Utd,26,6,14,93,56,37,84,6
580,Wycombe,24,9,13,72,42,30,81,7
580,Bolton,24,9,13,65,38,27,81,8
580,Shrewsbury,21,9,16,61,47,14,72,9
580,Portsmouth,16,18,12,65,56,9,66,10
580,Fleetwood Town,17,14,15,58,49,9,65,11
580,Exeter City,16,12,18,62,58,4,60,12
580,Charlton Ath,15,13,18,61,60,1,58,13
580,Lincoln City,12,21,13,42,48,-6,57,14
580,Port Vale,15,11,20,50,65,-15,56,15
580,Bristol Rovers,14,12,20,65,83,-18,54,16
580,Oxford United,12,13,21,47,61,-14,49,17
580,Burton Albion,12,11,23,55,90,-35,47,18
580,Cheltenham,12,8,26,31,69,-38,44,19
580,Acc'ton Stanley,10,13,23,35,72,-37,43,20
580,MK Dons,9,14,23,46,71,-25,41,21
580,Morecambe,8,15,23,44,75,-31,39,22
580,Cambridge Utd,11,6,29,39,80,-41,39,23
580,FG Rovers,7,10,29,32,86,-54,31,24
581,Sheffield Weds,28,13,5,82,34,48,97,1
581,Wycombe,27,7,12,72,40,32,88,2
581,Plymouth Argyle,25,12,9,82,60,22,87,3
581,Bolton,25,11,10,69,35,34,86,4
581,Ipswich Town,22,16,8,78,48,30,82,5
581,Barnsley,23,10,13,73,46,27,79,6
581,Derby County,22,13,11,69,45,24,79,7
581,P'borough Utd,23,9,14,76,47,29,78,8
581,Portsmouth,19,17,10,65,49,16,74,9
581,Charlton Ath,19,11,16,76,60,16,68,10
581,Shrewsbury,19,11,16,62,52,10,68,11
581,Exeter City,17,14,15,66,56,10,65,12
581,Fleetwood Town,16,13,17,55,47,8,61,13
581,Lincoln City,12,23,11,46,51,-5,59,14
581,Port Vale,14,10,22,47,67,-20,52,15
581,Oxford United,12,12,22,45,61,-16,48,16
581,Morecambe,12,12,22,46,68,-22,48,17
581,Burton Albion,12,12,22,64,93,-29,48,18
581,Bristol Rovers,13,9,24,59,88,-29,48,19
581,MK Dons,13,8,25,47,71,-24,47,20
581,Cambridge Utd,12,8,26,38,70,-32,44,21
581,Acc'ton Stanley,8,14,24,36,76,-40,38,22
581,Cheltenham,9,10,27,30,68,-38,37,23
581,FG Rovers,7,11,28,34,85,-51,32,24
582,Sheffield Weds,32,10,4,85,30,55,106,1
582,Plymouth Argyle,30,9,7,89,50,39,99,2
582,Wycombe,27,8,11,75,42,33,89,3
582,Ipswich Town,24,15,7,88,45,43,87,4
582,Barnsley,25,9,12,69,38,31,84,5
582,Bolton,24,11,11,67,36,31,83,6
582,Portsmouth,21,14,11,64,47,17,77,7
582,Derby County,21,13,12,70,44,26,76,8
582,P'borough Utd,22,5,19,76,63,13,71,9
582,Shrewsbury,20,10,16,62,49,13,70,10
582,Fleetwood Town,19,12,15,59,45,14,69,11
582,Charlton Ath,15,12,19,63,60,3,57,12
582,Exeter City,14,14,18,62,66,-4,56,13
582,Oxford United,14,13,19,52,58,-6,55,14
582,Bristol Rovers,14,11,21,59,78,-19,53,15
582,Port Vale,13,12,21,44,68,-24,51,16
582,Lincoln City,9,22,15,39,52,-13,49,17
582,Burton Albion,13,10,23,57,83,-26,49,18
582,Cheltenham,13,9,24,40,67,-27,48,19
582,Acc'ton Stanley,12,11,23,41,74,-33,47,20
582,Morecambe,10,13,23,43,72,-29,43,21
582,MK Dons,10,7,29,39,84,-45,37,22
582,Cambridge Utd,10,5,31,34,75,-41,35,23
582,FG Rovers,7,11,28,32,83,-51,32,24
583,Plymouth Argyle,29,11,6,83,46,37,98,1
583,Sheffield Weds,27,13,6,79,32,47,94,2
583,Barnsley,28,7,11,82,45,37,91,3
583,Wycombe,26,6,14,66,43,23,84,4
583,Ipswich Town,22,16,8,80,45,35,82,5
583,Bolton,23,12,11,66,39,27,81,6
583,Derby County,23,11,12,69,44,25,80,7
583,P'borough Utd,23,6,17,73,59,14,75,8
583,Shrewsbury,22,9,15,59,48,11,75,9
583,Fleetwood Town,20,14,12,53,39,14,74,10
583,Portsmouth,17,14,15,59,52,7,65,11
583,Charlton Ath,16,16,14,64,57,7,64,12
583,Port Vale,16,11,19,51,60,-9,59,13
583,Oxford United,12,16,18,49,53,-4,52,14
583,Exeter City,13,12,21,52,59,-7,51,15
583,Lincoln City,9,24,13,40,49,-9,51,16
583,Bristol Rovers,13,10,23,59,78,-19,49,17
583,Cheltenham,13,10,23,35,63,-28,49,18
583,MK Dons,13,6,27,50,72,-22,45,19
583,Morecambe,10,13,23,44,71,-27,43,20
583,Burton Albion,11,10,25,53,87,-34,43,21
583,Acc'ton Stanley,9,16,21,36,71,-35,43,22
583,FG Rovers,8,11,27,43,90,-47,35,23
583,Cambridge Utd,9,6,31,37,80,-43,33,24
584,Sheffield Weds,29,12,5,81,30,51,99,1
584,Plymouth Argyle,28,9,9,80,55,25,93,2
584,Barnsley,26,10,10,70,40,30,88,3
584,P'borough Utd,27,4,15,83,56,27,85,4
584,Ipswich Town,22,15,9,79,44,35,81,5
584,Wycombe,24,9,13,71,49,22,81,6
584,Bolton,23,10,13,64,40,24,79,7
584,Derby County,23,9,14,76,51,25,78,8
584,Portsmouth,21,12,13,62,46,16,75,9
584,Shrewsbury,21,8,17,56,47,9,71,10
584,Fleetwood Town,17,17,12,54,42,12,68,11
584,Lincoln City,12,23,11,43,45,-2,59,12
584,Charlton Ath,14,15,17,68,63,5,57,13
584,Bristol Rovers,16,9,21,66,78,-12,57,14
584,Port Vale,16,9,21,55,70,-15,57,15
584,Exeter City,14,14,18,56,60,-4,56,16
584,Oxford United,15,11,20,56,61,-5,56,17
584,Morecambe,12,11,23,47,70,-23,47,18
584,Cheltenham,12,9,25,37,68,-31,45,19
584,Burton Albion,11,12,23,52,84,-32,45,20
584,MK Dons,12,8,26,43,73,-30,44,21
584,Cambridge Utd,9,10,27,32,73,-41,37,22
584,Acc'ton Stanley,7,13,26,34,70,-36,34,23
584,FG Rovers,6,11,29,34,84,-50,29,24
585,Sheffield Weds,30,10,6,80,28,52,100,1
585,Plymouth Argyle,29,11,6,95,44,51,98,2
585,Derby County,28,11,7,78,36,42,95,3
585,Ipswich Town,23,16,7,78,40,38,85,4
585,Barnsley,24,10,12,70,47,23,82,5
585,Bolton,23,10,13,66,38,28,79,6
585,Wycombe,22,10,14,63,43,20,76,7
585,P'borough Utd,22,4,20,74,55,19,70,8
585,Portsmouth,18,16,12,59,53,6,70,9
585,Shrewsbury,20,9,17,59,55,4,69,10
585,Charlton Ath,15,18,13,67,56,11,63,11
585,Fleetwood Town,15,16,15,49,44,5,61,12
585,Lincoln City,13,21,12,45,47,-2,60,13
585,Port Vale,16,9,21,47,64,-17,57,14
585,Exeter City,15,11,20,54,65,-11,56,15
585,Bristol Rovers,14,13,19,64,73,-9,55,16
585,Oxford United,13,11,22,49,60,-11,50,17
585,Cheltenham,13,9,24,36,61,-25,48,18
585,Burton Albion,12,11,23,54,88,-34,47,19
585,Morecambe,11,13,22,46,74,-28,46,20
585,Acc'ton Stanley,8,16,22,33,69,-36,40,21
585,MK Dons,9,11,26,43,73,-30,38,22
585,Cambridge Utd,10,8,28,34,80,-46,38,23
585,FG Rovers,7,10,29,36,86,-50,31,24
586,Plymouth Argyle,30,11,5,96,48,48,101,1
586,Sheffield Weds,29,10,7,82,34,48,97,2
586,Ipswich Town,26,14,6,91,45,46,92,3
586,Derby County,23,11,12,72,43,29,80,4
586,Barnsley,23,11,12,67,41,26,80,5
586,Bolton,23,10,13,71,39,32,79,6
586,P'borough Utd,23,7,16,79,55,24,76,7
586,Wycombe,20,9,17,58,47,11,69,8
586,Charlton Ath,19,11,16,73,60,13,68,9
586,Lincoln City,16,20,10,56,45,11,68,10
586,Fleetwood Town,17,15,14,57,47,10,66,11
586,Portsmouth,15,19,12,59,57,2,64,12
586,Shrewsbury,18,7,21,54,58,-4,61,13
586,Exeter City,16,11,19,63,71,-8,59,14
586,Burton Albion,16,9,21,56,89,-33,57,15
586,Oxford United,14,12,20,57,60,-3,54,16
586,Bristol Rovers,14,11,21,66,82,-16,53,17
586,Port Vale,15,8,23,49,71,-22,53,18
586,Cheltenham,13,9,24,36,60,-24,48,19
586,MK Dons,11,8,27,41,69,-28,41,20
586,Cambridge Utd,11,8,27,38,80,-42,41,21
586,Acc'ton Stanley,9,13,24,41,79,-38,40,22
586,Morecambe,8,15,23,42,79,-37,39,23
586,FG Rovers,8,11,27,40,85,-45,35,24
587,Sheffield Weds,29,12,5,81,33,48,99,1
587,Plymouth Argyle,28,12,6,91,49,42,96,2
587,Barnsley,25,8,13,74,45,29,83,3
587,Wycombe,24,10,12,75,46,29,82,4
587,Derby County,23,12,11,76,46,30,81,5
587,Ipswich Town,22,14,10,80,45,35,80,6
587,Shrewsbury,24,8,14,62,45,17,80,7
587,Bolton,22,13,11,61,35,26,79,8
587,P'borough Utd,23,4,19,73,57,16,73,9
587,Portsmouth,19,15,12,63,53,10,72,10
587,Charlton Ath,18,15,13,68,55,13,69,11
587,Bristol Rovers,16,10,20,64,75,-11,58,12
587,Lincoln City,11,23,12,44,49,-5,56,13
587,Exeter City,15,11,20,60,69,-9,56,14
587,Fleetwood Town,12,16,18,42,48,-6,52,15
587,Port Vale,14,9,23,43,67,-24,51,16
587,Oxford United,12,13,21,48,57,-9,49,17
587,MK Dons,14,6,26,45,74,-29,48,18
587,Cheltenham,12,11,23,33,57,-24,47,19
587,Burton Albion,11,11,24,61,95,-34,44,20
587,Cambridge Utd,12,7,27,38,72,-34,43,21
587,Acc'ton Stanley,9,15,22,36,68,-32,42,22
587,FG Rovers,9,12,25,35,78,-43,39,23
587,Morecambe,7,15,24,44,79,-35,36,24
588,Sheffield Weds,29,13,4,90,34,56,100,1
588,Ipswich Town,27,12,7,90,41,49,93,2
588,Plymouth Argyle,27,11,8,91,50,41,92,3
588,Bolton,26,10,10,71,37,34,88,4
588,Barnsley,25,11,10,72,42,30,86,5
588,Derby County,22,14,10,71,45,26,80,6
588,Portsmouth,20,15,11,66,51,15,75,7
588,Wycombe,22,9,15,65,50,15,75,8
588,P'borough Utd,23,6,17,75,63,12,75,9
588,Charlton Ath,19,12,15,71,61,10,69,10
588,Shrewsbury,19,7,20,51,53,-2,64,11
588,Lincoln City,14,20,12,44,51,-7,62,12
588,Fleetwood Town,15,16,15,55,53,2,61,13
588,Oxford United,15,11,20,49,57,-8,56,14
588,Exeter City,14,13,19,60,61,-1,55,15
588,Bristol Rovers,15,9,22,66,79,-13,54,16
588,MK Dons,14,8,24,57,71,-14,50,17
588,Burton Albion,13,9,24,63,86,-23,48,18
588,Cheltenham,12,10,24,39,62,-23,46,19
588,Acc'ton Stanley,10,15,21,38,70,-32,45,20
588,Port Vale,11,11,24,43,71,-28,44,21
588,Cambridge Utd,12,8,26,42,81,-39,44,22
588,Morecambe,7,11,28,41,85,-44,32,23
588,FG Rovers,6,9,31,38,94,-56,27,24
589,Sheffield Weds,31,10,5,82,29,53,103,1
589,Ipswich Town,27,13,6,85,41,44,94,2
589,Plymouth Argyle,28,9,9,89,55,34,93,3
589,Barnsley,28,8,10,78,41,37,92,4
589,Derby County,24,11,11,71,38,33,83,5
589,P'borough Utd,26,5,15,78,52,26,83,6
589,Wycombe,26,5,15,69,45,24,83,7
589,Bolton,23,11,12,63,36,27,80,8
589,Charlton Ath,19,12,15,74,64,10,69,9
589,Fleetwood Town,18,13,15,52,45,7,67,10
589,Lincoln City,14,22,10,46,47,-1,64,11
589,Portsmouth,17,12,17,71,56,15,63,12
589,Shrewsbury,17,9,20,52,52,0,60,13
589,Bristol Rovers,14,11,21,58,74,-16,53,14
589,Port Vale,14,11,21,45,64,-19,53,15
589,Exeter City,14,9,23,57,64,-7,51,16
589,Oxford United,13,12,21,46,56,-10,51,17
589,Acc'ton Stanley,11,14,21,37,71,-34,47,18
589,MK Dons,13,7,26,46,69,-23,46,19
589,Burton Albion,11,10,25,52,85,-33,43,20
589,Cheltenham,12,6,28,32,73,-41,42,21
589,Cambridge Utd,10,9,27,37,70,-33,39,22
589,Morecambe,9,12,25,41,79,-38,39,23
589,FG Rovers,7,11,28,37,92,-55,32,24
590,Sheffield Weds,32,11,3,88,32,56,107,1
590,Barnsley,26,10,10,73,42,31,88,2
590,Ipswich Town,24,15,7,82,41,41,87,3
590,Plymouth Argyle,24,14,8,73,51,22,86,4
590,Derby County,24,12,10,78,44,34,84,5
590,Wycombe,23,8,15,64,43,21,77,6
590,Bolton,22,11,13,64,43,21,77,7
590,P'borough Utd,21,9,16,65,50,15,72,8
590,Portsmouth,19,14,13,65,51,14,71,9
590,Fleetwood Town,17,15,14,55,44,11,66,10
590,Shrewsbury,20,6,20,59,57,2,66,11
590,Port Vale,18,11,17,53,57,-4,65,12
590,Charlton Ath,15,16,15,63,58,5,61,13
590,Lincoln City,11,21,14,40,48,-8,54,14
590,Oxford United,14,11,21,53,63,-10,53,15
590,Exeter City,13,13,20,56,60,-4,52,16
590,Bristol Rovers,13,13,20,60,84,-24,52,17
590,Cheltenham,13,11,22,34,57,-23,50,18
590,Acc'ton Stanley,12,12,22,40,74,-34,48,19
590,Morecambe,12,11,23,51,72,-21,47,20
590,MK Dons,12,8,26,46,71,-25,44,21
590,Burton Albion,10,11,25,50,84,-34,41,22
590,Cambridge Utd,11,7,28,38,66,-28,40,23
590,FG Rovers,6,10,30,32,90,-58,28,24
591,Sheffield Weds,31,10,5,86,32,54,103,1
591,Plymouth Argyle,28,10,8,92,52,40,94,2
591,Derby County,26,11,9,77,40,37,89,3
591,Ipswich Town,24,14,8,84,47,37,86,4
591,Bolton,23,12,11,74,40,34,81,5
591,Barnsley,24,9,13,71,44,27,81,6
591,Wycombe,24,7,15,62,46,16,79,7
591,P'borough Utd,24,4,18,80,56,24,76,8
591,Portsmouth,18,14,14,61,53,8,68,9
591,Shrewsbury,18,11,17,56,55,1,65,10
591,Charlton Ath,16,16,14,69,65,4,64,11
591,Lincoln City,14,22,10,44,43,1,64,12
591,Fleetwood Town,15,16,15,45,45,0,61,13
591,Exeter City,15,12,19,62,63,-1,57,14
591,Oxford United,14,13,19,48,52,-4,55,15
591,Acc'ton Stanley,15,10,21,50,67,-17,55,16
591,Port Vale,14,10,22,45,64,-19,52,17
591,Bristol Rovers,13,13,20,61,85,-24,52,18
591,Morecambe,11,13,22,44,73,-29,46,19
591,Burton Albion,11,12,23,56,87,-31,45,20
591,Cheltenham,11,8,27,29,63,-34,41,21
591,Cambridge Utd,10,10,26,34,69,-35,40,22
591,MK Dons,10,9,27,41,72,-31,39,23
591,FG Rovers,5,10,31,30,88,-58,25,24
592,Sheffield Weds,31,10,5,85,30,55,103,1
592,Plymouth Argyle,31,9,6,89,50,39,102,2
592,Barnsley,27,9,10,74,44,30,90,3
592,Ipswich Town,25,13,8,89,45,44,88,4
592,Bolton,24,11,11,72,35,37,83,5
592,Derby County,23,10,13,72,45,27,79,6
592,P'borough Utd,23,8,15,73,52,21,77,7
592,Wycombe,22,10,14,70,46,24,76,8
592,Portsmouth,20,14,12,65,52,13,74,9
592,Fleetwood Town,17,15,14,52,42,10,66,10
592,Charlton Ath,17,12,17,69,66,3,63,11
592,Exeter City,16,12,18,60,65,-5,60,12
592,Shrewsbury,17,9,20,52,58,-6,60,13
592,Lincoln City,12,19,15,44,49,-5,55,14
592,Cheltenham,15,10,21,36,56,-20,55,15
592,Port Vale,14,10,22,44,68,-24,52,16
592,Oxford United,14,9,23,46,58,-12,51,17
592,Bristol Rovers,13,11,22,58,79,-21,50,18
592,Acc'ton Stanley,12,11,23,40,70,-30,47,19
592,Morecambe,11,11,24,42,71,-29,44,20
592,Cambridge Utd,12,7,27,35,71,-36,43,21
592,Burton Albion,10,11,25,54,84,-30,41,22
592,MK Dons,10,9,27,43,73,-30,39,23
592,FG Rovers,6,10,30,31,86,-55,28,24
593,Sheffield Weds,32,9,5,91,31,60,105,1
593,Plymouth Argyle,29,10,7,86,48,38,97,2
593,Barnsley,27,8,11,73,43,30,89,3
593,Derby County,25,11,10,74,44,30,86,4
593,Ipswich Town,23,15,8,79,42,37,84,5
593,Bolton,24,10,12,69,39,30,82,6
593,Wycombe,24,7,15,66,45,21,79,7
593,P'borough Utd,22,6,18,80,59,21,72,8
593,Portsmouth,17,17,12,64,56,8,68,9
593,Charlton Ath,18,13,15,71,60,11,67,10
593,Shrewsbury,19,10,17,53,49,4,67,11
593,Port Vale,17,9,20,48,64,-16,60,12
593,Exeter City,16,11,19,62,61,1,59,13
593,Bristol Rovers,16,10,20,71,84,-13,58,14
593,Fleetwood Town,13,18,15,48,49,-1,57,15
593,Lincoln City,11,23,12,42,49,-7,56,16
593,Burton Albion,12,11,23,58,86,-28,47,17
593,Acc'ton Stanley,12,11,23,37,68,-31,47,18
593,Oxford United,11,12,23,43,60,-17,45,19
593,Cheltenham,11,10,25,34,62,-28,43,20
593,Morecambe,10,13,23,42,71,-29,43,21
593,Cambridge Utd,10,10,26,40,75,-35,40,22
593,MK Dons,10,8,28,40,74,-34,38,23
593,FG Rovers,7,10,29,34,86,-52,31,24
594,Sheffield Weds,31,11,4,88,33,55,104,1
594,Ipswich Town,27,13,6,94,46,48,94,2
594,Plymouth Argyle,27,12,7,81,52,29,93,3
594,Barnsley,28,7,11,82,40,42,91,4
594,Wycombe,28,6,12,73,39,34,90,5
594,Derby County,24,12,10,68,38,30,84,6
594,P'borough Utd,26,4,16,85,55,30,82,7
594,Bolton,20,15,11,59,36,23,75,8
594,Portsmouth,18,15,13,65,52,13,69,9
594,Charlton Ath,18,14,14,65,55,10,68,10
594,Lincoln City,14,22,10,48,44,4,64,11
594,Exeter City,15,13,18,55,56,-1,58,12
594,Bristol Rovers,16,10,20,68,78,-10,58,13
594,Fleetwood Town,12,18,16,46,48,-2,54,14
594,Shrewsbury,15,9,22,53,61,-8,54,15
594,Burton Albion,13,12,21,58,81,-23,51,16
594,Port Vale,14,9,23,46,75,-29,51,17
594,Oxford United,12,12,22,51,64,-13,48,18
594,Acc'ton Stanley,11,12,23,41,74,-33,45,19
594,Cheltenham,12,8,26,33,62,-29,44,20
594,Cambridge Utd,11,8,27,35,77,-42,41,21
594,MK Dons,9,10,27,36,71,-35,37,22
594,Morecambe,7,14,25,42,77,-35,35,23
594,FG Rovers,6,10,30,33,91,-58,28,24
595,Sheffield Weds,29,13,4,95,31,64,100,1
595,Ipswich Town,25,16,5,78,38,40,91,2
595,Plymouth Argyle,27,10,9,83,52,31,91,3
595,Barnsley,26,9,11,76,43,33,87,4
595,Derby County,25,10,11,75,43,32,85,5
595,Bolton,23,14,9,67,36,31,83,6
595,Portsmouth,19,15,12,76,55,21,72,7
595,Wycombe,21,8,17,59,46,13,71,8
595,P'borough Utd,22,4,20,78,59,19,70,9
595,Fleetwood Town,18,13,15,59,46,13,67,10
595,Shrewsbury,19,9,18,55,52,3,66,11
595,Lincoln City,15,19,12,49,46,3,64,12
595,Oxford United,15,14,17,52,52,0,59,13
595,Charlton Ath,14,16,16,65,64,1,58,14
595,Bristol Rovers,15,10,21,67,83,-16,55,15
595,Acc'ton Stanley,14,12,20,42,84,-42,54,16
595,Exeter City,14,11,21,60,73,-13,53,17
595,Cheltenham,14,8,24,40,64,-24,50,18
595,Port Vale,12,10,24,46,73,-27,46,19
595,Burton Albion,11,12,23,54,86,-32,45,20
595,Cambridge Utd,11,9,26,34,67,-33,42,21
595,MK Dons,10,10,26,41,68,-27,40,22
595,Morecambe,9,12,25,50,82,-32,39,23
595,FG Rovers,6,12,28,31,89,-58,30,24
596,Sheffield Weds,28,13,5,81,32,49,97,1
596,Ipswich Town,25,14,7,89,41,48,89,2
596,Barnsley,26,10,10,71,40,31,88,3
596,Plymouth Argyle,25,12,9,76,46,30,87,4
596,Bolton,23,12,11,68,35,33,81,5
596,Derby County,22,12,12,74,48,26,78,6
596,P'borough Utd,23,7,16,73,54,19,76,7
596,Wycombe,21,12,13,58,41,17,75,8
596,Portsmouth,19,17,10,66,50,16,74,9
596,Charlton Ath,17,13,16,65,55,10,64,10
596,Shrewsbury,17,12,17,52,50,2,63,11
596,Exeter City,17,12,17,60,59,1,63,12
596,Bristol Rovers,15,13,18,64,71,-7,58,13
596,Fleetwood Town,13,17,16,43,44,-1,56,14
596,Lincoln City,10,25,11,40,46,-6,55,15
596,Port Vale,13,11,22,43,65,-22,50,16
596,Acc'ton Stanley,12,14,20,39,69,-30,50,17
596,Oxford United,11,15,20,48,63,-15,48,18
596,Morecambe,12,12,22,45,74,-29,48,19
596,Burton Albion,12,12,22,54,87,-33,48,20
596,MK Dons,12,10,24,43,66,-23,46,21
596,Cambridge Utd,11,7,28,34,74,-40,40,22
596,Cheltenham,10,9,27,34,64,-30,39,23
596,FG Rovers,8,9,29,34,80,-46,33,24
597,Sheffield Weds,31,10,5,91,33,58,103,1
597,Plymouth Argyle,27,14,5,83,47,36,95,2
597,Ipswich Town,26,15,5,90,43,47,93,3
597,Bolton,26,9,11,74,36,38,87,4
597,Barnsley,26,6,14,72,43,29,84,5
597,Derby County,22,13,11,72,44,28,79,6
597,Wycombe,24,6,16,74,51,23,78,7
597,P'borough Utd,20,7,19,72,57,15,67,8
597,Portsmouth,15,18,13,58,55,3,63,9
597,Shrewsbury,18,9,19,52,50,2,63,10
597,Lincoln City,13,23,10,45,44,1,62,11
597,Fleetwood Town,15,14,17,50,48,2,59,12
597,Bristol Rovers,16,11,19,61,71,-10,59,13
597,Charlton Ath,14,16,16,63,58,5,58,14
597,Exeter City,14,13,19,64,69,-5,55,15
597,Port Vale,14,11,21,42,61,-19,53,16
597,Morecambe,13,13,20,45,69,-24,52,17
597,Acc'ton Stanley,13,13,20,41,70,-29,52,18
597,Oxford United,12,15,19,48,57,-9,51,19
597,Cambridge Utd,14,6,26,41,72,-31,48,20
597,Cheltenham,12,10,24,33,61,-28,46,21
597,Burton Albion,10,12,24,50,93,-43,42,22
597,MK Dons,10,7,29,40,74,-34,37,23
597,FG Rovers,6,11,29,33,88,-55,29,24
598,Plymouth Argyle,29,10,7,86,50,36,97,1
598,Ipswich Town,27,15,4,92,38,54,96,2
598,Sheffield Weds,27,13,6,76,33,43,94,3
598,Derby County,27,11,8,81,38,43,92,4
598,Barnsley,23,11,12,69,44,25,80,5
598,Bolton,23,10,13,62,38,24,79,6
598,Wycombe,22,8,16,69,41,28,74,7
598,P'borough Utd,22,8,16,76,58,18,74,8
598,Portsmouth,19,15,12,65,52,13,72,9
598,Shrewsbury,20,8,18,51,50,1,68,10
598,Fleetwood Town,17,14,15,53,45,8,65,11
598,Charlton Ath,15,13,18,59,60,-1,58,12
598,Oxford United,14,12,20,48,54,-6,54,13
598,Lincoln City,11,21,14,40,48,-8,54,14
598,Port Vale,15,9,22,50,69,-19,54,15
598,Exeter City,13,14,19,51,61,-10,53,16
598,Bristol Rovers,13,13,20,69,83,-14,52,17
598,MK Dons,15,6,25,45,73,-28,51,18
598,Cheltenham,13,8,25,37,67,-30,47,19
598,Burton Albion,12,10,24,54,85,-31,46,20
598,Morecambe,10,13,23,41,70,-29,43,21
598,Acc'ton Stanley,10,13,23,38,69,-31,43,22
598,Cambridge Utd,11,8,27,36,73,-37,41,23
598,FG Rovers,8,9,29,35,84,-49,33,24
599,Sheffield Weds,29,12,5,82,29,53,99,1
599,Plymouth Argyle,29,10,7,87,48,39,97,2
599,Ipswich Town,25,15,6,91,45,46,90,3
599,Derby County,24,12,10,75,43,32,84,4
599,Bolton,24,11,11,69,35,34,83,5
599,Barnsley,24,10,12,68,43,25,82,6
599,Wycombe,24,8,14,68,48,20,80,7
599,P'borough Utd,22,8,16,74,59,15,74,8
599,Shrewsbury,20,11,15,59,47,12,71,9
599,Fleetwood Town,17,14,15,55,47,8,65,10
599,Portsmouth,16,16,14,64,53,11,64,11
599,Bristol Rovers,18,9,19,67,77,-10,63,12
599,Charlton Ath,16,14,16,73,66,7,62,13
599,Lincoln City,13,23,10,41,47,-6,62,14
599,Exeter City,14,11,21,58,68,-10,53,15
599,Oxford United,13,13,20,45,56,-11,52,16
599,Port Vale,14,10,22,42,66,-24,52,17
599,Burton Albion,13,8,25,50,84,-34,47,18
599,MK Dons,12,9,25,48,71,-23,45,19
599,Acc'ton Stanley,10,15,21,38,70,-32,45,20
599,Morecambe,9,14,23,49,74,-25,41,21
599,Cambridge Utd,11,7,28,35,72,-37,40,22
599,Cheltenham,10,8,28,29,66,-37,38,23
599,FG Rovers,6,10,30,32,85,-53,28,24
600,Sheffield Weds,31,10,5,92,33,59,103,1
600,Plymouth Argyle,30,9,7,88,47,41,99,2
600,Barnsley,24,11,11,70,44,26,83,3
600,P'borough Utd,26,4,16,86,54,32,82,4
600,Ipswich Town,22,15,9,79,44,35,81,5
600,Derby County,22,13,11,74,48,26,79,6
600,Bolton,22,11,13,61,40,21,77,7
600,Wycombe,21,12,13,56,41,15,75,8
600,Portsmouth,20,14,12,68,48,20,74,9
600,Shrewsbury,20,11,15,53,45,8,71,10
600,Fleetwood Town,17,15,14,48,41,7,66,11
600,Charlton Ath,16,15,15,69,59,10,63,12
600,Lincoln City,12,22,12,43,46,-3,58,13
600,Exeter City,15,12,19,59,63,-4,57,14
600,Oxford United,14,12,20,47,57,-10,54,15
600,Bristol Rovers,14,12,20,67,85,-18,54,16
600,Port Vale,13,9,24,45,68,-23,48,17
600,Burton Albion,12,12,22,59,93,-34,48,18
600,Cheltenham,12,10,24,41,62,-21,46,19
600,Acc'ton Stanley,11,13,22,40,74,-34,46,20
600,Morecambe,10,13,23,39,76,-37,43,21
600,MK Dons,10,12,24,45,69,-24,42,22
600,Cambridge Utd,9,8,29,35,73,-38,35,23
600,FG Rovers,7,9,30,37,91,-54,30,24
601,Sheffield Weds,30,12,4,87,32,55,102,1
601,Plymouth Argyle,30,10,6,87,49,38,100,2
601,Ipswich Town,26,13,7,82,42,40,91,3
601,Derby County,25,11,10,78,42,36,86,4
601,Barnsley,24,12,10,65,37,28,84,5
601,Wycombe,24,9,13,65,42,23,81,6
601,Bolton,22,12,12,65,40,25,78,7
601,Portsmouth,19,18,9,63,47,16,75,8
601,P'borough Utd,21,8,17,72,52,20,71,9
601,Shrewsbury,19,7,20,52,54,-2,64,10
601,Fleetwood Town,16,14,16,58,46,12,62,11
601,Charlton Ath,16,13,17,61,56,5,61,12
601,Exeter City,16,13,17,67,63,4,61,13
601,Port Vale,17,9,20,49,61,-12,60,14
601,Lincoln City,11,24,11,44,45,-1,57,15
601,Oxford United,12,16,18,48,54,-6,52,16
601,Bristol Rovers,14,10,22,62,82,-20,52,17
601,Burton Albion,13,13,20,58,78,-20,52,18
601,Cambridge Utd,13,5,28,36,76,-40,44,19
601,Cheltenham,10,13,23,30,61,-31,43,20
601,Acc'ton Stanley,8,16,22,34,67,-33,40,21
601,MK Dons,10,7,29,42,77,-35,37,22
601,Morecambe,8,11,27,41,86,-45,35,23
601,FG Rovers,6,8,32,31,88,-57,26,24
602,Sheffield Weds,27,13,6,79,32,47,94,1
602,Plymouth Argyle,26,13,7,77,50,27,91,2
602,Ipswich Town,23,15,8,83,43,40,84,3
602,Bolton,24,12,10,71,36,35,84,4
602,Wycombe,24,9,13,69,44,25,81,5
602,Derby County,22,14,10,69,40,29,80,6
602,P'borough Utd,24,7,15,78,52,26,79,7
602,Barnsley,22,9,15,63,47,16,75,8
602,Shrewsbury,22,8,16,58,49,9,74,9
602,Portsmouth,18,16,12,68,53,15,70,10
602,Lincoln City,14,19,13,50,49,1,61,11
602,Port Vale,16,10,20,47,66,-19,58,12
602,Exeter City,14,15,17,55,54,1,57,13
602,Fleetwood Town,14,15,17,50,52,-2,57,14
602,Charlton Ath,14,15,17,59,67,-8,57,15
602,Oxford United,13,14,19,49,56,-7,53,16
602,Bristol Rovers,14,8,24,62,78,-16,50,17
602,Acc'ton Stanley,12,14,20,40,67,-27,50,18
602,MK Dons,12,10,24,42,65,-23,46,19
602,Cheltenham,12,10,24,33,67,-34,46,20
602,Burton Albion,10,14,22,50,77,-27,44,21
602,Morecambe,9,15,22,47,81,-34,42,22
602,Cambridge Utd,10,11,25,38,65,-27,41,23
602,FG Rovers,7,12,27,38,85,-47,33,24
603,Sheffield Weds,31,11,4,89,28,61,104,1
603,Ipswich Town,29,12,5,97,43,54,99,2
603,Plymouth Argyle,27,11,8,89,53,36,92,3
603,Bolton,24,11,11,74,41,33,83,4
603,Derby County,22,13,11,75,47,28,79,5
603,Barnsley,23,10,13,68,46,22,79,6
603,P'borough Utd,24,6,16,83,58,25,78,7
603,Wycombe,21,11,14,65,44,21,74,8
603,Portsmouth,19,14,13,67,55,12,71,9
603,Charlton Ath,18,15,13,71,57,14,69,10
603,Fleetwood Town,17,15,14,49,41,8,66,11
603,Shrewsbury,18,11,17,52,56,-4,65,12
603,Lincoln City,15,19,12,44,45,-1,64,13
603,Port Vale,15,9,22,44,62,-18,54,14
603,Bristol Rovers,13,13,20,62,74,-12,52,15
603,Exeter City,12,13,21,56,69,-13,49,16
603,Burton Albion,12,11,23,56,83,-27,47,17
603,MK Dons,13,7,26,47,75,-28,46,18
603,Cambridge Utd,13,6,27,37,74,-37,45,19
603,Oxford United,10,14,22,44,61,-17,44,20
603,Acc'ton Stanley,10,14,22,37,73,-36,44,21
603,Morecambe,10,12,24,45,79,-34,42,22
603,Cheltenham,10,10,26,31,65,-34,40,23
603,FG Rovers,6,12,28,32,85,-53,30,24
604,Sheffield Weds,30,9,7,85,34,51,99,1
604,Plymouth Argyle,29,11,6,85,45,40,98,2
604,Bolton,25,11,10,77,37,40,86,3
604,Derby County,24,14,8,74,42,32,86,4
604,Ipswich Town,23,15,8,80,48,32,84,5
604,P'borough Utd,24,8,14,73,52,21,80,6
604,Barnsley,23,10,13,67,45,22,79,7
604,Portsmouth,19,14,13,62,54,8,71,8
604,Wycombe,20,9,17,63,46,17,69,9
604,Charlton Ath,16,14,16,70,59,11,62,10
604,Shrewsbury,17,10,19,51,49,2,61,11
604,Fleetwood Town,14,17,15,48,45,3,59,12
604,Exeter City,14,14,18,53,57,-4,56,13
604,Oxford United,14,13,19,49,51,-2,55,14
604,Lincoln City,10,25,11,42,48,-6,55,15
604,Bristol Rovers,14,10,22,67,89,-22,52,16
604,Cheltenham,14,8,24,41,63,-22,50,17
604,Morecambe,12,14,20,46,69,-23,50,18
604,Port Vale,13,11,22,44,70,-26,50,19
604,Burton Albion,11,14,21,60,89,-29,47,20
604,Acc'ton Stanley,11,14,21,35,65,-30,47,21
604,Cambridge Utd,13,6,27,41,73,-32,45,22
604,MK Dons,10,10,26,40,71,-31,40,23
604,FG Rovers,5,13,28,34,86,-52,28,24
605,Sheffield Weds,30,11,5,86,30,56,101,1
605,Plymouth Argyle,27,12,7,88,49,39,93,2
605,Ipswich Town,23,16,7,83,49,34,85,3
605,Barnsley,25,10,11,73,44,29,85,4
605,Bolton,24,11,11,67,40,27,83,5
605,P'borough Utd,26,3,17,87,54,33,81,6
605,Derby County,22,12,12,67,41,26,78,7
605,Wycombe,23,7,16,62,43,19,76,8
605,Portsmouth,20,14,12,72,49,23,74,9
605,Fleetwood Town,17,15,14,52,45,7,66,10
605,Shrewsbury,18,10,18,50,47,3,64,11
605,Charlton Ath,17,12,17,63,60,3,63,12
605,Port Vale,17,9,20,52,64,-12,60,13
605,Lincoln City,12,23,11,42,47,-5,59,14
605,Exeter City,15,12,19,59,63,-4,57,15
605,Oxford United,12,13,21,45,59,-14,49,16
605,Burton Albion,12,13,21,54,78,-24,49,17
605,MK Dons,13,9,24,41,65,-24,48,18
605,Bristol Rovers,12,10,24,58,90,-32,46,19
605,Acc'ton Stanley,10,15,21,38,66,-28,45,20
605,Cheltenham,11,11,24,32,61,-29,44,21
605,Morecambe,9,14,23,44,75,-31,41,22
605,Cambridge Utd,9,8,29,34,80,-46,35,23
605,FG Rovers,9,8,29,37,87,-50,35,24
606,Sheffield Weds,33,10,3,87,26,61,109,1
606,Plymouth Argyle,28,11,7,86,48,38,95,2
606,Ipswich Town,25,16,5,88,41,47,91,3
606,Bolton,26,9,11,70,34,36,87,4
606,Derby County,24,12,10,83,43,40,84,5
606,Barnsley,25,9,12,72,44,28,84,6
606,P'borough Utd,24,4,18,76,56,20,76,7
606,Wycombe,22,9,15,59,40,19,75,8
606,Portsmouth,19,16,11,70,54,16,73,9
606,Lincoln City,13,21,12,45,50,-5,60,10
606,Charlton Ath,13,19,14,63,58,5,58,11
606,Shrewsbury,16,9,21,54,60,-6,57,12
606,Fleetwood Town,13,16,17,44,46,-2,55,13
606,Exeter City,14,12,20,55,61,-6,54,14
606,Oxford United,14,12,20,50,56,-6,54,15
606,Port Vale,15,9,22,52,68,-16,54,16
606,Acc'ton Stanley,13,14,19,42,68,-26,53,17
606,Bristol Rovers,14,9,23,60,74,-14,51,18
606,Morecambe,12,14,20,48,72,-24,50,19
606,Cheltenham,11,11,24,38,67,-29,44,20
606,Burton Albion,11,11,24,53,95,-42,44,21
606,MK Dons,10,10,26,40,76,-36,40,22
606,Cambridge Utd,9,10,27,35,79,-44,37,23
606,FG Rovers,6,11,29,31,85,-54,29,24
607,Sheffield Weds,31,10,5,87,30,57,103,1
607,Ipswich Town,25,16,5,91,43,48,91,2
607,Barnsley,27,10,9,73,37,36,91,3
607,Plymouth Argyle,26,10,10,88,50,38,88,4
607,Bolton,26,9,11,72,33,39,87,5
607,Derby County,25,12,9,75,40,35,87,6
607,Wycombe,22,8,16,59,45,14,74,7
607,P'borough Utd,21,8,17,75,58,17,71,8
607,Charlton Ath,19,12,15,74,60,14,69,9
607,Shrewsbury,19,10,17,57,51,6,67,10
607,Portsmouth,16,15,15,55,57,-2,63,11
607,Fleetwood Town,15,17,14,51,47,4,62,12
607,Exeter City,15,14,17,59,60,-1,59,13
607,Port Vale,15,11,20,46,65,-19,56,14
607,Bristol Rovers,14,10,22,59,76,-17,52,15
607,Cheltenham,15,7,24,36,66,-30,52,16
607,Oxford United,12,13,21,47,59,-12,49,17
607,Lincoln City,9,22,15,35,48,-13,49,18
607,Burton Albion,12,12,22,53,86,-33,48,19
607,MK Dons,11,11,24,48,71,-23,44,20
607,Acc'ton Stanley,9,15,22,38,76,-38,42,21
607,Cambridge Utd,11,8,27,37,73,-36,41,22
607,Morecambe,8,14,24,45,78,-33,38,23
607,FG Rovers,7,10,29,38,89,-51,31,24
608,Sheffield Weds,29,9,8,77,32,45,96,1
608,Plymouth Argyle,28,11,7,83,49,34,95,2
608,Ipswich Town,26,15,5,82,38,44,93,3
608,Bolton,25,10,11,66,33,33,85,4
608,Barnsley,25,9,12,70,43,27,84,5
608,Derby County,23,12,11,72,43,29,81,6
608,P'borough Utd,24,7,15,80,54,26,79,7
608,Wycombe,23,9,14,63,42,21,78,8
608,Shrewsbury,20,11,15,56,47,9,71,9
608,Portsmouth,17,16,13,67,52,15,67,10
608,Charlton Ath,16,13,17,66,62,4,61,11
608,Lincoln City,13,21,12,45,48,-3,60,12
608,Fleetwood Town,15,13,18,48,45,3,58,13
608,Bristol Rovers,15,11,20,63,78,-15,56,14
608,Oxford United,14,12,20,46,55,-9,54,15
608,Exeter City,13,12,21,56,68,-12,51,16
608,Cheltenham,14,9,23,34,53,-19,51,17
608,Port Vale,13,12,21,43,65,-22,51,18
608,Acc'ton Stanley,10,16,20,43,73,-30,46,19
608,Cambridge Utd,13,6,27,39,72,-33,45,20
608,Burton Albion,11,11,24,50,79,-29,44,21
608,MK Dons,12,8,26,44,73,-29,44,22
608,Morecambe,8,12,26,37,77,-40,36,23
608,FG Rovers,7,11,28,34,83,-49,32,24
609,Sheffield Weds,29,12,5,86,29,57,99,1
609,Plymouth Argyle,27,12,7,89,52,37,93,2
609,Ipswich Town,26,13,7,81,38,43,91,3
609,Barnsley,28,5,13,73,43,30,89,4
609,Wycombe,27,5,14,69,40,29,86,5
609,Derby County,23,13,10,72,39,33,82,6
609,Bolton,23,11,12,72,42,30,80,7
609,Shrewsbury,21,9,16,66,46,20,72,8
609,Portsmouth,17,16,13,58,52,6,67,9
609,Charlton Ath,18,12,16,66,57,9,66,10
609,P'borough Utd,19,7,20,68,65,3,64,11
609,Fleetwood Town,16,14,16,51,47,4,62,12
609,Bristol Rovers,16,11,19,59,73,-14,59,13
609,Exeter City,15,13,18,62,62,0,58,14
609,Lincoln City,12,22,12,43,47,-4,58,15
609,Port Vale,15,11,20,51,70,-19,56,16
609,Oxford United,14,9,23,48,67,-19,51,17
609,Burton Albion,12,12,22,54,82,-28,48,18
609,Morecambe,11,11,24,46,78,-32,44,19
609,Cheltenham,10,13,23,35,61,-26,43,20
609,Cambridge Utd,12,7,27,42,83,-41,43,21
609,Acc'ton Stanley,8,15,23,35,68,-33,39,22
609,MK Dons,10,8,28,39,74,-35,38,23
609,FG Rovers,7,11,28,38,88,-50,32,24
610,Sheffield Weds,28,14,4,79,29,50,98,1
610,Plymouth Argyle,27,11,8,84,52,32,92,2
610,Ipswich Town,24,15,7,82,40,42,87,3
610,Wycombe,26,9,11,68,33,35,87,4
610,Derby County,25,12,9,71,37,34,87,5
610,Barnsley,24,9,13,67,46,21,81,6
610,Bolton,22,13,11,64,38,26,79,7
610,P'borough Utd,23,8,15,79,54,25,77,8
610,Portsmouth,17,17,12,62,53,9,68,9
610,Fleetwood Town,17,16,13,52,44,8,67,10
610,Shrewsbury,19,9,18,54,51,3,66,11
610,Lincoln City,13,23,10,51,48,3,62,12
610,Exeter City,15,14,17,58,54,4,59,13
610,Port Vale,15,12,19,45,58,-13,57,14
610,Charlton Ath,13,15,18,58,57,1,54,15
610,Bristol Rovers,14,12,20,63,78,-15,54,16
610,Burton Albion,14,8,24,55,85,-30,50,17
610,Cheltenham,13,9,24,36,62,-26,48,18
610,Oxford United,11,12,23,43,60,-17,45,19
610,MK Dons,12,8,26,42,70,-28,44,20
610,Cambridge Utd,11,9,26,37,75,-38,42,21
610,Acc'ton Stanley,8,17,21,37,70,-33,41,22
610,Morecambe,7,12,27,37,76,-39,33,23
610,FG Rovers,6,12,28,33,87,-54,30,24
611,Sheffield Weds,31,12,3,91,32,59,105,1
611,Plymouth Argyle,29,10,7,92,55,37,97,2
611,Barnsley,28,8,10,76,42,34,92,3
611,Ipswich Town,24,15,7,82,40,42,87,4
611,Derby County,25,12,9,80,38,42,87,5
611,Bolton,24,11,11,67,36,31,83,6
611,Wycombe,23,11,12,59,37,22,80,7
611,P'borough Utd,22,8,16,73,56,17,74,8
611,Portsmouth,17,16,13,61,56,5,67,9
611,Fleetwood Town,16,17,13,56,43,13,65,10
611,Exeter City,16,13,17,67,64,3,61,11
611,Shrewsbury,17,10,19,54,55,-1,61,12
611,Lincoln City,13,22,11,47,50,-3,61,13
611,Charlton Ath,13,16,17,63,64,-1,55,14
611,Port Vale,15,10,21,48,62,-14,55,15
611,Oxford United,14,11,21,48,53,-5,53,16
611,Bristol Rovers,13,12,21,57,83,-26,51,17
611,Cheltenham,13,7,26,34,64,-30,46,18
611,Cambridge Utd,12,9,25,37,67,-30,45,19
611,Morecambe,10,12,24,50,77,-27,42,20
611,Acc'ton Stanley,9,14,23,36,71,-35,41,21
611,Burton Albion,10,9,27,55,100,-45,39,22
611,MK Dons,9,10,27,37,69,-32,37,23
611,FG Rovers,7,9,30,33,89,-56,30,24
612,Sheffield Weds,33,8,5,88,31,57,107,1
612,Plymouth Argyle,28,10,8,90,49,41,94,2
612,Ipswich Town,25,14,7,84,46,38,89,3
612,Bolton,24,10,12,75,38,37,82,4
612,Derby County,23,11,12,68,42,26,80,5
612,Barnsley,24,7,15,68,50,18,79,6
612,Wycombe,23,8,15,64,41,23,77,7
612,Fleetwood Town,19,14,13,60,41,19,71,8
612,P'borough Utd,20,9,17,73,57,16,69,9
612,Portsmouth,17,18,11,65,54,11,69,10
612,Exeter City,19,9,18,67,60,7,66,11
612,Shrewsbury,19,9,18,57,52,5,66,12
612,Charlton Ath,16,15,15,67,56,11,63,13
612,Port Vale,16,10,20,52,65,-13,58,14
612,Lincoln City,12,19,15,42,57,-15,55,15
612,Oxford United,13,13,20,51,59,-8,52,16
612,Bristol Rovers,14,10,22,58,81,-23,52,17
612,Cheltenham,14,9,23,34,54,-20,51,18
612,MK Dons,14,8,24,45,67,-22,50,19
612,Burton Albion,11,10,25,50,87,-37,43,20
612,Cambridge Utd,11,8,27,37,76,-39,41,21
612,Acc'ton Stanley,9,14,23,38,78,-40,41,22
612,Morecambe,9,13,24,46,76,-30,40,23
612,FG Rovers,6,10,30,31,93,-62,28,24
613,Sheffield Weds,32,11,3,84,27,57,107,1
613,Bolton,27,10,9,73,32,41,91,2
613,Plymouth Argyle,26,13,7,80,49,31,91,3
613,Barnsley,27,7,12,71,39,32,88,4
613,Derby County,24,13,9,82,48,34,85,5
613,Wycombe,24,9,13,62,39,23,81,6
613,Ipswich Town,21,14,11,76,50,26,77,7
613,P'borough Utd,23,7,16,79,56,23,76,8
613,Portsmouth,17,17,12,61,53,8,68,9
613,Shrewsbury,19,9,18,53,49,4,66,10
613,Fleetwood Town,16,16,14,56,48,8,64,11
613,Lincoln City,13,22,11,46,44,2,61,12
613,Charlton Ath,14,18,14,64,57,7,60,13
613,Port Vale,16,10,20,50,66,-16,58,14
613,Exeter City,14,14,18,62,66,-4,56,15
613,Burton Albion,15,9,22,58,79,-21,54,16
613,Oxford United,11,14,21,42,61,-19,47,17
613,Cheltenham,12,9,25,31,60,-29,45,18
613,Acc'ton Stanley,10,14,22,41,69,-28,44,19
613,Bristol Rovers,11,11,24,57,92,-35,44,20
613,Morecambe,9,14,23,41,69,-28,41,21
613,MK Dons,9,9,28,40,74,-34,36,22
613,Cambridge Utd,9,9,28,37,77,-40,36,23
613,FG Rovers,8,11,27,42,84,-42,35,24
614,Sheffield Weds,31,9,6,89,32,57,102,1
614,Plymouth Argyle,30,9,7,88,47,41,99,2
614,Barnsley,28,9,9,78,38,40,93,3
614,Ipswich Town,23,15,8,86,46,40,84,4
614,Bolton,24,12,10,68,33,35,84,5
614,Derby County,24,11,11,76,42,34,83,6
614,Wycombe,24,8,14,68,38,30,80,7
614,Portsmouth,21,14,11,69,49,20,77,8
614,P'borough Utd,22,7,17,76,62,14,73,9
614,Charlton Ath,19,15,12,69,53,16,72,10
614,Shrewsbury,19,9,18,54,48,6,66,11
614,Fleetwood Town,17,15,14,53,48,5,66,12
614,Lincoln City,13,22,11,44,46,-2,61,13
614,Port Vale,14,11,21,45,65,-20,53,14
614,Oxford United,12,15,19,46,54,-8,51,15
614,Exeter City,13,12,21,57,67,-10,51,16
614,Bristol Rovers,13,10,23,66,85,-19,49,17
614,MK Dons,13,9,24,45,65,-20,48,18
614,Acc'ton Stanley,10,14,22,40,81,-41,44,19
614,Burton Albion,10,10,26,45,93,-48,40,20
614,Cheltenham,10,8,28,32,64,-32,38,21
614,Morecambe,9,11,26,42,86,-44,38,22
614,Cambridge Utd,9,8,29,35,81,-46,35,23
614,FG Rovers,7,11,28,37,85,-48,32,24
615,Sheffield Weds,31,10,5,88,31,57,103,1
615,Ipswich Town,27,14,5,96,44,52,95,2
615,Plymouth Argyle,26,10,10,84,53,31,88,3
615,Barnsley,25,11,10,75,44,31,86,4
615,Bolton,23,10,13,70,46,24,79,5
615,Wycombe,23,10,13,64,46,18,79,6
615,Derby County,21,13,12,65,42,23,76,7
615,P'borough Utd,23,5,18,78,59,19,74,8
615,Portsmouth,18,16,12,65,50,15,70,9
615,Shrewsbury,19,9,18,53,52,1,66,10
615,Charlton Ath,17,14,15,63,55,8,65,11
615,Exeter City,17,11,18,62,67,-5,62,12
615,Port Vale,18,8,20,49,61,-12,62,13
615,Bristol Rovers,15,15,16,60,69,-9,60,14
615,Lincoln City,12,21,13,40,48,-8,57,15
615,Fleetwood Town,14,13,19,48,51,-3,55,16
615,Acc'ton Stanley,12,11,23,41,76,-35,47,17
615,Cheltenham,11,12,23,34,58,-24,45,18
615,Oxford United,11,11,24,45,61,-16,44,19
615,MK Dons,11,10,25,43,66,-23,43,20
615,Morecambe,10,13,23,44,75,-31,43,21
615,Cambridge Utd,12,7,27,39,70,-31,43,22
615,Burton Albion,10,12,24,51,86,-35,42,23
615,FG Rovers,8,10,28,39,86,-47,34,24
616,Sheffield Weds,28,15,3,87,33,54,99,1
616,Plymouth Argyle,28,11,7,86,49,37,95,2
616,Ipswich Town,25,15,6,91,44,47,90,3
616,Barnsley,27,9,10,73,37,36,90,4
616,Bolton,26,11,9,76,34,42,89,5
616,Derby County,25,10,11,74,40,34,85,6
616,Wycombe,24,10,12,66,38,28,82,7
616,P'borough Utd,23,6,17,73,55,18,75,8
616,Charlton Ath,20,12,14,71,54,17,72,9
616,Portsmouth,16,18,12,63,50,13,66,10
616,Exeter City,17,11,18,62,59,3,62,11
616,Fleetwood Town,15,16,15,53,47,6,61,12
616,Shrewsbury,18,7,21,53,60,-7,61,13
616,Bristol Rovers,14,12,20,66,83,-17,54,14
616,Lincoln City,10,22,14,41,50,-9,52,15
616,Burton Albion,12,13,21,58,85,-27,49,16
616,Oxford United,13,9,24,47,61,-14,48,17
616,MK Dons,12,11,23,43,66,-23,47,18
616,Port Vale,12,11,23,41,68,-27,47,19
616,Cheltenham,12,9,25,34,64,-30,45,20
616,Morecambe,10,12,24,44,81,-37,42,21
616,Acc'ton Stanley,9,14,23,37,74,-37,41,22
616,Cambridge Utd,8,10,28,35,81,-46,34,23
616,FG Rovers,6,10,30,34,95,-61,28,24
617,Sheffield Weds,31,11,4,83,28,55,104,1
617,Plymouth Argyle,30,8,8,90,49,41,98,2
617,Ipswich Town,25,14,7,85,37,48,89,3
617,Derby County,25,10,11,73,38,35,85,4
617,Barnsley,25,10,11,74,41,33,85,5
617,Bolton,25,8,13,65,35,30,83,6
617,Wycombe,21,9,16,60,48,12,72,7
617,P'borough Utd,21,8,17,77,61,16,71,8
617,Portsmouth,18,14,14,55,53,2,68,9
617,Lincoln City,16,20,10,46,45,1,68,10
617,Shrewsbury,20,8,18,51,51,0,68,11
617,Fleetwood Town,15,15,16,50,47,3,60,12
617,Charlton Ath,14,18,14,64,62,2,60,13
617,Exeter City,17,9,20,58,60,-2,60,14
617,Port Vale,15,11,20,46,63,-17,56,15
617,Bristol Rovers,14,11,21,65,84,-19,53,16
617,Oxford United,13,11,22,44,54,-10,50,17
617,Burton Albion,12,13,21,57,84,-27,49,18
617,Cheltenham,13,9,24,39,63,-24,48,19
617,Cambridge Utd,12,9,25,39,69,-30,45,20
617,MK Dons,10,9,27,42,73,-31,39,21
617,Morecambe,7,15,24,41,73,-32,36,22
617,Acc'ton Stanley,7,15,24,33,72,-39,36,23
617,FG Rovers,9,9,28,41,88,-47,36,24
618,Sheffield Weds,31,11,4,86,33,53,104,1
618,Ipswich Town,25,15,6,90,49,41,90,2
618,Plymouth Argyle,27,9,10,82,52,30,90,3
618,Barnsley,25,8,13,67,41,26,83,4
618,Derby County,23,11,12,70,40,30,80,5
618,Bolton,23,11,12,67,37,30,80,6
618,P'borough Utd,23,8,15,84,57,27,77,7
618,Wycombe,23,8,15,63,46,17,77,8
618,Shrewsbury,20,12,14,52,45,7,72,9
618,Portsmouth,19,14,13,64,52,12,71,10
618,Fleetwood Town,17,15,14,52,43,9,66,11
618,Charlton Ath,17,13,16,65,61,4,64,12
618,Port Vale,16,10,20,48,61,-13,58,13
618,Lincoln City,12,21,13,42,50,-8,57,14
618,Bristol Rovers,16,9,21,65,81,-16,57,15
618,Oxford United,15,11,20,50,52,-2,56,16
618,Exeter City,14,11,21,57,63,-6,53,17
618,Burton Albion,14,10,22,57,83,-26,52,18
618,Acc'ton Stanley,10,14,22,36,65,-29,44,19
618,Cheltenham,11,9,26,32,64,-32,42,20
618,Morecambe,9,14,23,43,72,-29,41,21
618,Cambridge Utd,11,7,28,38,75,-37,40,22
618,MK Dons,9,9,28,38,76,-38,36,23
618,FG Rovers,7,10,29,37,87,-50,31,24
619,Plymouth Argyle,32,9,5,90,47,43,105,1
619,Sheffield Weds,30,11,5,88,29,59,101,2
619,Ipswich Town,24,16,6,88,43,45,88,3
619,Derby County,23,13,10,72,43,29,82,4
619,Wycombe,25,7,14,68,44,24,82,5
619,Bolton,22,14,10,67,41,26,80,6
619,Barnsley,23,8,15,67,47,20,77,7
619,P'borough Utd,21,7,18,73,59,14,70,8
619,Shrewsbury,20,9,17,55,53,2,69,9
619,Portsmouth,17,16,13,60,51,9,67,10
619,Charlton Ath,18,12,16,66,61,5,66,11
619,Fleetwood Town,15,18,13,50,43,7,63,12
619,Lincoln City,12,23,11,49,51,-2,59,13
619,Exeter City,15,11,20,59,63,-4,56,14
619,Bristol Rovers,14,12,20,59,73,-14,54,15
619,Cheltenham,14,9,23,37,59,-22,51,16
619,Port Vale,12,14,20,42,62,-20,50,17
619,Oxford United,10,17,19,43,53,-10,47,18
619,MK Dons,13,8,25,44,68,-24,47,19
619,Burton Albion,12,11,23,53,88,-35,47,20
619,Acc'ton Stanley,9,15,22,34,71,-37,42,21
619,Morecambe,9,14,23,45,73,-28,41,22
619,Cambridge Utd,10,7,29,34,72,-38,37,23
619,FG Rovers,6,11,29,33,82,-49,29,24
620,Sheffield Weds,30,10,6,89,32,57,100,1
620,Plymouth Argyle,27,12,7,86,48,38,93,2
620,Bolton,24,11,11,70,38,32,83,3
620,Barnsley,25,8,13,65,39,26,83,4
620,Ipswich Town,23,12,11,82,50,32,81,5
620,Derby County,22,15,9,69,38,31,81,6
620,Portsmouth,20,14,12,65,49,16,74,7
620,Wycombe,22,8,16,61,45,16,74,8
620,Shrewsbury,21,9,16,58,51,7,72,9
620,P'borough Utd,20,7,19,74,61,13,67,10
620,Lincoln City,16,19,11,49,47,2,67,11
620,Bristol Rovers,17,11,18,69,76,-7,62,12
620,Fleetwood Town,16,13,17,48,44,4,61,13
620,Burton Albion,16,9,21,58,84,-26,57,14
620,Charlton Ath,14,14,18,62,67,-5,56,15
620,Oxford United,15,10,21,47,56,-9,55,16
620,Port Vale,15,10,21,47,65,-18,55,17
620,Exeter City,13,11,22,58,66,-8,50,18
620,Morecambe,12,13,21,51,72,-21,49,19
620,Cambridge Utd,12,11,23,39,66,-27,47,20
620,Cheltenham,10,10,26,30,65,-35,40,21
620,MK Dons,10,9,27,38,70,-32,39,22
620,Acc'ton Stanley,8,15,23,37,76,-39,39,23
620,FG Rovers,9,9,28,34,81,-47,36,24
621,Sheffield Weds,31,9,6,83,33,50,102,1
621,Plymouth Argyle,27,12,7,77,45,32,93,2
621,Ipswich Town,25,13,8,80,46,34,88,3
621,Barnsley,26,9,11,75,44,31,87,4
621,Derby County,23,13,10,74,38,36,82,5
621,Bolton,24,10,12,65,35,30,82,6
621,Portsmouth,21,16,9,66,44,22,79,7
621,P'borough Utd,23,5,18,76,55,21,74,8
621,Wycombe,22,8,16,65,48,17,74,9
621,Charlton Ath,19,13,14,67,51,16,70,10
621,Exeter City,18,10,18,62,62,0,64,11
621,Shrewsbury,18,8,20,49,52,-3,62,12
621,Fleetwood Town,15,15,16,47,46,1,60,13
621,Lincoln City,12,21,13,43,46,-3,57,14
621,Cambridge Utd,17,6,23,48,68,-20,57,15
621,Bristol Rovers,15,11,20,68,80,-12,56,16
621,Port Vale,14,10,22,49,66,-17,52,17
621,Oxford United,12,13,21,48,58,-10,49,18
621,Burton Albion,11,12,23,57,86,-29,45,19
621,Cheltenham,10,10,26,35,72,-37,40,20
621,MK Dons,10,9,27,39,68,-29,39,21
621,Acc'ton Stanley,8,15,23,35,71,-36,39,22
621,Morecambe,8,14,24,39,77,-38,38,23
621,FG Rovers,7,10,29,35,91,-56,31,24
622,Sheffield Weds,30,10,6,90,33,57,100,1
622,Barnsley,29,8,9,74,41,33,95,2
622,Plymouth Argyle,26,11,9,76,51,25,89,3
622,Ipswich Town,24,13,9,89,55,34,85,4
622,Derby County,22,14,10,69,43,26,80,5
622,Bolton,22,11,13,64,42,22,77,6
622,Fleetwood Town,21,13,12,60,42,18,76,7
622,Wycombe,22,8,16,61,47,14,74,8
622,Shrewsbury,20,13,13,57,44,13,73,9
622,P'borough Utd,22,6,18,72,56,16,72,10
622,Portsmouth,16,20,10,61,48,13,68,11
622,Charlton Ath,16,14,16,64,57,7,62,12
622,Exeter City,17,9,20,60,58,2,60,13
622,Lincoln City,13,21,12,46,48,-2,60,14
622,Port Vale,14,12,20,47,64,-17,54,15
622,Oxford United,12,15,19,47,56,-9,51,16
622,Cambridge Utd,12,11,23,37,64,-27,47,17
622,Acc'ton Stanley,10,16,20,41,71,-30,46,18
622,Bristol Rovers,11,12,23,57,85,-28,45,19
622,Burton Albion,11,11,24,59,88,-29,44,20
622,Morecambe,9,15,22,47,73,-26,42,21
622,MK Dons,10,11,25,45,71,-26,41,22
622,Cheltenham,11,8,27,37,69,-32,41,23
622,FG Rovers,6,10,30,31,85,-54,28,24
623,Sheffield Weds,31,9,6,95,33,62,102,1
623,Plymouth Argyle,28,10,8,92,51,41,94,2
623,Derby County,27,10,9,77,43,34,91,3
623,Barnsley,27,9,10,70,39,31,90,4
623,Ipswich Town,24,15,7,81,41,40,87,5
623,Bolton,25,10,11,70,36,34,85,6
623,Wycombe,25,9,12,64,40,24,84,7
623,Portsmouth,19,16,11,60,48,12,73,8
623,P'borough Utd,21,4,21,74,68,6,67,9
623,Fleetwood Town,16,15,15,46,43,3,63,10
623,Exeter City,17,11,18,67,64,3,62,11
623,Shrewsbury,16,11,19,49,50,-1,59,12
623,Lincoln City,13,19,14,47,47,0,58,13
623,Oxford United,16,10,20,52,60,-8,58,14
623,Charlton Ath,13,16,17,65,67,-2,55,15
623,Port Vale,14,11,21,48,67,-19,53,16
623,Burton Albion,14,11,21,57,85,-28,53,17
623,Bristol Rovers,13,11,22,60,80,-20,50,18
623,Cheltenham,13,9,24,31,60,-29,48,19
623,Morecambe,9,15,22,47,74,-27,42,20
623,MK Dons,10,10,26,40,64,-24,40,21
623,Cambridge Utd,9,13,24,38,72,-34,40,22
623,Acc'ton Stanley,7,16,23,38,80,-42,37,23
623,FG Rovers,5,10,31,31,87,-56,25,24
624,Sheffield Weds,30,11,5,82,34,48,101,1
624,Bolton,27,9,10,69,35,34,90,2
624,Ipswich Town,25,14,7,82,43,39,89,3
624,Plymouth Argyle,24,14,8,84,54,30,86,4
624,Barnsley,25,9,12,67,42,25,84,5
624,P'borough Utd,26,5,15,83,53,30,83,6
624,Wycombe,22,11,13,61,39,22,77,7
624,Shrewsbury,23,8,15,61,48,13,77,8
624,Portsmouth,19,14,13,70,48,22,71,9
624,Derby County,19,11,16,62,47,15,68,10
624,Fleetwood Town,16,15,15,49,45,4,63,11
624,Charlton Ath,16,13,17,62,60,2,61,12
624,Port Vale,17,9,20,53,65,-12,60,13
624,Exeter City,14,15,17,55,56,-1,57,14
624,Bristol Rovers,15,11,20,68,80,-12,56,15
624,Oxford United,14,13,19,50,56,-6,55,16
624,Lincoln City,10,22,14,38,48,-10,52,17
624,Acc'ton Stanley,11,13,22,43,70,-27,46,18
624,Cheltenham,13,7,26,36,67,-31,46,19
624,Burton Albion,12,9,25,56,87,-31,45,20
624,MK Dons,12,7,27,41,72,-31,43,21
624,Cambridge Utd,11,9,26,36,71,-35,42,22
624,Morecambe,9,11,26,41,80,-39,38,23
624,FG Rovers,6,12,28,31,80,-49,30,24
625,Sheffield Weds,33,9,4,93,30,63,108,1
625,Plymouth Argyle,30,8,8,93,53,40,98,2
625,Ipswich Town,27,14,5,93,38,55,95,3
625,Derby County,24,11,11,74,43,31,83,4
625,Barnsley,24,11,11,71,44,27,83,5
625,Bolton,23,10,13,66,39,27,79,6
625,Wycombe,21,10,15,66,43,23,73,7
625,P'borough Utd,23,3,20,79,64,15,72,8
625,Portsmouth,19,14,13,62,50,12,71,9
625,Lincoln City,14,24,8,45,41,4,66,10
625,Fleetwood Town,16,14,16,48,48,0,62,11
625,Exeter City,16,12,18,60,61,-1,60,12
625,Shrewsbury,17,8,21,52,58,-6,59,13
625,Charlton Ath,15,13,18,62,58,4,58,14
625,Port Vale,15,10,21,45,66,-21,55,15
625,Burton Albion,15,10,21,55,85,-30,55,16
625,Bristol Rovers,14,12,20,65,80,-15,54,17
625,Cambridge Utd,16,5,25,41,66,-25,53,18
625,Oxford United,11,14,21,45,58,-13,47,19
625,Cheltenham,12,10,24,33,65,-32,46,20
625,MK Dons,10,10,26,39,73,-34,40,21
625,Acc'ton Stanley,9,12,25,35,77,-42,39,22
625,Morecambe,8,14,24,43,76,-33,38,23
625,FG Rovers,6,10,30,37,86,-49,28,24
626,Sheffield Weds,29,12,5,78,31,47,99,1
626,Plymouth Argyle,28,12,6,89,51,38,96,2
626,Barnsley,28,9,9,80,38,42,93,3
626,Bolton,26,8,12,72,41,31,86,4
626,Wycombe,25,8,13,61,39,22,83,5
626,Ipswich Town,22,16,8,76,44,32,82,6
626,Derby County,24,10,12,71,39,32,82,7
626,P'borough Utd,21,7,18,67,60,7,70,8
626,Fleetwood Town,18,15,13,53,39,14,69,9
626,Lincoln City,16,20,10,54,42,12,68,10
626,Portsmouth,18,14,14,56,49,7,68,11
626,Shrewsbury,19,7,20,54,52,2,64,12
626,Charlton Ath,16,14,16,62,58,4,62,13
626,Exeter City,16,13,17,60,55,5,61,14
626,Bristol Rovers,15,9,22,61,77,-16,54,15
626,Oxford United,13,11,22,51,64,-13,50,16
626,Port Vale,13,11,22,44,64,-20,50,17
626,Burton Albion,12,11,23,51,78,-27,47,18
626,Cheltenham,11,12,23,33,60,-27,45,19
626,Cambridge Utd,12,9,25,40,70,-30,45,20
626,Morecambe,10,12,24,42,81,-39,42,21
626,MK Dons,11,8,27,42,74,-32,41,22
626,Acc'ton Stanley,8,11,27,35,72,-37,35,23
626,FG Rovers,6,11,29,34,88,-54,29,24
627,Sheffield Weds,28,13,5,82,32,50,97,1
627,Plymouth Argyle,29,10,7,81,46,35,97,2
627,Ipswich Town,25,15,6,85,41,44,90,3
627,Bolton,25,11,10,73,35,38,86,4
627,Wycombe,25,7,14,65,42,23,82,5
627,Barnsley,24,9,13,61,41,20,81,6
627,P'borough Utd,23,5,18,78,59,19,74,7
627,Portsmouth,19,15,12,60,51,9,72,8
627,Shrewsbury,20,10,16,53,48,5,70,9
627,Charlton Ath,18,14,14,70,60,10,68,10
627,Derby County,18,13,15,61,46,15,67,11
627,Exeter City,17,13,16,63,56,7,64,12
627,Bristol Rovers,17,10,19,65,73,-8,61,13
627,Lincoln City,12,23,11,40,39,1,59,14
627,Fleetwood Town,14,16,16,48,48,0,58,15
627,MK Dons,15,8,23,47,65,-18,53,16
627,Oxford United,12,12,22,47,61,-14,48,17
627,Port Vale,12,12,22,43,64,-21,48,18
627,Burton Albion,13,9,24,54,87,-33,48,19
627,Cheltenham,11,12,23,35,61,-26,45,20
627,Acc'ton Stanley,8,15,23,40,73,-33,39,21
627,Morecambe,8,14,24,44,74,-30,38,22
627,Cambridge Utd,10,8,28,35,77,-42,38,23
627,FG Rovers,6,12,28,30,81,-51,30,24
628,Sheffield Weds,26,14,6,75,31,44,92,1
628,Plymouth Argyle,26,13,7,86,50,36,91,2
628,Barnsley,27,8,11,68,39,29,89,3
628,Bolton,25,11,10,69,38,31,86,4
628,Ipswich Town,23,15,8,78,45,33,84,5
628,Derby County,23,12,11,73,38,35,81,6
628,Portsmouth,19,17,10,66,51,15,74,7
628,Wycombe,22,7,17,69,52,17,73,8
628,P'borough Utd,21,9,16,73,56,17,72,9
628,Shrewsbury,21,8,17,58,52,6,71,10
628,Charlton Ath,17,12,17,69,64,5,63,11
628,Lincoln City,12,23,11,45,44,1,59,12
628,Bristol Rovers,16,10,20,68,82,-14,58,13
628,Exeter City,15,12,19,54,57,-3,57,14
628,Fleetwood Town,14,15,17,48,54,-6,57,15
628,Port Vale,14,10,22,43,62,-19,52,16
628,Cambridge Utd,14,10,22,46,67,-21,52,17
628,Cheltenham,14,9,23,36,61,-25,51,18
628,Oxford United,12,12,22,50,57,-7,48,19
628,Burton Albion,12,10,24,55,87,-32,46,20
628,Morecambe,10,13,23,51,79,-28,43,21
628,Acc'ton Stanley,9,16,21,40,71,-31,43,22
628,MK Dons,10,9,27,37,68,-31,39,23
628,FG Rovers,7,11,28,33,85,-52,32,24
629,Sheffield Weds,27,13,6,77,34,43,94,1
629,Plymouth Argyle,26,12,8,82,47,35,90,2
629,Ipswich Town,24,16,6,82,43,39,88,3
629,Barnsley,25,11,10,75,45,30,86,4
629,Derby County,23,12,11,78,42,36,81,5
629,Bolton,24,9,13,67,43,24,81,6
629,Wycombe,22,8,16,63,48,15,74,7
629,Portsmouth,19,15,12,72,58,14,72,8
629,P'borough Utd,21,9,16,75,62,13,72,9
629,Lincoln City,16,21,9,49,42,7,69,10
629,Shrewsbury,20,8,18,50,48,2,68,11
629,Exeter City,17,11,18,62,58,4,62,12
629,Fleetwood Town,14,18,14,48,43,5,60,13
629,Oxford United,15,13,18,55,53,2,58,14
629,Charlton Ath,14,15,17,61,62,-1,57,15
629,Bristol Rovers,16,9,21,63,77,-14,57,16
629,Port Vale,15,9,22,50,73,-23,54,17
629,Cheltenham,12,11,23,35,60,-25,47,18
629,Cambridge Utd,13,8,25,48,76,-28,47,19
629,Acc'ton Stanley,10,15,21,39,66,-27,45,20
629,Burton Albion,11,11,24,56,88,-32,44,21
629,Morecambe,9,13,24,40,73,-33,40,22
629,MK Dons,10,9,27,42,74,-32,39,23
629,FG Rovers,6,10,30,34,88,-54,28,24
630,Ipswich Town,28,14,4,97,43,54,98,1
630,Sheffield Weds,29,11,6,82,31,51,98,2
630,Derby County,27,11,8,81,37,44,92,3
630,Plymouth Argyle,27,10,9,90,52,38,91,4
630,Wycombe,25,7,14,64,44,20,82,5
630,Bolton,22,10,14,67,43,24,76,6
630,P'borough Utd,23,5,18,72,63,9,74,7
630,Barnsley,22,6,18,65,57,8,72,8
630,Portsmouth,19,13,14,63,53,10,70,9
630,Exeter City,18,13,15,68,58,10,67,10
630,Shrewsbury,18,10,18,49,47,2,64,11
630,Charlton Ath,17,12,17,68,63,5,63,12
630,Oxford United,16,12,18,53,53,0,60,13
630,Lincoln City,14,17,15,46,52,-6,59,14
630,Fleetwood Town,15,13,18,54,48,6,58,15
630,Morecambe,14,11,21,48,72,-24,53,16
630,Bristol Rovers,14,10,22,57,82,-25,52,17
630,Port Vale,13,10,23,50,70,-20,49,18
630,Cheltenham,13,8,25,36,61,-25,47,19
630,MK Dons,12,9,25,44,65,-21,45,20
630,Acc'ton Stanley,9,17,20,38,68,-30,44,21
630,Burton Albion,11,11,24,56,90,-34,44,22
630,Cambridge Utd,11,9,26,42,75,-33,42,23
630,FG Rovers,6,9,31,31,94,-63,27,24
631,Sheffield Weds,33,9,4,86,29,57,108,1
631,Plymouth Argyle,27,12,7,81,46,35,93,2
631,Ipswich Town,23,18,5,79,38,41,87,3
631,Barnsley,25,10,11,69,39,30,85,4
631,Wycombe,25,8,13,68,42,26,83,5
631,Derby County,23,13,10,72,46,26,82,6
631,Bolton,21,11,14,63,40,23,74,7
631,Portsmouth,20,14,12,70,49,21,74,8
631,P'borough Utd,20,8,18,70,62,8,68,9
631,Fleetwood Town,15,19,12,53,43,10,64,10
631,Charlton Ath,17,13,16,65,60,5,64,11
631,Shrewsbury,16,13,17,51,53,-2,61,12
631,Exeter City,16,11,19,55,58,-3,59,13
631,Acc'ton Stanley,16,11,19,46,64,-18,59,14
631,Lincoln City,12,20,14,45,51,-6,56,15
631,Port Vale,15,10,21,45,61,-16,55,16
631,Bristol Rovers,12,13,21,61,79,-18,49,17
631,MK Dons,13,8,25,41,65,-24,47,18
631,Burton Albion,12,10,24,56,81,-25,46,19
631,Cheltenham,12,10,24,34,61,-27,46,20
631,Morecambe,9,17,20,45,71,-26,44,21
631,Oxford United,10,11,25,44,61,-17,41,22
631,Cambridge Utd,9,8,29,32,78,-46,35,23
631,FG Rovers,6,13,27,31,85,-54,31,24
632,Sheffield Weds,28,12,6,80,33,47,96,1
632,Barnsley,28,10,8,78,35,43,94,2
632,Derby County,25,13,8,82,39,43,88,3
632,Ipswich Town,23,16,7,85,46,39,85,4
632,Plymouth Argyle,24,12,10,87,59,28,84,5
632,Wycombe,24,8,14,78,47,31,80,6
632,Bolton,22,12,12,64,38,26,78,7
632,Portsmouth,20,13,13,63,56,7,73,8
632,P'borough Utd,21,9,16,73,57,16,72,9
632,Shrewsbury,17,13,16,56,54,2,64,10
632,Exeter City,17,11,18,59,67,-8,62,11
632,Port Vale,17,11,18,53,62,-9,62,12
632,Charlton Ath,15,16,15,66,60,6,61,13
632,Cheltenham,17,10,19,42,52,-10,61,14
632,Lincoln City,12,23,11,43,44,-1,59,15
632,Fleetwood Town,15,13,18,52,46,6,58,16
632,Acc'ton Stanley,12,13,21,46,71,-25,49,17
632,Morecambe,11,13,22,48,74,-26,46,18
632,Oxford United,11,12,23,45,61,-16,45,19
632,Bristol Rovers,12,9,25,61,87,-26,45,20
632,Burton Albion,11,12,23,56,93,-37,45,21
632,MK Dons,11,6,29,40,76,-36,39,22
632,Cambridge Utd,9,10,27,34,77,-43,37,23
632,FG Rovers,6,11,29,34,91,-57,29,24
633,Sheffield Weds,31,9,6,80,33,47,102,1
633,Plymouth Argyle,28,9,9,86,55,31,93,2
633,Ipswich Town,26,14,6,89,45,44,92,3
633,Derby County,24,12,10,77,43,34,84,4
633,Bolton,24,10,12,65,35,30,82,5
633,Wycombe,23,8,15,63,41,22,77,6
633,Barnsley,22,9,15,72,49,23,75,7
633,Portsmouth,19,16,11,69,49,20,73,8
633,P'borough Utd,21,10,15,70,59,11,73,9
633,Fleetwood Town,18,14,14,55,45,10,68,10
633,Shrewsbury,18,12,16,60,50,10,66,11
633,Charlton Ath,16,15,15,68,62,6,63,12
633,Lincoln City,13,21,12,49,49,0,60,13
633,Exeter City,15,14,17,60,62,-2,59,14
633,Port Vale,16,8,22,46,65,-19,56,15
633,Burton Albion,14,11,21,58,78,-20,53,16
633,Oxford United,13,11,22,43,55,-12,50,17
633,Bristol Rovers,12,12,22,60,79,-19,48,18
633,MK Dons,13,7,26,46,72,-26,46,19
633,Acc'ton Stanley,11,12,23,37,76,-39,45,20
633,Morecambe,9,14,23,43,72,-29,41,21
633,Cheltenham,10,10,26,32,67,-35,40,22
633,Cambridge Utd,9,10,27,38,78,-40,37,23
633,FG Rovers,8,10,28,35,82,-47,34,24
634,Sheffield Weds,32,8,6,83,35,48,104,1
634,Plymouth Argyle,28,10,8,86,55,31,94,2
634,Derby County,27,9,10,81,38,43,90,3
634,Bolton,25,11,10,72,38,34,86,4
634,Ipswich Town,23,16,7,85,49,36,85,5
634,Wycombe,23,10,13,65,43,22,79,6
634,P'borough Utd,23,6,17,83,61,22,75,7
634,Barnsley,22,9,15,66,44,22,75,8
634,Portsmouth,19,16,11,62,52,10,73,9
634,Shrewsbury,20,10,16,58,51,7,70,10
634,Fleetwood Town,18,15,13,60,51,9,69,11
634,Lincoln City,13,21,12,47,46,1,60,12
634,Oxford United,15,10,21,49,55,-6,55,13
634,Exeter City,13,15,18,55,64,-9,54,14
634,MK Dons,16,6,24,46,64,-18,54,15
634,Charlton Ath,13,13,20,62,69,-7,52,16
634,Bristol Rovers,14,10,22,64,77,-13,52,17
634,Port Vale,14,8,24,47,73,-26,50,18
634,Morecambe,12,13,21,48,68,-20,49,19
634,Cheltenham,11,11,24,37,65,-28,44,20
634,Acc'ton Stanley,9,15,22,35,68,-33,42,21
634,Burton Albion,10,11,25,59,92,-33,41,22
634,Cambridge Utd,10,9,27,37,72,-35,39,23
634,FG Rovers,5,12,29,29,86,-57,27,24
635,Sheffield Weds,29,9,8,81,32,49,96,1
635,Derby County,25,14,7,77,40,37,89,2
635,Ipswich Town,24,15,7,90,47,43,87,3
635,Plymouth Argyle,25,12,9,75,53,22,87,4
635,P'borough Utd,27,3,16,78,47,31,84,5
635,Bolton,25,8,13,66,37,29,83,6
635,Wycombe,23,9,14,64,42,22,78,7
635,Barnsley,22,11,13,72,49,23,77,8
635,Portsmouth,18,17,11,65,54,11,71,9
635,Shrewsbury,19,12,15,58,50,8,69,10
635,Lincoln City,13,23,10,46,47,-1,62,11
635,Exeter City,16,12,18,59,57,2,60,12
635,Charlton Ath,15,14,17,63,60,3,59,13
635,Port Vale,15,12,19,42,57,-15,57,14
635,Fleetwood Town,13,17,16,42,44,-2,56,15
635,Oxford United,13,13,20,51,61,-10,52,16
635,Bristol Rovers,13,13,20,59,76,-17,52,17
635,Cheltenham,14,9,23,36,58,-22,51,18
635,Acc'ton Stanley,12,15,19,42,66,-24,51,19
635,Morecambe,9,15,22,49,76,-27,42,20
635,Burton Albion,10,10,26,53,90,-37,40,21
635,Cambridge Utd,11,7,28,35,74,-39,40,22
635,MK Dons,9,11,26,43,73,-30,38,23
635,FG Rovers,6,11,29,31,87,-56,29,24
636,Sheffield Weds,30,10,6,89,34,55,100,1
636,Plymouth Argyle,29,12,5,87,47,40,99,2
636,Ipswich Town,24,14,8,77,45,32,86,3
636,Derby County,24,12,10,74,41,33,84,4
636,Bolton,25,8,13,64,37,27,83,5
636,Barnsley,23,12,11,64,41,23,81,6
636,Wycombe,23,9,14,65,39,26,78,7
636,Portsmouth,20,15,11,60,45,15,75,8
636,P'borough Utd,20,9,17,71,58,13,69,9
636,Shrewsbury,19,9,18,55,51,4,66,10
636,Fleetwood Town,15,17,14,52,46,6,62,11
636,Lincoln City,12,24,10,44,42,2,60,12
636,Port Vale,16,11,19,53,62,-9,59,13
636,Charlton Ath,13,19,14,69,61,8,58,14
636,Bristol Rovers,15,11,20,59,75,-16,56,15
636,Oxford United,13,12,21,47,57,-10,51,16
636,Exeter City,12,14,20,56,66,-10,50,17
636,Acc'ton Stanley,11,14,21,42,76,-34,47,18
636,MK Dons,13,7,26,50,74,-24,46,19
636,Morecambe,11,13,22,48,75,-27,46,20
636,Cheltenham,11,9,26,31,67,-36,42,21
636,Burton Albion,10,11,25,52,82,-30,41,22
636,Cambridge Utd,11,8,27,41,78,-37,41,23
636,FG Rovers,7,10,29,35,86,-51,31,24
637,Sheffield Weds,34,9,3,86,25,61,111,1
637,Plymouth Argyle,29,11,6,96,46,50,98,2
637,Derby County,25,11,10,78,47,31,86,3
637,Wycombe,25,10,11,70,40,30,85,4
637,Ipswich Town,23,15,8,77,43,34,84,5
637,Barnsley,25,8,13,73,44,29,83,6
637,Bolton,22,14,10,67,36,31,80,7
637,P'borough Utd,21,5,20,70,57,13,68,8
637,Portsmouth,17,16,13,56,51,5,67,9
637,Charlton Ath,18,12,16,68,59,9,66,10
637,Shrewsbury,19,7,20,55,57,-2,64,11
637,Fleetwood Town,16,14,16,51,47,4,62,12
637,Exeter City,15,12,19,60,66,-6,57,13
637,Cheltenham,16,9,21,41,55,-14,57,14
637,Lincoln City,12,19,15,48,55,-7,55,15
637,Bristol Rovers,15,10,21,63,81,-18,55,16
637,Port Vale,13,13,20,50,65,-15,52,17
637,Oxford United,12,15,19,45,52,-7,51,18
637,Acc'ton Stanley,11,15,20,36,63,-27,48,19
637,Burton Albion,12,10,24,55,92,-37,46,20
637,Morecambe,9,13,24,44,80,-36,40,21
637,MK Dons,10,8,28,37,72,-35,38,22
637,Cambridge Utd,9,9,28,36,75,-39,36,23
637,FG Rovers,6,11,29,31,85,-54,29,24
638,Sheffield Weds,30,9,7,87,31,56,99,1
638,Plymouth Argyle,27,12,7,85,52,33,93,2
638,Barnsley,27,8,11,73,42,31,89,3
638,Derby County,24,14,8,80,43,37,86,4
638,Wycombe,26,6,14,66,38,28,84,5
638,Ipswich Town,21,16,9,77,47,30,79,6
638,Bolton,23,10,13,65,37,28,79,7
638,P'borough Utd,24,7,15,79,57,22,79,8
638,Portsmouth,19,18,9,65,48,17,75,9
638,Fleetwood Town,19,14,13,49,39,10,71,10
638,Shrewsbury,18,9,19,50,51,-1,63,11
638,Lincoln City,13,23,10,40,39,1,62,12
638,Port Vale,15,13,18,48,63,-15,58,13
638,Exeter City,15,11,20,59,65,-6,56,14
638,Oxford United,14,12,20,50,53,-3,54,15
638,Bristol Rovers,15,9,22,63,78,-15,54,16
638,Charlton Ath,13,14,19,57,61,-4,53,17
638,Burton Albion,13,12,21,59,84,-25,51,18
638,Acc'ton Stanley,10,15,21,41,72,-31,45,19
638,Cheltenham,11,11,24,30,58,-28,44,20
638,MK Dons,11,8,27,42,72,-30,41,21
638,Cambridge Utd,10,7,29,37,76,-39,37,22
638,Morecambe,8,11,27,38,80,-42,35,23
638,FG Rovers,7,9,30,34,88,-54,30,24
639,Sheffield Weds,33,8,5,81,26,55,107,1
639,Plymouth Argyle,27,11,8,79,45,34,92,2
639,Ipswich Town,25,14,7,83,44,39,89,3
639,Bolton,23,13,10,64,35,29,82,4
639,Derby County,23,12,11,70,43,27,81,5
639,Barnsley,23,12,11,65,40,25,81,6
639,Portsmouth,20,15,11,65,47,18,75,7
639,Wycombe,22,9,15,62,44,18,75,8
639,P'borough Utd,23,5,18,73,55,18,74,9
639,Fleetwood Town,18,13,15,55,45,10,67,10
639,Shrewsbury,19,9,18,53,49,4,66,11
639,Charlton Ath,15,16,15,69,60,9,61,12
639,Lincoln City,13,20,13,47,49,-2,59,13
639,Bristol Rovers,15,11,20,60,82,-22,56,14
639,Port Vale,15,10,21,44,66,-22,55,15
639,Oxford United,11,17,18,47,53,-6,50,16
639,Exeter City,13,11,22,57,67,-10,50,17
639,Cheltenham,13,9,24,35,60,-25,48,18
639,Burton Albion,12,11,23,56,89,-33,47,19
639,Acc'ton Stanley,11,12,23,37,68,-31,45,20
639,Morecambe,10,13,23,46,70,-24,43,21
639,MK Dons,11,10,25,42,66,-24,43,22
639,Cambridge Utd,11,7,28,37,72,-35,40,23
639,FG Rovers,7,10,29,35,87,-52,31,24
640,Sheffield Weds,31,9,6,88,34,54,102,1
640,Plymouth Argyle,30,9,7,97,51,46,99,2
640,Ipswich Town,26,15,5,93,39,54,93,3
640,Barnsley,26,10,10,76,42,34,88,4
640,Derby County,26,10,10,73,42,31,88,5
640,Wycombe,24,9,13,63,42,21,81,6
640,Bolton,21,14,11,60,36,24,77,7
640,Portsmouth,21,13,12,72,52,20,76,8
640,P'borough Utd,21,7,18,68,62,6,70,9
640,Charlton Ath,16,15,15,69,66,3,63,10
640,Fleetwood Town,14,19,13,51,45,6,61,11
640,Shrewsbury,17,9,20,55,50,5,60,12
640,Exeter City,15,11,20,59,66,-7,56,13
640,Port Vale,14,12,20,48,69,-21,54,14
640,Oxford United,13,13,20,52,59,-7,52,15
640,Lincoln City,10,22,14,44,53,-9,52,16
640,Bristol Rovers,13,11,22,60,81,-21,50,17
640,Morecambe,12,12,22,46,71,-25,48,18
640,Burton Albion,12,11,23,56,89,-33,47,19
640,Cheltenham,11,12,23,37,63,-26,45,20
640,Cambridge Utd,11,9,26,36,74,-38,42,21
640,MK Dons,10,10,26,46,76,-30,40,22
640,Acc'ton Stanley,7,14,25,33,73,-40,35,23
640,FG Rovers,7,12,27,35,82,-47,33,24
641,Sheffield Weds,30,10,6,91,33,58,100,1
641,Plymouth Argyle,28,11,7,83,49,34,95,2
641,Barnsley,29,6,11,88,39,49,93,3
641,Ipswich Town,24,15,7,83,45,38,87,4
641,Derby County,24,13,9,72,39,33,85,5
641,Bolton,25,10,11,67,37,30,85,6
641,Wycombe,25,8,13,72,44,28,83,7
641,P'borough Utd,21,6,19,75,61,14,69,8
641,Portsmouth,17,17,12,62,52,10,68,9
641,Shrewsbury,17,10,19,52,54,-2,61,10
641,Port Vale,17,9,20,47,65,-18,60,11
641,Fleetwood Town,14,16,16,49,47,2,58,12
641,Lincoln City,12,21,13,42,45,-3,57,13
641,Charlton Ath,15,11,20,73,69,4,56,14
641,Bristol Rovers,15,11,20,67,83,-16,56,15
641,Exeter City,14,11,21,61,71,-10,53,16
641,Cheltenham,15,8,23,41,64,-23,53,17
641,Oxford United,13,12,21,47,58,-11,51,18
641,Morecambe,11,14,21,51,72,-21,47,19
641,Acc'ton Stanley,11,13,22,38,72,-34,46,20
641,Cambridge Utd,12,9,25,38,67,-29,45,21
641,Burton Albion,11,10,25,54,98,-44,43,22
641,MK Dons,11,9,26,43,73,-30,42,23
641,FG Rovers,7,8,31,35,94,-59,29,24
642,Sheffield Weds,31,11,4,86,29,57,104,1
642,Plymouth Argyle,28,10,8,83,47,36,94,2
642,Barnsley,26,9,11,77,41,36,87,3
642,Ipswich Town,23,15,8,85,46,39,84,4
642,Wycombe,25,9,12,72,41,31,84,5
642,Derby County,23,13,10,71,44,27,82,6
642,Bolton,22,13,11,61,36,25,79,7
642,P'borough Utd,23,6,17,76,59,17,75,8
642,Shrewsbury,21,8,17,57,49,8,71,9
642,Portsmouth,19,13,14,65,59,6,70,10
642,Bristol Rovers,17,8,21,65,82,-17,59,11
642,Charlton Ath,14,15,17,67,65,2,57,12
642,Fleetwood Town,13,17,16,46,46,0,56,13
642,Lincoln City,11,23,12,42,51,-9,56,14
642,Port Vale,14,10,22,49,67,-18,52,15
642,Exeter City,12,14,20,51,65,-14,50,16
642,Cheltenham,12,13,21,35,55,-20,49,17
642,Cambridge Utd,14,7,25,41,71,-30,49,18
642,Oxford United,12,12,22,46,60,-14,48,19
642,Acc'ton Stanley,10,15,21,39,68,-29,45,20
642,MK Dons,11,11,24,44,67,-23,44,21
642,Burton Albion,11,11,24,52,86,-34,44,22
642,Morecambe,9,14,23,48,73,-25,41,23
642,FG Rovers,8,9,29,34,85,-51,33,24
643,Sheffield Weds,33,9,4,92,30,62,108,1
643,Barnsley,28,9,9,73,35,38,93,2
643,Plymouth Argyle,26,11,9,77,52,25,89,3
643,Ipswich Town,23,15,8,78,43,35,84,4
643,P'borough Utd,25,6,15,86,55,31,81,5
643,Bolton,24,8,14,60,36,24,80,6
643,Wycombe,23,10,13,66,39,27,79,7
643,Derby County,22,13,11,70,45,25,79,8
643,Shrewsbury,20,10,16,62,53,9,70,9
643,Portsmouth,17,15,14,59,57,2,66,10
643,Charlton Ath,16,17,13,68,53,15,65,11
643,Fleetwood Town,15,17,14,45,41,4,62,12
643,Exeter City,16,10,20,55,58,-3,58,13
643,Port Vale,15,9,22,43,64,-21,54,14
643,Lincoln City,11,20,15,44,50,-6,53,15
643,Bristol Rovers,14,10,22,62,80,-18,52,16
643,Oxford United,13,11,22,48,58,-10,50,17
643,Cheltenham,13,9,24,36,65,-29,48,18
643,Burton Albion,12,10,24,52,82,-30,46,19
643,Acc'ton Stanley,11,12,23,34,66,-32,45,20
643,Morecambe,9,16,21,46,74,-28,43,21
643,MK Dons,11,10,25,41,69,-28,43,22
643,Cambridge Utd,9,11,26,34,74,-40,38,23
643,FG Rovers,6,12,28,33,85,-52,30,24
644,Sheffield Weds,31,11,4,87,29,58,104,1
644,Barnsley,29,6,11,81,43,38,93,2
644,Plymouth Argyle,27,10,9,83,54,29,91,3
644,Bolton,26,10,10,74,37,37,88,4
644,Ipswich Town,22,17,7,73,43,30,83,5
644,Derby County,23,13,10,77,43,34,82,6
644,Wycombe,21,9,16,60,44,16,72,7
644,Portsmouth,18,14,14,66,55,11,68,8
644,P'borough Utd,19,8,19,72,59,13,65,9
644,Charlton Ath,17,14,15,71,62,9,65,10
644,Shrewsbury,18,10,18,58,55,3,64,11
644,Fleetwood Town,15,18,13,48,42,6,63,12
644,Exeter City,17,11,18,65,63,2,62,13
644,Lincoln City,12,22,12,44,48,-4,58,14
644,Oxford United,14,12,20,49,58,-9,54,15
644,Port Vale,15,9,22,47,65,-18,54,16
644,Burton Albion,13,13,20,59,80,-21,52,17
644,Bristol Rovers,12,12,22,54,80,-26,48,18
644,Cambridge Utd,13,9,24,40,72,-32,48,19
644,Cheltenham,11,11,24,32,62,-30,44,20
644,Acc'ton Stanley,11,11,24,38,74,-36,44,21
644,Morecambe,9,13,24,46,78,-32,40,22
644,MK Dons,9,10,27,40,74,-34,37,23
644,FG Rovers,8,11,27,38,82,-44,35,24
645,Sheffield Weds,28,15,3,79,29,50,99,1
645,Plymouth Argyle,29,9,8,82,48,34,96,2
645,Barnsley,27,6,13,73,40,33,87,3
645,Ipswich Town,23,17,6,83,43,40,86,4
645,Derby County,25,10,11,82,43,39,85,5
645,Bolton,23,13,10,61,34,27,82,6
645,Wycombe,23,8,15,65,46,19,77,7
645,P'borough Utd,21,10,15,80,57,23,73,8
645,Portsmouth,18,14,14,59,61,-2,68,9
645,Shrewsbury,18,10,18,59,55,4,64,10
645,Lincoln City,13,21,12,45,47,-2,60,11
645,Fleetwood Town,14,17,15,55,49,6,59,12
645,Charlton Ath,14,17,15,58,58,0,59,13
645,Exeter City,16,11,19,55,61,-6,59,14
645,Port Vale,16,11,19,50,59,-9,59,15
645,Bristol Rovers,14,11,21,63,80,-17,53,16
645,Acc'ton Stanley,13,12,21,39,67,-28,51,17
645,Cheltenham,13,11,22,38,61,-23,50,18
645,Burton Albion,12,11,23,56,83,-27,47,19
645,MK Dons,13,7,26,49,74,-25,46,20
645,Morecambe,10,13,23,49,74,-25,43,21
645,Oxford United,10,12,24,41,62,-21,42,22
645,FG Rovers,9,9,28,38,84,-46,36,23
645,Cambridge Utd,9,7,30,30,74,-44,34,24
646,Sheffield Weds,33,9,4,97,26,71,108,1
646,Plymouth Argyle,29,10,7,91,50,41,97,2
646,Ipswich Town,25,14,7,85,48,37,89,3
646,Barnsley,24,11,11,69,41,28,83,4
646,Bolton,22,13,11,68,37,31,79,5
646,Derby County,23,10,13,84,56,28,79,6
646,Wycombe,22,8,16,56,41,15,74,7
646,Shrewsbury,21,9,16,61,51,10,72,8
646,Charlton Ath,18,12,16,66,57,9,66,9
646,Portsmouth,17,14,15,61,55,6,65,10
646,P'borough Utd,20,5,21,68,65,3,65,11
646,Port Vale,17,11,18,46,59,-13,62,12
646,Exeter City,16,12,18,61,61,0,60,13
646,Fleetwood Town,15,14,17,51,50,1,59,14
646,Lincoln City,12,22,12,47,52,-5,58,15
646,Bristol Rovers,13,13,20,61,75,-14,52,16
646,Oxford United,12,15,19,53,59,-6,51,17
646,Burton Albion,14,9,23,58,93,-35,51,18
646,MK Dons,13,9,24,47,70,-23,48,19
646,Acc'ton Stanley,11,12,23,43,76,-33,45,20
646,Cheltenham,11,10,25,32,60,-28,43,21
646,Morecambe,8,16,22,49,79,-30,40,22
646,Cambridge Utd,9,10,27,36,75,-39,37,23
646,FG Rovers,7,12,27,35,89,-54,33,24
647,Barnsley,27,11,8,74,38,36,92,1
647,Plymouth Argyle,26,12,8,90,55,35,90,2
647,Sheffield Weds,24,16,6,73,33,40,88,3
647,Derby County,24,15,7,72,34,38,87,4
647,Ipswich Town,22,17,7,76,45,31,83,5
647,Wycombe,23,9,14,67,39,28,78,6
647,Bolton,21,14,11,62,34,28,77,7
647,P'borough Utd,23,6,17,79,60,19,75,8
647,Shrewsbury,21,8,17,56,51,5,71,9
647,Charlton Ath,18,15,13,79,57,22,69,10
647,Portsmouth,16,17,13,60,52,8,65,11
647,Lincoln City,15,19,12,48,53,-5,64,12
647,Fleetwood Town,15,18,13,51,48,3,63,13
647,Exeter City,14,14,18,61,65,-4,56,14
647,Port Vale,15,9,22,49,67,-18,54,15
647,Bristol Rovers,14,11,21,68,81,-13,53,16
647,Burton Albion,13,11,22,57,88,-31,50,17
647,Oxford United,12,12,22,45,57,-12,48,18
647,MK Dons,13,8,25,42,68,-26,47,19
647,Cheltenham,12,9,25,32,62,-30,45,20
647,Acc'ton Stanley,8,17,21,38,71,-33,41,21
647,Morecambe,8,15,23,40,71,-31,39,22
647,Cambridge Utd,8,11,27,32,73,-41,35,23
647,FG Rovers,7,12,27,32,81,-49,33,24
648,Sheffield Weds,27,14,5,83,36,47,95,1
648,Plymouth Argyle,28,10,8,93,54,39,94,2
648,Barnsley,26,9,11,75,44,31,87,3
648,Derby County,24,13,9,73,42,31,85,4
648,Ipswich Town,23,15,8,77,43,34,84,5
648,Wycombe,24,9,13,71,49,22,81,6
648,Bolton,22,12,12,62,32,30,78,7
648,P'borough Utd,21,8,17,71,53,18,71,8
648,Portsmouth,18,15,13,71,56,15,69,9
648,Lincoln City,14,23,9,47,43,4,65,10
648,Shrewsbury,18,10,18,53,50,3,64,11
648,Port Vale,18,9,19,55,63,-8,63,12
648,Charlton Ath,16,13,17,65,61,4,61,13
648,Fleetwood Town,14,18,14,52,45,7,60,14
648,Exeter City,14,14,18,55,58,-3,56,15
648,Bristol Rovers,13,12,21,61,84,-23,51,16
648,Burton Albion,13,11,22,57,83,-26,50,17
648,Morecambe,12,11,23,48,78,-30,47,18
648,Oxford United,11,12,23,46,60,-14,45,19
648,Acc'ton Stanley,11,12,23,38,71,-33,45,20
648,Cheltenham,11,11,24,31,60,-29,44,21
648,Cambridge Utd,12,8,26,37,71,-34,44,22
648,MK Dons,11,9,26,45,76,-31,42,23
648,FG Rovers,7,10,29,38,92,-54,31,24
649,Sheffield Weds,29,11,6,82,33,49,98,1
649,Plymouth Argyle,29,9,8,92,58,34,96,2
649,Derby County,26,12,8,85,42,43,90,3
649,Bolton,26,9,11,70,35,35,87,4
649,Barnsley,26,8,12,73,42,31,86,5
649,Ipswich Town,23,16,7,87,46,41,85,6
649,Wycombe,24,8,14,67,46,21,80,7
649,Portsmouth,18,16,12,67,54,13,70,8
649,Charlton Ath,19,12,15,72,56,16,69,9
649,P'borough Utd,21,6,19,74,64,10,69,10
649,Fleetwood Town,17,15,14,53,44,9,66,11
649,Lincoln City,15,19,12,45,46,-1,64,12
649,Shrewsbury,18,9,19,60,55,5,63,13
649,Exeter City,14,13,19,59,61,-2,55,14
649,Port Vale,14,11,21,44,65,-21,53,15
649,Bristol Rovers,13,12,21,59,81,-22,51,16
649,Cheltenham,14,8,24,37,59,-22,50,17
649,Acc'ton Stanley,12,14,20,43,71,-28,50,18
649,Oxford United,11,14,21,43,55,-12,47,19
649,Burton Albion,12,9,25,55,90,-35,45,20
649,Cambridge Utd,10,10,26,35,74,-39,40,21
649,Morecambe,9,12,25,44,82,-38,39,22
649,MK Dons,10,8,28,40,74,-34,38,23
649,FG Rovers,5,13,28,34,87,-53,28,24
650,Sheffield Weds,29,11,6,84,36,48,98,1
650,Ipswich Town,26,14,6,85,41,44,92,2
650,Derby County,25,14,7,76,40,36,89,3
650,Plymouth Argyle,26,11,9,76,51,25,89,4
650,Bolton,26,8,12,70,39,31,86,5
650,Barnsley,23,13,10,71,43,28,82,6
650,Charlton Ath,19,15,12,69,53,16,72,7
650,Wycombe,20,10,16,59,43,16,70,8
650,Shrewsbury,20,9,17,53,46,7,69,9
650,Fleetwood Town,17,15,14,59,49,10,66,10
650,Portsmouth,17,15,14,57,53,4,66,11
650,P'borough Utd,20,5,21,75,63,12,65,12
650,Lincoln City,12,22,12,45,49,-4,58,13
650,Port Vale,16,8,22,50,68,-18,56,14
650,Exeter City,14,12,20,56,61,-5,54,15
650,Bristol Rovers,14,12,20,60,81,-21,54,16
650,Oxford United,13,13,20,51,60,-9,52,17
650,Acc'ton Stanley,14,10,22,50,68,-18,52,18
650,Morecambe,12,13,21,46,69,-23,49,19
650,Burton Albion,12,12,22,61,86,-25,48,20
650,Cheltenham,11,11,24,33,63,-30,44,21
650,MK Dons,10,11,25,46,71,-25,41,22
650,Cambridge Utd,10,6,30,35,77,-42,36,23
650,FG Rovers,5,12,29,36,93,-57,27,24
651,Sheffield Weds,26,16,4,74,29,45,94,1
651,Ipswich Town,26,15,5,88,38,50,93,2
651,Barnsley,28,7,11,75,40,35,91,3
651,Plymouth Argyle,26,13,7,74,45,29,91,4
651,Bolton,27,9,10,68,32,36,90,5
651,Derby County,25,11,10,73,39,34,86,6
651,P'borough Utd,23,6,17,72,55,17,75,7
651,Wycombe,21,11,14,62,46,16,74,8
651,Charlton Ath,17,14,15,66,56,10,65,9
651,Portsmouth,16,16,14,60,55,5,64,10
651,Fleetwood Town,16,13,17,54,50,4,61,11
651,Lincoln City,13,21,12,42,44,-2,60,12
651,Shrewsbury,17,9,20,48,52,-4,60,13
651,Port Vale,15,10,21,45,64,-19,55,14
651,Cheltenham,15,9,22,39,57,-18,54,15
651,Burton Albion,14,12,20,57,79,-22,54,16
651,Acc'ton Stanley,12,15,19,46,73,-27,51,17
651,Exeter City,13,11,22,55,63,-8,50,18
651,Bristol Rovers,13,11,22,62,78,-16,50,19
651,Oxford United,12,13,21,48,59,-11,49,20
651,Morecambe,11,13,22,47,72,-25,46,21
651,Cambridge Utd,11,9,26,38,72,-34,42,22
651,MK Dons,8,11,27,38,71,-33,35,23
651,FG Rovers,5,9,32,32,94,-62,24,24
652,Sheffield Weds,32,11,3,86,26,60,107,1
652,Plymouth Argyle,29,10,7,85,47,38,97,2
652,Bolton,27,9,10,68,30,38,90,3
652,Barnsley,27,7,12,73,39,34,88,4
652,Ipswich Town,24,15,7,89,46,43,87,5
652,Derby County,24,11,11,73,42,31,83,6
652,Wycombe,24,8,14,67,47,20,80,7
652,P'borough Utd,24,5,17,75,57,18,77,8
652,Portsmouth,21,13,12,67,57,10,76,9
652,Shrewsbury,20,8,18,56,52,4,68,10
652,Lincoln City,13,22,11,43,42,1,61,11
652,Bristol Rovers,17,8,21,61,75,-14,59,12
652,Charlton Ath,14,13,19,64,65,-1,55,13
652,Fleetwood Town,12,19,15,45,46,-1,55,14
652,Exeter City,14,11,21,54,59,-5,53,15
652,Port Vale,15,8,23,44,62,-18,53,16
652,Oxford United,14,9,23,51,62,-11,51,17
652,Acc'ton Stanley,12,13,21,43,69,-26,49,18
652,MK Dons,13,9,24,48,69,-21,48,19
652,Burton Albion,12,9,25,50,94,-44,45,20
652,Cheltenham,11,10,25,34,65,-31,43,21
652,Morecambe,9,12,25,44,77,-33,39,22
652,Cambridge Utd,9,7,30,32,77,-45,34,23
652,FG Rovers,6,11,29,36,83,-47,29,24
653,Sheffield Weds,29,12,5,81,30,51,99,1
653,Plymouth Argyle,28,12,6,87,47,40,96,2
653,Barnsley,27,7,12,75,38,37,88,3
653,Ipswich Town,23,17,6,82,43,39,86,4
653,Shrewsbury,24,9,13,66,48,18,81,5
653,Derby County,22,13,11,70,43,27,79,6
653,Bolton,22,12,12,67,37,30,78,7
653,Wycombe,20,13,13,64,45,19,73,8
653,P'borough Utd,20,9,17,69,61,8,69,9
653,Portsmouth,18,15,13,65,59,6,69,10
653,Charlton Ath,16,16,14,66,59,7,64,11
653,Fleetwood Town,14,18,14,47,43,4,60,12
653,Lincoln City,12,21,13,40,44,-4,57,13
653,Bristol Rovers,14,13,19,66,82,-16,55,14
653,Exeter City,13,13,20,57,70,-13,52,15
653,Cheltenham,13,11,22,33,54,-21,50,16
653,Port Vale,13,10,23,43,65,-22,49,17
653,Cambridge Utd,13,9,24,39,66,-27,48,18
653,Burton Albion,12,11,23,54,85,-31,47,19
653,Morecambe,10,16,20,43,67,-24,46,20
653,Oxford United,11,12,23,44,60,-16,45,21
653,MK Dons,11,10,25,38,63,-25,43,22
653,Acc'ton Stanley,8,15,23,36,69,-33,39,23
653,FG Rovers,6,12,28,36,90,-54,30,24
654,Sheffield Weds,28,14,4,84,35,49,98,1
654,Plymouth Argyle,27,12,7,83,51,32,93,2
654,Ipswich Town,26,12,8,89,45,44,90,3
654,Derby County,24,12,10,76,42,34,84,4
654,Bolton,24,11,11,70,40,30,83,5
654,Barnsley,24,9,13,74,44,30,81,6
654,P'borough Utd,24,4,18,75,59,16,76,7
654,Wycombe,22,7,17,60,48,12,73,8
654,Portsmouth,18,17,11,65,52,13,71,9
654,Shrewsbury,21,7,18,53,51,2,70,10
654,Fleetwood Town,17,14,15,55,50,5,65,11
654,Lincoln City,12,23,11,41,41,0,59,12
654,Charlton Ath,14,12,20,63,68,-5,54,13
654,Oxford United,14,12,20,53,59,-6,54,14
654,Exeter City,14,12,20,53,59,-6,54,15
654,Bristol Rovers,14,10,22,64,82,-18,52,16
654,Port Vale,14,10,22,47,69,-22,52,17
654,Burton Albion,14,10,22,58,84,-26,52,18
654,Acc'ton Stanley,12,14,20,40,63,-23,50,19
654,Cheltenham,14,8,24,35,59,-24,50,20
654,Cambridge Utd,13,8,25,43,70,-27,47,21
654,Morecambe,9,15,22,44,69,-25,42,22
654,MK Dons,10,10,26,43,75,-32,40,23
654,FG Rovers,7,9,30,35,88,-53,30,24
655,Sheffield Weds,32,9,5,93,29,64,105,1
655,Barnsley,28,9,9,71,37,34,93,2
655,Plymouth Argyle,26,12,8,84,54,30,90,3
655,Ipswich Town,25,14,7,77,38,39,89,4
655,Wycombe,24,8,14,63,43,20,80,5
655,Derby County,22,13,11,74,47,27,79,6
655,Bolton,22,12,12,63,42,21,78,7
655,P'borough Utd,23,6,17,71,52,19,75,8
655,Portsmouth,20,13,13,66,59,7,73,9
655,Shrewsbury,20,10,16,61,54,7,70,10
655,Charlton Ath,17,15,14,65,57,8,66,11
655,Lincoln City,14,21,11,49,47,2,63,12
655,Fleetwood Town,14,14,18,44,47,-3,56,13
655,Bristol Rovers,15,10,21,67,72,-5,55,14
655,Port Vale,15,9,22,44,62,-18,54,15
655,Oxford United,14,11,21,52,62,-10,53,16
655,Exeter City,12,15,19,57,66,-9,51,17
655,Burton Albion,12,12,22,57,84,-27,48,18
655,Acc'ton Stanley,11,13,22,42,71,-29,46,19
655,Cheltenham,11,10,25,34,61,-27,43,20
655,Cambridge Utd,12,7,27,39,74,-35,43,21
655,Morecambe,8,14,24,41,73,-32,38,22
655,MK Dons,10,7,29,38,73,-35,37,23
655,FG Rovers,7,12,27,35,83,-48,33,24
656,Sheffield Weds,28,13,5,79,30,49,97,1
656,Plymouth Argyle,26,11,9,82,57,25,89,2
656,Derby County,25,12,9,83,40,43,87,3
656,Barnsley,26,7,13,71,48,23,85,4
656,Bolton,23,12,11,65,36,29,81,5
656,Ipswich Town,22,14,10,83,50,33,80,6
656,Wycombe,21,11,14,66,44,22,74,7
656,Shrewsbury,21,11,14,57,49,8,74,8
656,P'borough Utd,22,7,17,76,53,23,73,9
656,Charlton Ath,18,14,14,70,59,11,68,10
656,Portsmouth,16,17,13,63,49,14,65,11
656,Fleetwood Town,16,17,13,56,45,11,65,12
656,Exeter City,16,16,14,62,57,5,64,13
656,Lincoln City,13,21,12,41,43,-2,60,14
656,Bristol Rovers,15,11,20,64,74,-10,56,15
656,Port Vale,15,10,21,43,63,-20,55,16
656,Oxford United,14,11,21,46,53,-7,53,17
656,MK Dons,14,7,25,47,69,-22,49,18
656,Cheltenham,11,11,24,30,59,-29,44,19
656,Burton Albion,12,8,26,53,95,-42,44,20
656,Cambridge Utd,12,6,28,39,77,-38,42,21
656,Acc'ton Stanley,9,14,23,37,70,-33,41,22
656,Morecambe,7,14,25,39,81,-42,35,23
656,FG Rovers,7,11,28,33,84,-51,32,24
657,Plymouth Argyle,30,10,6,89,53,36,100,1
657,Sheffield Weds,28,14,4,82,29,53,98,2
657,Ipswich Town,23,15,8,82,44,38,84,3
657,Barnsley,24,11,11,77,48,29,83,4
657,Derby County,22,14,10,74,44,30,80,5
657,Wycombe,22,12,12,71,44,27,78,6
657,Bolton,22,10,14,66,46,20,76,7
657,P'borough Utd,23,7,16,71,55,16,76,8
657,Portsmouth,17,16,13,66,60,6,67,9
657,Shrewsbury,19,9,18,51,48,3,66,10
657,Fleetwood Town,15,18,13,49,42,7,63,11
657,Charlton Ath,15,17,14,62,57,5,62,12
657,Lincoln City,12,22,12,43,46,-3,58,13
657,Port Vale,15,10,21,51,72,-21,55,14
657,Exeter City,14,11,21,58,59,-1,53,15
657,Oxford United,13,12,21,47,54,-7,51,16
657,Acc'ton Stanley,13,12,21,41,66,-25,51,17
657,Bristol Rovers,12,14,20,65,81,-16,50,18
657,Morecambe,12,13,21,50,67,-17,49,19
657,Cambridge Utd,13,9,24,47,74,-27,48,20
657,Burton Albion,12,10,24,59,86,-27,46,21
657,Cheltenham,13,6,27,33,70,-37,45,22
657,MK Dons,12,7,27,44,73,-29,43,23
657,FG Rovers,7,9,30,35,95,-60,30,24
658,Sheffield Weds,32,8,6,89,33,56,104,1
658,Plymouth Argyle,29,10,7,94,46,48,97,2
658,Ipswich Town,26,14,6,88,45,43,92,3
658,Derby County,23,13,10,73,43,30,82,4
658,Bolton,23,11,12,60,33,27,80,5
658,Barnsley,23,10,13,69,48,21,79,6
658,Wycombe,21,11,14,64,43,21,74,7
658,P'borough Utd,22,7,17,73,60,13,73,8
658,Portsmouth,19,14,13,61,51,10,71,9
658,Shrewsbury,20,8,18,56,47,9,68,10
658,Fleetwood Town,16,16,14,50,44,6,64,11
658,Charlton Ath,15,15,16,61,60,1,60,12
658,Lincoln City,12,23,11,44,46,-2,59,13
658,Exeter City,15,14,17,59,68,-9,59,14
658,Port Vale,15,10,21,44,63,-19,55,15
658,Bristol Rovers,14,11,21,64,80,-16,53,16
658,Oxford United,13,11,22,44,53,-9,50,17
658,Burton Albion,13,11,22,58,85,-27,50,18
658,MK Dons,12,9,25,46,67,-21,45,19
658,Morecambe,11,12,23,44,70,-26,45,20
658,Cheltenham,11,10,25,29,61,-32,43,21
658,Cambridge Utd,9,12,25,37,69,-32,39,22
658,Acc'ton Stanley,8,15,23,33,73,-40,39,23
658,FG Rovers,7,11,28,34,86,-52,32,24
659,Sheffield Weds,31,10,5,96,34,62,103,1
659,Plymouth Argyle,29,9,8,88,55,33,96,2
659,Barnsley,27,8,11,70,36,34,89,3
659,Wycombe,27,7,12,75,45,30,88,4
659,Ipswich Town,23,15,8,79,45,34,84,5
659,Derby County,24,11,11,70,45,25,83,6
659,Bolton,23,10,13,63,37,26,79,7
659,P'borough Utd,21,8,17,70,59,11,71,8
659,Shrewsbury,20,9,17,53,46,7,69,9
659,Charlton Ath,18,14,14,71,61,10,68,10
659,Exeter City,18,11,17,64,59,5,65,11
659,Portsmouth,17,14,15,57,54,3,65,12
659,Fleetwood Town,14,16,16,50,47,3,58,13
659,Lincoln City,12,22,12,45,51,-6,58,14
659,Port Vale,16,9,21,49,65,-16,57,15
659,Bristol Rovers,15,9,22,67,79,-12,54,16
659,Cheltenham,14,8,24,40,62,-22,50,17
659,Burton Albion,13,10,23,58,84,-26,49,18
659,Morecambe,12,13,21,44,71,-27,49,19
659,Oxford United,12,10,24,44,60,-16,46,20
659,Acc'ton Stanley,10,13,23,38,72,-34,43,21
659,Cambridge Utd,11,7,28,35,69,-34,40,22
659,MK Dons,8,11,27,41,75,-34,35,23
659,FG Rovers,5,10,31,33,89,-56,25,24
660,Sheffield Weds,29,12,5,76,27,49,99,1
660,Plymouth Argyle,28,10,8,81,47,34,94,2
660,Derby County,27,11,8,84,41,43,92,3
660,Ipswich Town,25,14,7,84,44,40,89,4
660,Bolton,24,11,11,65,34,31,83,5
660,Wycombe,25,5,16,63,45,18,80,6
660,Barnsley,23,9,14,68,50,18,78,7
660,P'borough Utd,23,6,17,76,53,23,75,8
660,Portsmouth,19,16,11,66,53,13,73,9
660,Fleetwood Town,18,14,14,59,50,9,68,10
660,Shrewsbury,19,9,18,56,47,9,66,11
660,Lincoln City,15,20,11,46,42,4,65,12
660,Exeter City,17,9,20,58,54,4,60,13
660,Charlton Ath,14,15,17,60,62,-2,57,14
660,Oxford United,13,10,23,48,57,-9,49,15
660,Bristol Rovers,13,10,23,61,87,-26,49,16
660,Port Vale,13,10,23,39,66,-27,49,17
660,Burton Albion,13,9,24,57,93,-36,48,18
660,Acc'ton Stanley,11,14,21,35,60,-25,47,19
660,Cheltenham,13,8,25,37,67,-30,47,20
660,Cambridge Utd,12,7,27,44,75,-31,43,21
660,MK Dons,11,9,26,41,71,-30,42,22
660,Morecambe,8,15,23,41,72,-31,39,23
660,FG Rovers,7,11,28,37,85,-48,32,24
661,Sheffield Weds,30,11,5,80,33,47,101,1
661,Plymouth Argyle,29,11,6,84,48,36,98,2
661,Ipswich Town,27,13,6,90,38,52,94,3
661,Barnsley,26,11,9,78,40,38,89,4
661,Derby County,24,11,11,73,39,34,83,5
661,Bolton,23,10,13,64,37,27,79,6
661,P'borough Utd,24,6,16,78,59,19,78,7
661,Wycombe,22,10,14,63,46,17,76,8
661,Shrewsbury,20,10,16,58,47,11,70,9
661,Portsmouth,16,15,15,67,61,6,63,10
661,Lincoln City,13,22,11,48,45,3,61,11
661,Fleetwood Town,15,15,16,46,42,4,60,12
661,Oxford United,14,13,19,57,59,-2,55,13
661,Port Vale,15,10,21,44,65,-21,55,14
661,Bristol Rovers,15,10,21,59,81,-22,55,15
661,Charlton Ath,12,18,16,59,62,-3,54,16
661,Acc'ton Stanley,13,11,22,36,61,-25,50,17
661,Burton Albion,13,11,22,58,88,-30,50,18
661,Exeter City,13,10,23,54,65,-11,49,19
661,Cheltenham,13,8,25,36,68,-32,47,20
661,MK Dons,12,9,25,40,64,-24,45,21
661,Cambridge Utd,10,8,28,33,71,-38,38,22
661,Morecambe,8,13,25,44,80,-36,37,23
661,FG Rovers,6,12,28,30,80,-50,30,24
662,Sheffield Weds,30,11,5,82,29,53,101,1
662,Plymouth Argyle,27,10,9,86,52,34,91,2
662,Bolton,25,10,11,66,36,30,85,3
662,Ipswich Town,22,16,8,80,45,35,82,4
662,Wycombe,23,10,13,66,43,23,79,5
662,Derby County,22,12,12,71,46,25,78,6
662,P'borough Utd,24,6,16,81,61,20,78,7
662,Barnsley,23,9,14,64,46,18,78,8
662,Portsmouth,21,14,11,68,45,23,77,9
662,Shrewsbury,21,7,18,56,50,6,70,10
662,Charlton Ath,18,13,15,68,56,12,67,11
662,Bristol Rovers,18,9,19,68,79,-11,63,12
662,Fleetwood Town,15,16,15,45,40,5,61,13
662,Lincoln City,11,26,9,40,39,1,59,14
662,Exeter City,14,12,20,59,70,-11,54,15
662,Port Vale,14,9,23,49,68,-19,51,16
662,Burton Albion,13,12,21,57,80,-23,51,17
662,MK Dons,13,9,24,45,67,-22,48,18
662,Cambridge Utd,14,6,26,43,77,-34,48,19
662,Oxford United,12,10,24,41,55,-14,46,20
662,Cheltenham,11,13,22,32,60,-28,46,21
662,Acc'ton Stanley,10,11,25,37,71,-34,41,22
662,Morecambe,10,11,25,39,75,-36,41,23
662,FG Rovers,5,10,31,32,85,-53,25,24
663,Sheffield Weds,31,9,6,84,34,50,102,1
663,Plymouth Argyle,26,12,8,80,51,29,90,2
663,Ipswich Town,24,17,5,89,44,45,89,3
663,Barnsley,27,8,11,68,36,32,89,4
663,Portsmouth,23,14,9,71,47,24,83,5
663,Derby County,23,13,10,73,37,36,82,6
663,Bolton,24,10,12,76,44,32,82,7
663,Wycombe,21,11,14,62,46,16,74,8
663,P'borough Utd,19,10,17,74,62,12,67,9
663,Shrewsbury,18,10,18,58,59,-1,64,10
663,Charlton Ath,16,15,15,70,65,5,63,11
663,Lincoln City,12,23,11,45,47,-2,59,12
663,Fleetwood Town,14,16,16,50,47,3,58,13
663,Exeter City,13,15,18,64,69,-5,54,14
663,Port Vale,15,8,23,49,68,-19,53,15
663,Oxford United,13,11,22,46,56,-10,50,16
663,Bristol Rovers,12,13,21,61,77,-16,49,17
663,Acc'ton Stanley,11,15,20,39,65,-26,48,18
663,Cheltenham,12,11,23,35,61,-26,47,19
663,Morecambe,10,15,21,43,71,-28,45,20
663,Burton Albion,11,12,23,52,87,-35,45,21
663,Cambridge Utd,12,6,28,37,76,-39,42,22
663,MK Dons,10,11,25,43,72,-29,41,23
663,FG Rovers,7,11,28,33,81,-48,32,24
664,Sheffield Weds,31,11,4,91,29,62,104,1
664,Ipswich Town,27,15,4,89,41,48,96,2
664,Plymouth Argyle,28,9,9,86,57,29,93,3
664,Bolton,26,9,11,72,38,34,87,4
664,Barnsley,24,9,13,68,46,22,81,5
664,Derby County,22,12,12,69,45,24,78,6
664,Wycombe,22,10,14,67,46,21,76,7
664,Portsmouth,20,15,11,66,51,15,75,8
664,P'borough Utd,21,7,18,74,54,20,70,9
664,Charlton Ath,18,13,15,63,56,7,67,10
664,Shrewsbury,17,10,19,49,49,0,61,11
664,Lincoln City,12,23,11,45,49,-4,59,12
664,Port Vale,16,10,20,48,64,-16,58,13
664,Bristol Rovers,15,11,20,64,81,-17,56,14
664,Fleetwood Town,13,16,17,48,50,-2,55,15
664,Acc'ton Stanley,14,13,19,42,58,-16,55,16
664,Oxford United,13,13,20,46,59,-13,52,17
664,Exeter City,13,12,21,56,67,-11,51,18
664,Burton Albion,12,10,24,51,86,-35,46,19
664,Morecambe,10,13,23,46,73,-27,43,20
664,Cheltenham,10,13,23,30,57,-27,43,21
664,MK Dons,10,9,27,40,69,-29,39,22
664,Cambridge Utd,10,9,27,37,72,-35,39,23
664,FG Rovers,7,10,29,36,86,-50,31,24
665,Sheffield Weds,30,12,4,85,31,54,102,1
665,Plymouth Argyle,29,10,7,93,47,46,97,2
665,Ipswich Town,24,16,6,77,40,37,88,3
665,Barnsley,25,9,12,67,39,28,84,4
665,Wycombe,24,9,13,67,41,26,81,5
665,Bolton,23,11,12,67,39,28,80,6
665,Derby County,23,11,12,71,44,27,80,7
665,P'borough Utd,23,5,18,80,60,20,74,8
665,Shrewsbury,21,9,16,58,47,11,72,9
665,Fleetwood Town,17,16,13,54,42,12,67,10
665,Portsmouth,16,16,14,57,51,6,64,11
665,Lincoln City,13,19,14,48,48,0,58,12
665,Charlton Ath,14,15,17,58,63,-5,57,13
665,Bristol Rovers,15,12,19,65,78,-13,57,14
665,Port Vale,16,9,21,49,62,-13,57,15
665,Exeter City,15,11,20,55,63,-8,56,16
665,Burton Albion,14,12,20,55,80,-25,54,17
665,Acc'ton Stanley,12,12,22,39,73,-34,48,18
665,Oxford United,11,11,24,45,65,-20,44,19
665,Cheltenham,11,10,25,38,64,-26,43,20
665,MK Dons,11,9,26,41,70,-29,42,21
665,Morecambe,10,12,24,45,76,-31,42,22
665,Cambridge Utd,11,6,29,34,75,-41,39,23
665,FG Rovers,8,10,28,38,88,-50,34,24
666,Sheffield Weds,29,11,6,80,30,50,98,1
666,Plymouth Argyle,28,9,9,83,53,30,93,2
666,Barnsley,26,9,11,76,43,33,87,3
666,Ipswich Town,23,17,6,82,41,41,86,4
666,Derby County,24,12,10,77,44,33,84,5
666,Bolton,24,11,11,66,35,31,83,6
666,Wycombe,23,8,15,69,42,27,77,7
666,Portsmouth,19,17,10,66,53,13,74,8
666,P'borough Utd,21,7,18,78,58,20,70,9
666,Shrewsbury,20,10,16,57,50,7,70,10
666,Charlton Ath,16,15,15,63,54,9,63,11
666,Lincoln City,12,24,10,44,41,3,60,12
666,Port Vale,16,11,19,56,67,-11,59,13
666,Exeter City,15,13,18,60,63,-3,58,14
666,Fleetwood Town,13,17,16,43,47,-4,56,15
666,Cheltenham,15,7,24,38,61,-23,52,16
666,Oxford United,13,12,21,51,68,-17,51,17
666,Bristol Rovers,12,12,22,59,83,-24,48,18
666,Cambridge Utd,10,12,24,34,65,-31,42,19
666,Burton Albion,11,9,26,53,97,-44,42,20
666,Morecambe,10,11,25,46,78,-32,41,21
666,Acc'ton Stanley,8,16,22,39,69,-30,40,22
666,FG Rovers,8,14,24,37,81,-44,38,23
666,MK Dons,9,10,27,39,73,-34,37,24
667,Sheffield Weds,31,10,5,85,29,56,103,1
667,Plymouth Argyle,30,10,6,87,46,41,100,2
667,Barnsley,27,8,11,81,43,38,89,3
667,Derby County,25,10,11,75,43,32,85,4
667,Bolton,24,10,12,67,36,31,82,5
667,Wycombe,25,7,14,75,45,30,82,6
667,Ipswich Town,23,12,11,84,44,40,81,7
667,Portsmouth,20,15,11,59,46,13,75,8
667,Shrewsbury,22,7,17,61,49,12,73,9
667,P'borough Utd,22,6,18,77,65,12,72,10
667,Fleetwood Town,17,14,15,50,43,7,65,11
667,Lincoln City,14,21,11,47,44,3,63,12
667,Charlton Ath,15,15,16,67,65,2,60,13
667,Exeter City,15,9,22,57,68,-11,54,14
667,Port Vale,14,12,20,48,64,-16,54,15
667,Acc'ton Stanley,13,14,19,38,56,-18,53,16
667,Bristol Rovers,12,12,22,62,89,-27,48,17
667,Burton Albion,11,13,22,55,89,-34,46,18
667,Oxford United,11,12,23,48,66,-18,45,19
667,MK Dons,12,8,26,45,71,-26,44,20
667,Morecambe,10,13,23,44,75,-31,43,21
667,Cambridge Utd,11,8,27,37,78,-41,41,22
667,Cheltenham,10,8,28,32,73,-41,38,23
667,FG Rovers,6,10,30,35,89,-54,28,24
668,Sheffield Weds,30,11,5,86,34,52,101,1
668,Plymouth Argyle,30,9,7,85,47,38,99,2
668,Barnsley,28,7,11,80,43,37,91,3
668,Ipswich Town,25,14,7,85,44,41,89,4
668,Wycombe,26,8,12,68,38,30,86,5
668,Derby County,23,12,11,69,39,30,81,6
668,P'borough Utd,23,6,17,77,55,22,75,7
668,Bolton,20,13,13,56,36,20,73,8
668,Charlton Ath,19,11,16,72,58,14,68,9
668,Fleetwood Town,16,18,12,51,40,11,66,10
668,Shrewsbury,19,9,18,53,51,2,66,11
668,Lincoln City,14,22,10,46,43,3,64,12
668,Portsmouth,16,15,15,64,59,5,63,13
668,Exeter City,14,13,19,57,63,-6,55,14
668,Bristol Rovers,14,12,20,61,82,-21,54,15
668,Port Vale,13,13,20,45,62,-17,52,16
668,Burton Albion,13,10,23,55,83,-28,49,17
668,Oxford United,11,11,24,45,58,-13,44,18
668,MK Dons,11,10,25,44,70,-26,43,19
668,Acc'ton Stanley,10,13,23,39,72,-33,43,20
668,Cheltenham,11,10,25,35,68,-33,43,21
668,Cambridge Utd,11,9,26,34,77,-43,42,22
668,Morecambe,8,14,24,42,76,-34,38,23
668,FG Rovers,7,10,29,37,88,-51,31,24
669,Plymouth Argyle,32,8,6,90,47,43,104,1
669,Sheffield Weds,26,15,5,83,39,44,93,2
669,Barnsley,27,11,8,77,37,40,92,3
669,Bolton,26,9,11,71,34,37,87,4
669,Ipswich Town,24,14,8,91,43,48,86,5
669,Derby County,24,13,9,74,40,34,85,6
669,P'borough Utd,24,5,17,81,56,25,77,7
669,Wycombe,22,9,15,59,44,15,75,8
669,Shrewsbury,21,7,18,58,56,2,70,9
669,Portsmouth,18,14,14,65,52,13,68,10
669,Fleetwood Town,15,17,14,51,43,8,62,11
669,Port Vale,18,8,20,51,60,-9,62,12
669,Exeter City,15,16,15,60,56,4,61,13
669,Charlton Ath,13,15,18,58,64,-6,54,14
669,Oxford United,13,12,21,50,60,-10,51,15
669,Lincoln City,9,23,14,38,48,-10,50,16
669,Bristol Rovers,13,10,23,60,87,-27,49,17
669,Morecambe,10,14,22,44,68,-24,44,18
669,Burton Albion,10,14,22,53,87,-34,44,19
669,Acc'ton Stanley,10,13,23,42,85,-43,43,20
669,Cheltenham,10,10,26,30,62,-32,40,21
669,MK Dons,10,9,27,42,76,-34,39,22
669,Cambridge Utd,10,9,27,37,77,-40,39,23
669,FG Rovers,9,11,26,35,79,-44,38,24
670,Sheffield Weds,27,14,5,96,43,53,95,1
670,Bolton,27,10,9,77,34,43,91,2
670,Ipswich Town,25,15,6,84,44,40,90,3
670,Plymouth Argyle,25,12,9,77,51,26,87,4
670,Barnsley,25,10,11,74,41,33,85,5
670,Derby County,24,13,9,73,43,30,85,6
670,Wycombe,22,10,14,59,40,19,76,7
670,P'borough Utd,21,8,17,71,60,11,71,8
670,Portsmouth,17,17,12,67,54,13,68,9
670,Fleetwood Town,17,15,14,50,42,8,66,10
670,Shrewsbury,19,8,19,54,48,6,65,11
670,Charlton Ath,17,14,15,69,64,5,65,12
670,Port Vale,14,13,19,50,63,-13,55,13
670,Exeter City,14,12,20,59,64,-5,54,14
670,Burton Albion,13,15,18,62,83,-21,54,15
670,Oxford United,14,11,21,53,63,-10,53,16
670,Bristol Rovers,14,11,21,60,75,-15,53,17
670,Lincoln City,10,22,14,40,50,-10,52,18
670,MK Dons,13,9,24,47,72,-25,48,19
670,Cheltenham,12,11,23,38,63,-25,47,20
670,Morecambe,11,13,22,50,76,-26,46,21
670,Cambridge Utd,10,7,29,38,81,-43,37,22
670,Acc'ton Stanley,8,13,25,39,83,-44,37,23
670,FG Rovers,6,11,29,33,83,-50,29,24
671,Sheffield Weds,30,12,4,82,30,52,102,1
671,Derby County,25,12,9,77,33,44,87,2
671,Ipswich Town,23,17,6,77,46,31,86,3
671,Plymouth Argyle,23,13,10,76,58,18,82,4
671,Bolton,23,10,13,65,37,28,79,5
671,Barnsley,23,10,13,66,46,20,79,6
671,P'borough Utd,24,5,17,76,53,23,77,7
671,Wycombe,22,10,14,57,36,21,76,8
671,Portsmouth,19,15,12,66,55,11,72,9
671,Charlton Ath,17,16,13,60,52,8,67,10
671,Shrewsbury,17,12,17,49,46,3,63,11
671,Fleetwood Town,14,18,14,47,45,2,60,12
671,Lincoln City,13,20,13,45,49,-4,59,13
671,Port Vale,16,10,20,51,62,-11,58,14
671,Exeter City,15,10,21,57,65,-8,55,15
671,Burton Albion,14,12,20,54,75,-21,54,16
671,Cheltenham,15,9,22,39,60,-21,54,17
671,Bristol Rovers,13,12,21,64,81,-17,51,18
671,Morecambe,13,11,22,45,66,-21,50,19
671,Acc'ton Stanley,12,11,23,43,70,-27,47,20
671,Oxford United,10,12,24,41,62,-21,42,21
671,MK Dons,10,12,24,42,67,-25,42,22
671,FG Rovers,8,12,26,33,74,-41,36,23
671,Cambridge Utd,9,7,30,33,77,-44,34,24
672,Sheffield Weds,29,11,6,92,34,58,98,1
672,Barnsley,29,8,9,76,38,38,95,2
672,Plymouth Argyle,28,11,7,87,50,37,95,3
672,Ipswich Town,27,13,6,86,42,44,94,4
672,Derby County,21,14,11,68,43,25,77,5
672,Wycombe,23,7,16,68,48,20,76,6
672,Bolton,20,14,12,60,38,22,74,7
672,Charlton Ath,20,12,14,71,53,18,72,8
672,P'borough Utd,22,4,20,75,60,15,70,9
672,Shrewsbury,20,9,17,55,45,10,69,10
672,Portsmouth,16,17,13,61,56,5,65,11
672,Fleetwood Town,17,13,16,54,46,8,64,12
672,Exeter City,16,13,17,58,56,2,61,13
672,Oxford United,16,10,20,55,60,-5,58,14
672,Port Vale,15,9,22,47,69,-22,54,15
672,Lincoln City,10,21,15,35,52,-17,51,16
672,Bristol Rovers,12,13,21,65,91,-26,49,17
672,Burton Albion,12,13,21,54,80,-26,49,18
672,Cambridge Utd,13,9,24,41,66,-25,48,19
672,Cheltenham,11,11,24,32,66,-34,44,20
672,Morecambe,10,13,23,45,77,-32,43,21
672,Acc'ton Stanley,10,11,25,35,71,-36,41,22
672,MK Dons,10,8,28,36,69,-33,38,23
672,FG Rovers,8,10,28,39,85,-46,34,24
673,Sheffield Weds,30,11,5,78,31,47,101,1
673,Barnsley,29,8,9,77,33,44,95,2
673,Plymouth Argyle,26,11,9,77,52,25,89,3
673,Bolton,24,11,11,70,37,33,83,4
673,Wycombe,25,8,13,65,39,26,83,5
673,Ipswich Town,23,12,11,83,48,35,81,6
673,Derby County,22,12,12,71,48,23,78,7
673,P'borough Utd,23,6,17,73,57,16,75,8
673,Portsmouth,17,17,12,65,53,12,68,9
673,Shrewsbury,18,12,16,55,50,5,66,10
673,Charlton Ath,16,15,15,64,60,4,63,11
673,Fleetwood Town,15,16,15,55,48,7,61,12
673,Lincoln City,13,22,11,47,46,1,61,13
673,Port Vale,16,10,20,51,65,-14,58,14
673,Acc'ton Stanley,13,15,18,46,60,-14,54,15
673,Oxford United,14,11,21,53,59,-6,53,16
673,Bristol Rovers,13,13,20,61,75,-14,52,17
673,Exeter City,12,15,19,53,62,-9,51,18
673,Cheltenham,12,11,23,31,54,-23,47,19
673,MK Dons,12,9,25,46,82,-36,45,20
673,Morecambe,9,14,23,50,80,-30,41,21
673,Cambridge Utd,11,7,28,36,73,-37,40,22
673,Burton Albion,10,10,26,51,90,-39,40,23
673,FG Rovers,6,10,30,30,86,-56,28,24
674,Sheffield Weds,30,12,4,81,25,56,102,1
674,Plymouth Argyle,27,11,8,82,51,31,92,2
674,Ipswich Town,26,13,7,83,39,44,91,3
674,Barnsley,28,6,12,80,42,38,90,4
674,Derby County,22,17,7,71,36,35,83,5
674,Wycombe,24,10,12,64,41,23,82,6
674,Bolton,24,8,14,70,43,27,80,7
674,P'borough Utd,21,7,18,73,58,15,70,8
674,Charlton Ath,18,14,14,68,57,11,68,9
674,Shrewsbury,19,10,17,57,54,3,67,10
674,Portsmouth,17,15,14,66,58,8,66,11
674,Fleetwood Town,17,14,15,57,46,11,65,12
674,Port Vale,19,8,19,57,63,-6,65,13
674,Bristol Rovers,14,12,20,65,78,-13,54,14
674,Exeter City,14,12,20,53,66,-13,54,15
674,Lincoln City,11,20,15,43,50,-7,53,16
674,Oxford United,12,13,21,48,60,-12,49,17
674,Cheltenham,12,9,25,38,67,-29,45,18
674,Cambridge Utd,12,8,26,40,73,-33,44,19
674,Morecambe,10,13,23,42,76,-34,43,20
674,Burton Albion,11,9,26,62,97,-35,42,21
674,MK Dons,11,8,27,47,75,-28,41,22
674,Acc'ton Stanley,8,16,22,36,73,-37,40,23
674,FG Rovers,7,11,28,39,94,-55,32,24
675,Sheffield Weds,31,12,3,81,27,54,105,1
675,Plymouth Argyle,31,9,6,94,49,45,102,2
675,Barnsley,28,7,11,79,39,40,91,3
675,Ipswich Town,23,16,7,86,48,38,85,4
675,Bolton,25,10,11,74,38,36,85,5
675,Derby County,22,14,10,73,42,31,80,6
675,Wycombe,24,8,14,64,42,22,80,7
675,P'borough Utd,20,8,18,72,58,14,68,8
675,Shrewsbury,19,10,17,50,49,1,67,9
675,Portsmouth,17,15,14,59,55,4,66,10
675,Fleetwood Town,14,20,12,51,45,6,62,11
675,Lincoln City,12,22,12,40,49,-9,58,12
675,Port Vale,14,15,17,47,60,-13,57,13
675,Charlton Ath,13,15,18,59,61,-2,54,14
675,Exeter City,14,12,20,62,67,-5,54,15
675,Oxford United,13,15,18,50,55,-5,54,16
675,Bristol Rovers,13,11,22,58,81,-23,50,17
675,Cheltenham,11,12,23,32,57,-25,45,18
675,Cambridge Utd,12,9,25,41,70,-29,45,19
675,MK Dons,10,12,24,37,69,-32,42,20
675,Burton Albion,10,12,24,48,83,-35,42,21
675,Morecambe,9,13,24,46,76,-30,40,22
675,Acc'ton Stanley,8,14,24,37,75,-38,38,23
675,FG Rovers,8,11,27,41,86,-45,35,24
676,Sheffield Weds,30,13,3,92,32,60,103,1
676,Plymouth Argyle,28,11,7,86,45,41,95,2
676,Barnsley,28,9,9,82,43,39,93,3
676,Bolton,26,11,9,69,30,39,89,4
676,Ipswich Town,24,15,7,83,48,35,87,5
676,Wycombe,24,8,14,62,41,21,80,6
676,Derby County,21,14,11,66,45,21,77,7
676,Shrewsbury,19,10,17,56,45,11,67,8
676,Portsmouth,18,13,15,61,59,2,67,9
676,P'borough Utd,18,10,18,70,60,10,64,10
676,Fleetwood Town,14,19,13,51,44,7,61,11
676,Lincoln City,11,25,10,41,45,-4,58,12
676,Port Vale,15,10,21,49,64,-15,55,13
676,Charlton Ath,13,14,19,59,61,-2,53,14
676,Bristol Rovers,14,10,22,63,81,-18,52,15
676,Exeter City,12,14,20,56,64,-8,50,16
676,Burton Albion,13,11,22,58,84,-26,50,17
676,Cheltenham,11,14,21,34,57,-23,47,18
676,Morecambe,12,11,23,46,71,-25,47,19
676,Acc'ton Stanley,10,16,20,40,68,-28,46,20
676,Cambridge Utd,13,7,26,39,73,-34,46,21
676,Oxford United,10,14,22,44,64,-20,44,22
676,MK Dons,10,12,24,46,73,-27,42,23
676,FG Rovers,7,11,28,33,89,-56,32,24
677,Sheffield Weds,28,12,6,74,32,42,96,1
677,Plymouth Argyle,28,11,7,82,52,30,95,2
677,Ipswich Town,23,15,8,76,45,31,84,3
677,Barnsley,24,10,12,74,42,32,82,4
677,Bolton,23,11,12,69,40,29,80,5
677,Derby County,22,13,11,68,44,24,79,6
677,P'borough Utd,24,6,16,79,55,24,78,7
677,Wycombe,23,9,14,63,42,21,78,8
677,Charlton Ath,20,13,13,75,56,19,73,9
677,Fleetwood Town,17,17,12,57,43,14,68,10
677,Portsmouth,17,17,12,62,50,12,68,11
677,Shrewsbury,19,9,18,50,49,1,66,12
677,Lincoln City,14,19,13,46,50,-4,61,13
677,Bristol Rovers,15,12,19,68,78,-10,57,14
677,Exeter City,14,12,20,60,63,-3,54,15
677,Oxford United,14,10,22,47,61,-14,52,16
677,Burton Albion,13,12,21,60,81,-21,51,17
677,Port Vale,12,11,23,45,70,-25,47,18
677,Acc'ton Stanley,11,13,22,45,75,-30,46,19
677,MK Dons,11,11,24,44,67,-23,44,20
677,Morecambe,11,10,25,46,73,-27,43,21
677,Cheltenham,9,15,22,37,64,-27,42,22
677,Cambridge Utd,10,7,29,34,78,-44,37,23
677,FG Rovers,8,9,29,34,85,-51,33,24
678,Sheffield Weds,30,13,3,80,27,53,103,1
678,Plymouth Argyle,28,10,8,88,49,39,94,2
678,Bolton,26,10,10,71,33,38,88,3
678,Barnsley,25,9,12,72,43,29,84,4
678,Derby County,22,15,9,70,40,30,81,5
678,P'borough Utd,23,8,15,78,53,25,77,6
678,Ipswich Town,20,16,10,73,49,24,76,7
678,Wycombe,22,9,15,61,44,17,75,8
678,Charlton Ath,19,13,14,78,55,23,70,9
678,Shrewsbury,19,11,16,57,55,2,68,10
678,Portsmouth,17,15,14,57,55,2,66,11
678,Lincoln City,14,20,12,50,47,3,62,12
678,Exeter City,16,12,18,63,59,4,60,13
678,Fleetwood Town,14,17,15,48,42,6,59,14
678,Port Vale,12,13,21,41,67,-26,49,15
678,Bristol Rovers,12,12,22,58,83,-25,48,16
678,Acc'ton Stanley,11,15,20,41,70,-29,48,17
678,Oxford United,11,13,22,48,64,-16,46,18
678,Cheltenham,12,10,24,36,62,-26,46,19
678,Burton Albion,12,10,24,57,87,-30,46,20
678,Morecambe,10,13,23,43,71,-28,43,21
678,MK Dons,12,7,27,42,74,-32,43,22
678,Cambridge Utd,11,10,25,33,68,-35,43,23
678,FG Rovers,7,13,26,37,85,-48,34,24
679,Sheffield Weds,30,11,5,91,31,60,101,1
679,Derby County,25,13,8,82,42,40,88,2
679,Ipswich Town,24,13,9,83,53,30,85,3
679,Plymouth Argyle,24,12,10,75,51,24,84,4
679,Barnsley,24,11,11,71,44,27,83,5
679,Bolton,22,10,14,61,40,21,76,6
679,Wycombe,21,12,13,62,44,18,75,7
679,P'borough Utd,23,4,19,73,59,14,73,8
679,Portsmouth,18,17,11,64,51,13,71,9
679,Fleetwood Town,18,13,15,55,45,10,67,10
679,Lincoln City,15,20,11,48,49,-1,65,11
679,Shrewsbury,18,10,18,60,53,7,64,12
679,Charlton Ath,15,14,17,66,70,-4,59,13
679,Port Vale,16,8,22,52,64,-12,56,14
679,Bristol Rovers,15,11,20,64,78,-14,56,15
679,Morecambe,13,15,18,52,67,-15,54,16
679,Exeter City,13,13,20,56,59,-3,52,17
679,MK Dons,14,10,22,42,61,-19,52,18
679,Burton Albion,12,11,23,56,85,-29,47,19
679,Oxford United,11,13,22,43,58,-15,46,20
679,Acc'ton Stanley,10,14,22,36,66,-30,44,21
679,Cheltenham,12,8,26,35,68,-33,44,22
679,Cambridge Utd,10,8,28,34,72,-38,38,23
679,FG Rovers,8,11,27,33,84,-51,35,24
680,Plymouth Argyle,30,10,6,91,44,47,100,1
680,Ipswich Town,25,16,5,89,41,48,91,2
680,Sheffield Weds,26,13,7,71,36,35,91,3
680,Derby County,24,13,9,76,39,37,85,4
680,Barnsley,24,10,12,69,42,27,82,5
680,Bolton,23,11,12,72,40,32,80,6
680,Portsmouth,20,15,11,68,50,18,75,7
680,P'borough Utd,21,6,19,71,55,16,69,8
680,Wycombe,20,8,18,58,47,11,68,9
680,Shrewsbury,18,11,17,60,53,7,65,10
680,Lincoln City,14,22,10,48,46,2,64,11
680,Exeter City,17,12,17,62,67,-5,63,12
680,Fleetwood Town,15,16,15,53,47,6,61,13
680,Charlton Ath,15,15,16,62,61,1,60,14
680,Oxford United,16,11,19,53,57,-4,59,15
680,Bristol Rovers,14,11,21,63,76,-13,53,16
680,Port Vale,14,10,22,44,67,-23,52,17
680,Cheltenham,13,10,23,35,58,-23,49,18
680,Burton Albion,13,10,23,55,85,-30,49,19
680,MK Dons,12,10,24,42,69,-27,46,20
680,Cambridge Utd,11,8,27,36,75,-39,41,21
680,Acc'ton Stanley,8,14,24,33,70,-37,38,22
680,FG Rovers,8,13,25,40,83,-43,37,23
680,Morecambe,7,13,26,41,84,-43,34,24
681,Sheffield Weds,33,10,3,95,31,64,109,1
681,Plymouth Argyle,31,8,7,94,50,44,101,2
681,Ipswich Town,24,16,6,85,44,41,88,3
681,Bolton,26,10,10,65,34,31,88,4
681,Barnsley,26,8,12,75,43,32,86,5
681,Derby County,23,12,11,69,39,30,81,6
681,Wycombe,23,9,14,65,47,18,78,7
681,P'borough Utd,22,5,19,71,56,15,71,8
681,Portsmouth,18,16,12,64,53,11,70,9
681,Charlton Ath,15,17,14,58,60,-2,62,10
681,Shrewsbury,17,9,20,48,51,-3,60,11
681,Fleetwood Town,13,17,16,46,44,2,56,12
681,Bristol Rovers,14,13,19,62,72,-10,55,13
681,Port Vale,14,13,19,47,64,-17,55,14
681,Lincoln City,10,22,14,41,51,-10,52,15
681,Oxford United,13,12,21,50,65,-15,51,16
681,Acc'ton Stanley,11,16,19,39,66,-27,49,17
681,Exeter City,12,12,22,51,63,-12,48,18
681,Morecambe,11,15,20,44,66,-22,48,19
681,Cheltenham,12,9,25,40,68,-28,45,20
681,Burton Albion,10,13,23,56,87,-31,43,21
681,Cambridge Utd,12,7,27,43,75,-32,43,22
681,MK Dons,11,8,27,39,67,-28,41,23
681,FG Rovers,8,9,29,39,90,-51,33,24
682,Sheffield Weds,31,10,5,80,26,54,103,1
682,Plymouth Argyle,29,11,6,82,47,35,98,2
682,Ipswich Town,24,17,5,80,39,41,89,3
682,Barnsley,25,9,12,70,45,25,84,4
682,Wycombe,25,7,14,63,40,23,82,5
682,Bolton,24,9,13,61,34,27,81,6
682,P'borough Utd,23,7,16,74,55,19,76,7
682,Derby County,20,14,12,66,45,21,74,8
682,Shrewsbury,22,8,16,64,46,18,74,9
682,Portsmouth,19,16,11,65,49,16,73,10
682,Fleetwood Town,19,15,12,57,38,19,72,11
682,Charlton Ath,16,14,16,63,57,6,62,12
682,Lincoln City,12,21,13,44,49,-5,57,13
682,Exeter City,15,12,19,58,68,-10,57,14
682,Port Vale,14,10,22,45,76,-31,52,15
682,Oxford United,13,12,21,49,58,-9,51,16
682,Acc'ton Stanley,11,15,20,38,62,-24,48,17
682,Burton Albion,13,9,24,54,89,-35,48,18
682,Bristol Rovers,12,10,24,56,78,-22,46,19
682,MK Dons,11,10,25,43,65,-22,43,20
682,Cheltenham,11,9,26,36,68,-32,42,21
682,Morecambe,9,14,23,42,69,-27,41,22
682,Cambridge Utd,10,7,29,34,71,-37,37,23
682,FG Rovers,6,10,30,33,83,-50,28,24
683,Plymouth Argyle,30,10,6,92,49,43,100,1
683,Sheffield Weds,29,12,5,82,33,49,99,2
683,Ipswich Town,24,15,7,82,40,42,87,3
683,Derby County,25,11,10,76,41,35,86,4
683,Barnsley,26,7,13,74,48,26,85,5
683,Wycombe,25,6,15,69,48,21,81,6
683,Bolton,23,10,13,67,39,28,79,7
683,P'borough Utd,24,7,15,82,57,25,79,8
683,Portsmouth,21,14,11,64,50,14,77,9
683,Fleetwood Town,17,14,15,57,47,10,65,10
683,Shrewsbury,18,11,17,53,49,4,65,11
683,Charlton Ath,16,14,16,66,59,7,62,12
683,Port Vale,17,8,21,49,71,-22,59,13
683,Exeter City,15,12,19,58,62,-4,57,14
683,Lincoln City,10,24,12,41,47,-6,54,15
683,Burton Albion,13,11,22,60,87,-27,50,16
683,Oxford United,13,9,24,42,58,-16,48,17
683,Bristol Rovers,13,9,24,61,87,-26,48,18
683,Acc'ton Stanley,12,11,23,40,71,-31,47,19
683,Cheltenham,11,11,24,35,64,-29,44,20
683,Cambridge Utd,10,9,27,42,72,-30,39,21
683,Morecambe,8,14,24,40,77,-37,38,22
683,MK Dons,8,12,26,42,74,-32,36,23
683,FG Rovers,8,11,27,37,81,-44,35,24
684,Sheffield Weds,29,11,6,88,35,53,98,1
684,Plymouth Argyle,28,9,9,87,54,33,93,2
684,Ipswich Town,26,13,7,86,41,45,91,3
684,Barnsley,28,6,12,76,41,35,90,4
684,Bolton,25,11,10,69,35,34,86,5
684,Derby County,21,12,13,60,40,20,75,6
684,P'borough Utd,22,8,16,75,54,21,74,7
684,Wycombe,20,11,15,57,48,9,71,8
684,Shrewsbury,19,9,18,56,50,6,66,9
684,Portsmouth,16,16,14,57,51,6,64,10
684,Charlton Ath,15,16,15,61,57,4,61,11
684,Fleetwood Town,14,17,15,48,45,3,59,12
684,Burton Albion,16,10,20,62,80,-18,58,13
684,Bristol Rovers,15,12,19,63,82,-19,57,14
684,Lincoln City,11,23,12,49,57,-8,56,15
684,Exeter City,14,12,20,53,57,-4,54,16
684,Oxford United,14,12,20,53,58,-5,54,17
684,Port Vale,14,11,21,47,66,-19,53,18
684,Acc'ton Stanley,11,16,19,44,70,-26,49,19
684,Cheltenham,12,11,23,37,61,-24,47,20
684,MK Dons,12,10,24,43,65,-22,46,21
684,Cambridge Utd,13,5,28,38,72,-34,44,22
684,Morecambe,9,13,24,44,76,-32,40,23
684,FG Rovers,7,8,31,35,93,-58,29,24
685,Sheffield Weds,31,12,3,87,24,63,105,1
685,Plymouth Argyle,28,10,8,83,49,34,94,2
685,Ipswich Town,24,18,4,79,38,41,90,3
685,Barnsley,25,12,9,68,36,32,87,4
685,Derby County,22,15,9,76,43,33,81,5
685,Wycombe,24,8,14,66,42,24,80,6
685,Bolton,22,13,11,67,38,29,79,7
685,P'borough Utd,21,7,18,69,59,10,70,8
685,Charlton Ath,18,14,14,65,53,12,68,9
685,Portsmouth,17,16,13,62,57,5,67,10
685,Shrewsbury,17,11,18,55,53,2,62,11
685,Fleetwood Town,14,18,14,45,43,2,60,12
685,Exeter City,16,12,18,56,59,-3,60,13
685,Bristol Rovers,14,12,20,61,74,-13,54,14
685,Lincoln City,9,26,11,40,48,-8,53,15
685,Port Vale,13,13,20,48,68,-20,52,16
685,Acc'ton Stanley,13,13,20,39,63,-24,52,17
685,Oxford United,11,16,19,49,56,-7,49,18
685,Burton Albion,12,10,24,53,92,-39,46,19
685,MK Dons,11,12,23,44,68,-24,45,20
685,Morecambe,10,15,21,41,66,-25,45,21
685,Cheltenham,10,10,26,34,66,-32,40,22
685,Cambridge Utd,9,7,30,34,74,-40,34,23
685,FG Rovers,5,12,29,32,84,-52,27,24
686,Sheffield Weds,31,12,3,79,26,53,105,1
686,Plymouth Argyle,29,11,6,95,46,49,98,2
686,Bolton,28,8,10,71,31,40,92,3
686,Ipswich Town,24,15,7,74,38,36,87,4
686,Barnsley,25,7,14,74,43,31,82,5
686,Wycombe,24,10,12,65,40,25,82,6
686,Derby County,22,12,12,67,39,28,78,7
686,Shrewsbury,20,9,17,65,52,13,69,8
686,P'borough Utd,21,6,19,74,62,12,69,9
686,Portsmouth,17,18,11,62,52,10,69,10
686,Fleetwood Town,15,15,16,49,45,4,60,11
686,Exeter City,15,13,18,55,58,-3,58,12
686,Lincoln City,11,24,11,43,45,-2,57,13
686,Burton Albion,15,11,20,54,77,-23,56,14
686,Bristol Rovers,14,12,20,63,80,-17,54,15
686,Charlton Ath,12,17,17,56,61,-5,53,16
686,Port Vale,12,15,19,47,64,-17,51,17
686,Cheltenham,12,10,24,35,64,-29,46,18
686,Oxford United,10,14,22,40,58,-18,44,19
686,Cambridge Utd,11,11,24,40,71,-31,44,20
686,MK Dons,12,7,27,45,76,-31,43,21
686,Morecambe,10,12,24,48,82,-34,42,22
686,Acc'ton Stanley,9,13,24,36,75,-39,40,23
686,FG Rovers,6,12,28,34,86,-52,30,24
687,Sheffield Weds,30,10,6,88,30,58,100,1
687,Plymouth Argyle,27,11,8,84,48,36,92,2
687,Barnsley,26,9,11,71,40,31,87,3
687,Ipswich Town,23,17,6,90,47,43,86,4
687,Derby County,24,12,10,78,44,34,84,5
687,Bolton,22,13,11,64,39,25,79,6
687,Portsmouth,21,15,10,70,47,23,78,7
687,Wycombe,23,9,14,63,42,21,78,8
687,P'borough Utd,21,6,19,70,59,11,69,9
687,Shrewsbury,19,11,16,55,48,7,68,10
687,Charlton Ath,17,13,16,65,58,7,64,11
687,Fleetwood Town,15,16,15,53,47,6,61,12
687,Bristol Rovers,16,12,18,61,73,-12,60,13
687,Lincoln City,11,25,10,43,46,-3,58,14
687,Exeter City,16,10,20,59,65,-6,58,15
687,Oxford United,15,12,19,52,57,-5,57,16
687,Burton Albion,12,12,22,63,92,-29,48,17
687,Port Vale,13,8,25,43,76,-33,47,18
687,Acc'ton Stanley,10,15,21,45,72,-27,45,19
687,Cheltenham,11,10,25,33,64,-31,43,20
687,Cambridge Utd,11,8,27,37,76,-39,41,21
687,Morecambe,9,13,24,45,70,-25,40,22
687,MK Dons,10,9,27,42,75,-33,39,23
687,FG Rovers,7,10,29,33,92,-59,31,24
688,Sheffield Weds,32,9,5,102,34,68,105,1
688,Plymouth Argyle,27,12,7,86,51,35,93,2
688,Barnsley,28,8,10,72,39,33,92,3
688,Ipswich Town,25,15,6,88,41,47,90,4
688,Bolton,25,10,11,67,34,33,85,5
688,Derby County,24,11,11,81,42,39,83,6
688,Wycombe,24,8,14,69,50,19,80,7
688,Portsmouth,20,15,11,70,54,16,75,8
688,P'borough Utd,21,7,18,76,61,15,70,9
688,Charlton Ath,16,14,16,66,63,3,62,10
688,Fleetwood Town,15,16,15,52,48,4,61,11
688,Shrewsbury,16,13,17,56,55,1,61,12
688,Lincoln City,13,22,11,43,44,-1,61,13
688,Exeter City,15,11,20,57,65,-8,56,14
688,Bristol Rovers,14,13,19,68,83,-15,55,15
688,Port Vale,15,8,23,43,65,-22,53,16
688,Oxford United,14,9,23,47,63,-16,51,17
688,Acc'ton Stanley,12,13,21,43,71,-28,49,18
688,MK Dons,13,7,26,45,69,-24,46,19
688,Morecambe,12,10,24,45,73,-28,46,20
688,Cheltenham,12,8,26,33,64,-31,44,21
688,Cambridge Utd,12,6,28,39,74,-35,42,22
688,Burton Albion,10,9,27,49,92,-43,39,23
688,FG Rovers,5,10,31,31,93,-62,25,24
689,Sheffield Weds,30,10,6,87,35,52,100,1
689,Plymouth Argyle,26,13,7,84,51,33,91,2
689,Ipswich Town,25,14,7,87,46,41,89,3
689,Bolton,27,8,11,75,36,39,89,4
689,Barnsley,27,8,11,72,39,33,89,5
689,P'borough Utd,25,7,14,77,48,29,82,6
689,Portsmouth,20,16,10,66,44,22,76,7
689,Wycombe,22,10,14,62,44,18,76,8
689,Derby County,21,11,14,71,47,24,74,9
689,Fleetwood Town,19,13,14,58,47,11,70,10
689,Shrewsbury,20,10,16,56,49,7,70,11
689,Charlton Ath,17,13,16,74,61,13,64,12
689,Lincoln City,11,22,13,42,48,-6,55,13
689,Exeter City,14,12,20,53,62,-9,54,14
689,Port Vale,15,9,22,42,60,-18,54,15
689,Bristol Rovers,14,11,21,66,82,-16,53,16
689,Cheltenham,14,9,23,39,66,-27,51,17
689,Oxford United,13,11,22,45,60,-15,50,18
689,Burton Albion,13,10,23,54,84,-30,49,19
689,Acc'ton Stanley,11,13,22,34,63,-29,46,20
689,MK Dons,10,9,27,43,76,-33,39,21
689,Morecambe,8,12,26,40,78,-38,36,22
689,Cambridge Utd,9,8,29,32,82,-50,35,23
689,FG Rovers,7,9,30,33,84,-51,30,24
690,Sheffield Weds,30,13,3,81,26,55,103,1
690,Barnsley,29,8,9,77,44,33,95,2
690,Plymouth Argyle,27,11,8,88,55,33,92,3
690,Ipswich Town,24,14,8,86,49,37,86,4
690,Derby County,23,12,11,81,50,31,81,5
690,Portsmouth,22,15,9,75,48,27,81,6
690,Wycombe,24,8,14,70,46,24,80,7
690,Bolton,22,13,11,65,35,30,79,8
690,P'borough Utd,21,8,17,71,53,18,71,9
690,Shrewsbury,21,8,17,59,46,13,71,10
690,Exeter City,15,14,17,56,54,2,59,11
690,Lincoln City,12,21,13,40,43,-3,57,12
690,Fleetwood Town,13,17,16,47,50,-3,56,13
690,Bristol Rovers,15,10,21,67,83,-16,55,14
690,Charlton Ath,12,15,19,63,71,-8,51,15
690,Burton Albion,13,11,22,59,85,-26,50,16
690,Acc'ton Stanley,11,16,19,40,69,-29,49,17
690,Port Vale,13,9,24,42,69,-27,48,18
690,Oxford United,12,10,24,44,60,-16,46,19
690,Cheltenham,12,9,25,33,63,-30,45,20
690,Morecambe,10,14,22,47,74,-27,44,21
690,MK Dons,10,10,26,43,69,-26,40,22
690,Cambridge Utd,10,10,26,32,70,-38,40,23
690,FG Rovers,8,10,28,35,89,-54,34,24
691,Sheffield Weds,29,12,5,85,33,52,99,1
691,Plymouth Argyle,30,9,7,94,55,39,99,2
691,Derby County,26,11,9,75,41,34,89,3
691,Barnsley,24,11,11,70,45,25,83,4
691,Bolton,23,12,11,64,35,29,81,5
691,Ipswich Town,20,18,8,79,46,33,78,6
691,Portsmouth,21,14,11,67,49,18,77,7
691,Wycombe,21,12,13,61,43,18,75,8
691,P'borough Utd,22,5,19,68,58,10,71,9
691,Shrewsbury,19,9,18,56,47,9,66,10
691,Lincoln City,13,24,9,45,43,2,63,11
691,Charlton Ath,16,14,16,71,67,4,62,12
691,Port Vale,16,8,22,50,65,-15,56,13
691,Bristol Rovers,15,10,21,68,85,-17,55,14
691,Fleetwood Town,11,18,17,49,48,1,51,15
691,Exeter City,12,15,19,54,61,-7,51,16
691,Oxford United,13,12,21,51,59,-8,51,17
691,MK Dons,13,11,22,41,61,-20,50,18
691,Cheltenham,12,13,21,37,61,-24,49,19
691,Acc'ton Stanley,11,12,23,39,76,-37,45,20
691,Morecambe,10,14,22,46,71,-25,44,21
691,Burton Albion,10,11,25,52,88,-36,41,22
691,Cambridge Utd,11,7,28,33,72,-39,40,23
691,FG Rovers,7,12,27,35,81,-46,33,24
692,Plymouth Argyle,30,11,5,95,49,46,101,1
692,Sheffield Weds,27,12,7,77,29,48,93,2
692,Barnsley,27,9,10,69,38,31,90,3
692,Bolton,26,9,11,75,40,35,87,4
692,Ipswich Town,24,14,8,87,49,38,86,5
692,Derby County,24,12,10,77,47,30,84,6
692,Wycombe,21,12,13,61,42,19,75,7
692,Shrewsbury,21,8,17,61,57,4,71,8
692,P'borough Utd,20,7,19,74,62,12,67,9
692,Fleetwood Town,17,16,13,53,43,10,67,10
692,Portsmouth,16,17,13,61,56,5,65,11
692,Exeter City,17,12,17,64,58,6,63,12
692,Charlton Ath,15,16,15,66,59,7,61,13
692,Bristol Rovers,16,9,21,61,71,-10,57,14
692,Lincoln City,10,23,13,41,48,-7,53,15
692,Burton Albion,13,13,20,59,83,-24,52,16
692,Oxford United,12,12,22,49,58,-9,48,17
692,Port Vale,13,9,24,46,70,-24,48,18
692,MK Dons,11,11,24,42,66,-24,44,19
692,Cheltenham,11,11,24,37,62,-25,44,20
692,Morecambe,10,14,22,52,83,-31,44,21
692,Cambridge Utd,11,7,28,34,74,-40,40,22
692,Acc'ton Stanley,9,13,24,34,82,-48,40,23
692,FG Rovers,7,11,28,32,81,-49,32,24
693,Sheffield Weds,30,11,5,84,28,56,101,1
693,Plymouth Argyle,27,11,8,81,49,32,92,2
693,Derby County,26,11,9,74,39,35,89,3
693,Barnsley,24,12,10,68,41,27,84,4
693,Bolton,24,10,12,71,41,30,82,5
693,Ipswich Town,22,15,9,81,48,33,81,6
693,Wycombe,23,8,15,63,43,20,77,7
693,Portsmouth,18,15,13,60,49,11,69,8
693,Shrewsbury,18,12,16,54,51,3,66,9
693,Charlton Ath,17,13,16,72,63,9,64,10
693,P'borough Utd,18,9,19,73,66,7,63,11
693,Fleetwood Town,14,18,14,50,47,3,60,12
693,Port Vale,16,12,18,52,61,-9,60,13
693,Burton Albion,16,11,19,60,78,-18,59,14
693,Bristol Rovers,15,11,20,65,79,-14,56,15
693,Exeter City,13,16,17,59,61,-2,55,16
693,Lincoln City,10,23,13,41,45,-4,53,17
693,Cheltenham,13,10,23,39,64,-25,49,18
693,Oxford United,12,12,22,46,59,-13,48,19
693,MK Dons,12,8,26,41,69,-28,44,20
693,Morecambe,10,13,23,44,74,-30,43,21
693,Cambridge Utd,11,9,26,40,72,-32,42,22
693,Acc'ton Stanley,9,15,22,32,66,-34,42,23
693,FG Rovers,6,11,29,33,90,-57,29,24
694,Plymouth Argyle,28,11,7,93,54,39,95,1
694,Sheffield Weds,26,16,4,78,32,46,94,2
694,Ipswich Town,26,13,7,85,41,44,91,3
694,Bolton,26,10,10,74,38,36,88,4
694,Barnsley,25,12,9,66,33,33,87,5
694,Derby County,22,15,9,72,38,34,81,6
694,P'borough Utd,23,5,18,76,59,17,74,7
694,Portsmouth,18,18,10,73,55,18,72,8
694,Wycombe,21,9,16,60,46,14,72,9
694,Charlton Ath,18,12,16,64,57,7,66,10
694,Fleetwood Town,16,17,13,54,44,10,65,11
694,Lincoln City,13,21,12,47,49,-2,60,12
694,Shrewsbury,16,11,19,54,53,1,59,13
694,Bristol Rovers,16,10,20,63,73,-10,58,14
694,Cheltenham,16,8,22,39,54,-15,56,15
694,Oxford United,13,13,20,48,54,-6,52,16
694,Exeter City,12,16,18,54,63,-9,52,17
694,Port Vale,13,10,23,45,69,-24,49,18
694,MK Dons,11,11,24,42,68,-26,44,19
694,Morecambe,9,16,21,45,74,-29,43,20
694,Burton Albion,11,9,26,52,92,-40,42,21
694,Acc'ton Stanley,9,14,23,33,72,-39,41,22
694,FG Rovers,7,13,26,38,87,-49,34,23
694,Cambridge Utd,8,8,30,33,83,-50,32,24
695,Sheffield Weds,29,11,6,83,29,54,98,1
695,Plymouth Argyle,29,9,8,82,49,33,96,2
695,Ipswich Town,26,14,6,85,41,44,92,3
695,Barnsley,25,8,13,70,43,27,83,4
695,Derby County,22,16,8,68,37,31,82,5
695,Portsmouth,21,15,10,67,47,20,78,6
695,Wycombe,23,8,15,58,42,16,77,7
695,Bolton,21,12,13,64,41,23,75,8
695,P'borough Utd,22,6,18,73,56,17,72,9
695,Lincoln City,17,18,11,51,43,8,69,10
695,Shrewsbury,20,8,18,57,53,4,68,11
695,Charlton Ath,16,16,14,67,55,12,64,12
695,Fleetwood Town,16,14,16,51,47,4,62,13
695,Exeter City,15,12,19,66,64,2,57,14
695,Oxford United,15,12,19,53,55,-2,57,15
695,Port Vale,15,7,24,48,73,-25,52,16
695,Bristol Rovers,13,12,21,62,80,-18,51,17
695,Burton Albion,13,9,24,53,83,-30,48,18
695,Acc'ton Stanley,12,11,23,35,77,-42,47,19
695,Morecambe,11,12,23,46,75,-29,45,20
695,Cheltenham,12,9,25,34,63,-29,45,21
695,MK Dons,10,7,29,41,70,-29,37,22
695,FG Rovers,8,11,27,41,85,-44,35,23
695,Cambridge Utd,9,7,30,29,76,-47,34,24
696,Sheffield Weds,32,10,4,84,27,57,106,1
696,Plymouth Argyle,29,12,5,82,45,37,99,2
696,Ipswich Town,26,14,6,87,41,46,92,3
696,Barnsley,28,7,11,74,38,36,91,4
696,Derby County,25,10,11,77,40,37,85,5
696,Bolton,23,12,11,72,40,32,81,6
696,P'borough Utd,25,6,15,76,52,24,81,7
696,Wycombe,22,8,16,58,41,17,74,8
696,Charlton Ath,18,13,15,66,55,11,67,9
696,Portsmouth,17,15,14,63,55,8,66,10
696,Lincoln City,14,22,10,42,42,0,64,11
696,Shrewsbury,17,11,18,49,50,-1,62,12
696,Fleetwood Town,15,15,16,52,49,3,60,13
696,Exeter City,13,13,20,51,62,-11,52,14
696,Cambridge Utd,14,8,24,42,71,-29,50,15
696,Port Vale,14,8,24,46,76,-30,50,16
696,Oxford United,13,10,23,43,58,-15,49,17
696,Bristol Rovers,13,10,23,61,80,-19,49,18
696,Burton Albion,12,11,23,59,86,-27,47,19
696,Acc'ton Stanley,10,13,23,34,71,-37,43,20
696,Cheltenham,10,12,24,32,65,-33,42,21
696,Morecambe,10,11,25,45,77,-32,41,22
696,MK Dons,10,8,28,40,71,-31,38,23
696,FG Rovers,7,11,28,34,77,-43,32,24
697,Sheffield Weds,31,10,5,95,39,56,103,1
697,Plymouth Argyle,30,9,7,94,52,42,99,2
697,Ipswich Town,25,15,6,83,43,40,90,3
697,Barnsley,26,9,11,77,44,33,87,4
697,Bolton,25,11,10,70,33,37,86,5
697,Derby County,25,10,11,80,39,41,85,6
697,P'borough Utd,24,6,16,81,53,28,78,7
697,Wycombe,22,9,15,64,47,17,75,8
697,Shrewsbury,19,9,18,55,54,1,66,9
697,Fleetwood Town,16,17,13,51,47,4,65,10
697,Portsmouth,15,19,12,61,59,2,64,11
697,Charlton Ath,17,12,17,63,61,2,63,12
697,Lincoln City,13,23,10,47,45,2,62,13
697,Bristol Rovers,14,10,22,62,85,-23,52,14
697,Exeter City,13,12,21,61,74,-13,51,15
697,Port Vale,13,12,21,44,67,-23,51,16
697,Oxford United,12,12,22,47,61,-14,48,17
697,Cheltenham,13,7,26,38,68,-30,46,18
697,Burton Albion,11,13,22,54,85,-31,46,19
697,Acc'ton Stanley,10,16,20,40,72,-32,46,20
697,MK Dons,12,8,26,49,71,-22,44,21
697,Morecambe,9,12,25,47,82,-35,39,22
697,Cambridge Utd,8,11,27,34,74,-40,35,23
697,FG Rovers,8,10,28,36,78,-42,34,24
698,Sheffield Weds,30,10,6,88,30,58,100,1
698,Plymouth Argyle,26,11,9,86,58,28,89,2
698,Ipswich Town,24,15,7,81,46,35,87,3
698,Barnsley,26,9,11,68,37,31,87,4
698,Bolton,24,11,11,69,36,33,83,5
698,Derby County,23,11,12,77,44,33,80,6
698,Wycombe,22,9,15,62,42,20,75,7
698,Portsmouth,19,16,11,66,53,13,73,8
698,P'borough Utd,22,6,18,79,57,22,72,9
698,Shrewsbury,19,10,17,56,51,5,67,10
698,Charlton Ath,17,14,15,66,55,11,65,11
698,Lincoln City,15,20,11,49,51,-2,65,12
698,Fleetwood Town,15,16,15,48,47,1,61,13
698,Exeter City,15,11,20,56,62,-6,56,14
698,Morecambe,14,14,18,47,61,-14,56,15
698,Burton Albion,12,14,20,57,82,-25,50,16
698,Port Vale,13,10,23,45,67,-22,49,17
698,Cheltenham,13,10,23,38,63,-25,49,18
698,Bristol Rovers,12,12,22,55,78,-23,48,19
698,Oxford United,11,13,22,41,57,-16,46,20
698,Cambridge Utd,10,10,26,39,76,-37,40,21
698,MK Dons,10,9,27,41,73,-32,39,22
698,FG Rovers,8,14,24,35,82,-47,38,23
698,Acc'ton Stanley,8,13,25,31,72,-41,37,24
699,Plymouth Argyle,29,10,7,86,49,37,97,1
699,Sheffield Weds,26,16,4,69,28,41,94,2
699,Ipswich Town,24,17,5,83,38,45,89,3
699,Derby County,24,13,9,72,38,34,85,4
699,Barnsley,25,8,13,78,50,28,83,5
699,Bolton,22,13,11,63,36,27,79,6
699,P'borough Utd,23,8,15,77,52,25,77,7
699,Wycombe,22,7,17,63,47,16,73,8
699,Charlton Ath,20,12,14,71,55,16,72,9
699,Shrewsbury,20,9,17,55,52,3,69,10
699,Portsmouth,17,15,14,57,52,5,66,11
699,Fleetwood Town,14,17,15,48,47,1,59,12
699,Exeter City,16,10,20,61,62,-1,58,13
699,Lincoln City,12,22,12,46,48,-2,58,14
699,Bristol Rovers,15,12,19,63,73,-10,57,15
699,Burton Albion,14,11,21,57,83,-26,53,16
699,Oxford United,12,13,21,46,55,-9,49,17
699,Morecambe,12,13,21,44,65,-21,49,18
699,Port Vale,13,10,23,43,69,-26,49,19
699,Cheltenham,12,10,24,37,65,-28,46,20
699,Acc'ton Stanley,10,14,22,37,66,-29,44,21
699,Cambridge Utd,10,10,26,32,67,-35,40,22
699,MK Dons,10,9,27,42,72,-30,39,23
699,FG Rovers,6,9,31,28,89,-61,27,24
700,Sheffield Weds,27,14,5,75,33,42,95,1
700,Derby County,27,11,8,82,40,42,92,2
700,Plymouth Argyle,27,10,9,81,51,30,91,3
700,Ipswich Town,25,15,6,89,42,47,90,4
700,Bolton,24,12,10,71,36,35,84,5
700,Barnsley,25,9,12,74,44,30,84,6
700,Wycombe,24,9,13,72,44,28,81,7
700,P'borough Utd,24,7,15,78,53,25,79,8
700,Portsmouth,18,14,14,62,54,8,68,9
700,Shrewsbury,19,9,18,54,55,-1,66,10
700,Fleetwood Town,16,17,13,54,43,11,65,11
700,Charlton Ath,17,12,17,66,60,6,63,12
700,Lincoln City,12,23,11,41,43,-2,59,13
700,Port Vale,16,10,20,49,62,-13,58,14
700,Oxford United,14,12,20,52,59,-7,54,15
700,Exeter City,14,12,20,57,67,-10,54,16
700,Bristol Rovers,12,11,23,61,81,-20,47,17
700,Burton Albion,12,10,24,50,83,-33,46,18
700,MK Dons,12,9,25,41,65,-24,45,19
700,Acc'ton Stanley,10,13,23,38,74,-36,43,20
700,Morecambe,9,13,24,44,83,-39,40,21
700,Cambridge Utd,11,7,28,36,77,-41,40,22
700,Cheltenham,10,8,28,29,64,-35,38,23
700,FG Rovers,7,13,26,38,81,-43,34,24
701,Sheffield Weds,31,10,5,80,29,51,103,1
701,Derby County,25,13,8,74,36,38,88,2
701,Barnsley,26,10,10,73,38,35,88,3
701,Ipswich Town,24,15,7,78,43,35,87,4
701,Plymouth Argyle,25,12,9,83,51,32,87,5
701,Bolton,24,10,12,72,35,37,82,6
701,P'borough Utd,26,4,16,85,59,26,82,7
701,Wycombe,20,12,14,59,42,17,72,8
701,Shrewsbury,21,7,18,56,52,4,70,9
701,Portsmouth,18,15,13,61,53,8,69,10
701,Port Vale,18,11,17,52,55,-3,65,11
701,Charlton Ath,16,16,14,65,58,7,64,12
701,Bristol Rovers,16,10,20,61,75,-14,58,13
701,Lincoln City,11,24,11,40,44,-4,57,14
701,Exeter City,14,12,20,57,60,-3,54,15
701,Fleetwood Town,13,15,18,41,47,-6,54,16
701,Oxford United,13,11,22,46,58,-12,50,17
701,Morecambe,10,14,22,47,73,-26,44,18
701,Cheltenham,11,11,24,34,64,-30,44,19
701,Burton Albion,11,11,24,51,86,-35,44,20
701,Acc'ton Stanley,9,15,22,39,73,-34,42,21
701,Cambridge Utd,11,7,28,39,75,-36,40,22
701,MK Dons,10,8,28,39,77,-38,38,23
701,FG Rovers,7,11,28,34,83,-49,32,24
702,Sheffield Weds,30,11,5,84,36,48,101,1
702,Plymouth Argyle,28,11,7,83,49,34,95,2
702,Derby County,26,10,10,81,42,39,88,3
702,Wycombe,26,9,11,72,38,34,87,4
702,Ipswich Town,23,17,6,76,38,38,86,5
702,Bolton,23,10,13,62,35,27,79,6
702,Portsmouth,22,13,11,71,52,19,79,7
702,Barnsley,23,9,14,64,42,22,78,8
702,P'borough Utd,23,6,17,73,51,22,75,9
702,Fleetwood Town,18,16,12,57,43,14,70,10
702,Lincoln City,13,20,13,44,47,-3,59,11
702,Bristol Rovers,16,11,19,69,75,-6,59,12
702,Charlton Ath,14,16,16,60,62,-2,58,13
702,Shrewsbury,16,10,20,46,48,-2,58,14
702,Exeter City,14,12,20,57,59,-2,54,15
702,Port Vale,14,12,20,48,68,-20,54,16
702,Cheltenham,12,12,22,36,64,-28,48,17
702,Oxford United,12,11,23,47,67,-20,47,18
702,Acc'ton Stanley,11,11,24,42,73,-31,44,19
702,Burton Albion,11,11,24,50,87,-37,44,20
702,MK Dons,11,10,25,43,72,-29,43,21
702,Morecambe,9,15,22,42,68,-26,42,22
702,Cambridge Utd,9,9,28,35,78,-43,36,23
702,FG Rovers,7,10,29,35,83,-48,31,24
703,Plymouth Argyle,28,11,7,96,53,43,95,1
703,Sheffield Weds,27,13,6,74,34,40,94,2
703,Ipswich Town,24,16,6,90,44,46,88,3
703,Derby County,25,12,9,81,43,38,87,4
703,Barnsley,26,9,11,68,39,29,87,5
703,Wycombe,25,8,13,63,44,19,83,6
703,Bolton,21,12,13,64,39,25,75,7
703,P'borough Utd,22,5,19,77,60,17,71,8
703,Portsmouth,18,16,12,67,52,15,70,9
703,Shrewsbury,20,9,17,59,53,6,69,10
703,Fleetwood Town,16,16,14,46,41,5,64,11
703,Charlton Ath,16,15,15,64,63,1,63,12
703,Exeter City,16,12,18,62,62,0,60,13
703,Lincoln City,13,20,13,44,45,-1,59,14
703,Oxford United,14,12,20,45,52,-7,54,15
703,Port Vale,15,9,22,45,65,-20,54,16
703,Bristol Rovers,14,11,21,62,81,-19,53,17
703,MK Dons,12,12,22,47,63,-16,48,18
703,Burton Albion,11,11,24,55,101,-46,44,19
703,Cambridge Utd,11,9,26,35,74,-39,42,20
703,Cheltenham,10,11,25,33,61,-28,41,21
703,Morecambe,8,15,23,42,73,-31,39,22
703,Acc'ton Stanley,8,14,24,38,74,-36,38,23
703,FG Rovers,8,10,28,38,79,-41,34,24
704,Sheffield Weds,30,12,4,84,29,55,102,1
704,Ipswich Town,25,14,7,86,48,38,89,2
704,Barnsley,27,8,11,75,42,33,89,3
704,Plymouth Argyle,26,11,9,80,51,29,89,4
704,Bolton,25,11,10,71,36,35,86,5
704,Derby County,23,14,9,79,47,32,83,6
704,Wycombe,24,8,14,67,45,22,80,7
704,Portsmouth,22,13,11,77,52,25,79,8
704,P'borough Utd,22,9,15,82,59,23,75,9
704,Fleetwood Town,19,13,14,52,39,13,70,10
704,Shrewsbury,19,9,18,54,52,2,66,11
704,Charlton Ath,14,16,16,62,57,5,58,12
704,Port Vale,16,10,20,48,63,-15,58,13
704,Exeter City,14,13,19,61,62,-1,55,14
704,Burton Albion,14,10,22,60,90,-30,52,15
704,Lincoln City,10,21,15,38,55,-17,51,16
704,Bristol Rovers,14,8,24,62,84,-22,50,17
704,Oxford United,11,14,21,48,60,-12,47,18
704,Cheltenham,11,11,24,37,61,-24,44,19
704,MK Dons,12,7,27,40,64,-24,43,20
704,Acc'ton Stanley,10,13,23,38,75,-37,43,21
704,Morecambe,9,12,25,45,83,-38,39,22
704,Cambridge Utd,9,10,27,40,78,-38,37,23
704,FG Rovers,7,11,28,37,91,-54,32,24
705,Plymouth Argyle,28,10,8,90,54,36,94,1
705,Sheffield Weds,26,14,6,81,39,42,92,2
705,Barnsley,28,7,11,76,38,38,91,3
705,Derby County,24,12,10,78,49,29,84,4
705,Ipswich Town,23,14,9,81,47,34,83,5
705,P'borough Utd,25,6,15,86,55,31,81,6
705,Bolton,23,12,11,66,39,27,81,7
705,Portsmouth,22,14,10,69,46,23,80,8
705,Wycombe,24,6,16,62,43,19,78,9
705,Lincoln City,13,22,11,48,47,1,61,10
705,Shrewsbury,18,7,21,50,55,-5,61,11
705,Fleetwood Town,15,15,16,50,46,4,60,12
705,Port Vale,16,11,19,59,62,-3,59,13
705,Charlton Ath,14,16,16,61,61,0,58,14
705,Bristol Rovers,16,9,21,65,79,-14,57,15
705,Exeter City,14,13,19,60,66,-6,55,16
705,Oxford United,13,13,20,52,65,-13,52,17
705,Burton Albion,11,14,21,57,82,-25,47,18
705,MK Dons,11,11,24,44,68,-24,44,19
705,Morecambe,10,13,23,44,70,-26,43,20
705,Cheltenham,11,9,26,30,68,-38,42,21
705,Acc'ton Stanley,9,14,23,40,74,-34,41,22
705,Cambridge Utd,10,8,28,35,79,-44,38,23
705,FG Rovers,7,12,27,32,84,-52,33,24
706,Sheffield Weds,30,11,5,84,30,54,101,1
706,Barnsley,29,7,10,80,41,39,94,2
706,Derby County,27,10,9,75,38,37,91,3
706,Plymouth Argyle,27,10,9,86,58,28,91,4
706,Bolton,26,10,10,68,33,35,88,5
706,Ipswich Town,23,13,10,81,46,35,82,6
706,Wycombe,25,7,14,65,41,24,82,7
706,P'borough Utd,24,7,15,79,56,23,79,8
706,Portsmouth,18,15,13,66,54,12,69,9
706,Shrewsbury,17,10,19,55,51,4,61,10
706,Charlton Ath,16,13,17,65,62,3,61,11
706,Fleetwood Town,13,17,16,45,48,-3,56,12
706,Port Vale,15,11,20,46,67,-21,56,13
706,Lincoln City,11,21,14,40,46,-6,54,14
706,Exeter City,14,12,20,59,69,-10,54,15
706,Bristol Rovers,14,11,21,64,75,-11,53,16
706,Oxford United,14,10,22,52,61,-9,52,17
706,Cheltenham,14,9,23,38,58,-20,51,18
706,MK Dons,11,11,24,41,62,-21,44,19
706,Morecambe,10,14,22,47,77,-30,44,20
706,Burton Albion,10,14,22,56,94,-38,44,21
706,Acc'ton Stanley,9,14,23,34,73,-39,41,22
706,Cambridge Utd,11,7,28,41,78,-37,40,23
706,FG Rovers,7,10,29,33,82,-49,31,24
707,Sheffield Weds,30,12,4,89,31,58,102,1
707,Ipswich Town,26,14,6,82,38,44,92,2
707,Plymouth Argyle,26,12,8,87,56,31,90,3
707,Barnsley,27,7,12,71,46,25,88,4
707,Bolton,25,11,10,71,34,37,86,5
707,Derby County,24,11,11,73,44,29,83,6
707,Wycombe,25,6,15,63,42,21,81,7
707,P'borough Utd,24,6,16,81,56,25,78,8
707,Shrewsbury,19,10,17,55,49,6,67,9
707,Portsmouth,16,17,13,58,53,5,65,10
707,Lincoln City,14,19,13,46,47,-1,61,11
707,Fleetwood Town,14,15,17,47,47,0,57,12
707,Port Vale,15,12,19,45,60,-15,57,13
707,Bristol Rovers,14,10,22,63,82,-19,52,14
707,Oxford United,11,17,18,45,54,-9,50,15
707,Charlton Ath,12,14,20,52,64,-12,50,16
707,Cheltenham,13,11,22,40,57,-17,50,17
707,MK Dons,14,7,25,45,67,-22,49,18
707,Acc'ton Stanley,11,16,19,41,70,-29,49,19
707,Exeter City,13,9,24,53,69,-16,48,20
707,Morecambe,12,12,22,48,71,-23,48,21
707,Burton Albion,11,11,24,54,85,-31,44,22
707,Cambridge Utd,9,11,26,37,73,-36,38,23
707,FG Rovers,6,12,28,33,84,-51,30,24
708,Sheffield Weds,29,12,5,88,34,54,99,1
708,Plymouth Argyle,29,11,6,88,48,40,98,2
708,Barnsley,28,7,11,70,42,28,91,3
708,Ipswich Town,26,12,8,85,43,42,90,4
708,Bolton,26,9,11,68,33,35,87,5
708,Derby County,24,13,9,75,38,37,85,6
708,P'borough Utd,22,8,16,79,56,23,74,7
708,Wycombe,22,8,16,63,44,19,74,8
708,Portsmouth,19,15,12,64,52,12,72,9
708,Shrewsbury,18,11,17,52,50,2,65,10
708,Port Vale,17,8,21,46,60,-14,59,11
708,Charlton Ath,15,13,18,68,67,1,58,12
708,Lincoln City,13,18,15,43,49,-6,57,13
708,Bristol Rovers,15,12,19,61,74,-13,57,14
708,Exeter City,14,10,22,54,72,-18,52,15
708,Cheltenham,14,9,23,40,64,-24,51,16
708,Fleetwood Town,11,17,18,42,52,-10,50,17
708,MK Dons,13,10,23,48,67,-19,49,18
708,Oxford United,13,9,24,42,60,-18,48,19
708,Morecambe,12,12,22,51,71,-20,48,20
708,Cambridge Utd,10,11,25,37,72,-35,41,21
708,Burton Albion,10,11,25,54,91,-37,41,22
708,Acc'ton Stanley,9,13,24,38,78,-40,40,23
708,FG Rovers,7,13,26,39,78,-39,34,24
709,Sheffield Weds,31,11,4,78,28,50,104,1
709,Plymouth Argyle,28,9,9,88,55,33,93,2
709,Ipswich Town,25,16,5,84,39,45,91,3
709,Barnsley,26,11,9,74,38,36,89,4
709,Derby County,24,11,11,72,40,32,83,5
709,Wycombe,22,9,15,61,47,14,75,6
709,Bolton,21,10,15,61,42,19,73,7
709,P'borough Utd,20,7,19,70,60,10,67,8
709,Fleetwood Town,18,13,15,58,50,8,67,9
709,Shrewsbury,19,9,18,48,45,3,66,10
709,Portsmouth,16,17,13,56,57,-1,65,11
709,Charlton Ath,14,18,14,61,59,2,60,12
709,Lincoln City,11,25,10,45,44,1,58,13
709,Exeter City,15,11,20,59,59,0,56,14
709,Port Vale,15,10,21,48,64,-16,55,15
709,Bristol Rovers,13,11,22,64,82,-18,50,16
709,Acc'ton Stanley,11,16,19,40,62,-22,49,17
709,Cheltenham,14,7,25,37,63,-26,49,18
709,Oxford United,12,12,22,45,61,-16,48,19
709,Morecambe,11,14,21,43,65,-22,47,20
709,Burton Albion,10,14,22,50,85,-35,44,21
709,Cambridge Utd,11,9,26,43,71,-28,42,22
709,MK Dons,10,10,26,40,66,-26,40,23
709,FG Rovers,9,12,25,35,78,-43,39,24
710,Sheffield Weds,32,10,4,92,29,63,106,1
710,Plymouth Argyle,28,10,8,81,47,34,94,2
710,Ipswich Town,25,13,8,80,42,38,88,3
710,Barnsley,26,8,12,67,42,25,86,4
710,Derby County,23,12,11,74,44,30,81,5
710,Bolton,21,12,13,67,41,26,75,6
710,Wycombe,22,9,15,61,41,20,75,7
710,Charlton Ath,20,12,14,65,56,9,72,8
710,P'borough Utd,22,4,20,79,63,16,70,9
710,Portsmouth,18,16,12,65,52,13,70,10
710,Shrewsbury,20,8,18,57,53,4,68,11
710,Fleetwood Town,16,17,13,59,44,15,65,12
710,Lincoln City,14,19,13,45,50,-5,61,13
710,Exeter City,16,10,20,61,62,-1,58,14
710,Bristol Rovers,15,10,21,70,78,-8,55,15
710,Burton Albion,15,9,22,61,84,-23,54,16
710,Port Vale,15,9,22,44,68,-24,54,17
710,Oxford United,13,12,21,45,60,-15,51,18
710,MK Dons,12,7,27,46,75,-29,43,19
710,Acc'ton Stanley,10,13,23,40,70,-30,43,20
710,Cambridge Utd,11,10,25,38,73,-35,43,21
710,Morecambe,10,12,24,48,76,-28,42,22
710,Cheltenham,11,9,26,36,65,-29,42,23
710,FG Rovers,6,11,29,32,98,-66,29,24
711,Sheffield Weds,28,10,8,80,34,46,94,1
711,Plymouth Argyle,27,11,8,93,58,35,92,2
711,Derby County,26,11,9,82,41,41,89,3
711,Ipswich Town,24,16,6,79,36,43,88,4
711,Barnsley,25,10,11,74,43,31,85,5
711,Bolton,23,11,12,69,38,31,80,6
711,Shrewsbury,22,9,15,59,47,12,75,7
711,Portsmouth,20,14,12,64,48,16,74,8
711,Wycombe,21,10,15,61,46,15,73,9
711,P'borough Utd,21,7,18,76,62,14,70,10
711,Charlton Ath,17,13,16,70,57,13,64,11
711,Fleetwood Town,15,15,16,51,51,0,60,12
711,Bristol Rovers,16,12,18,74,84,-10,60,13
711,Lincoln City,12,21,13,42,49,-7,57,14
711,Exeter City,14,13,19,54,55,-1,55,15
711,Port Vale,15,10,21,50,69,-19,55,16
711,Cheltenham,15,7,24,39,63,-24,52,17
711,Burton Albion,14,10,22,56,90,-34,52,18
711,Oxford United,13,11,22,46,57,-11,50,19
711,Acc'ton Stanley,12,13,21,38,64,-26,49,20
711,Morecambe,11,13,22,49,74,-25,46,21
711,MK Dons,10,8,28,42,81,-39,38,22
711,Cambridge Utd,10,6,30,39,81,-42,36,23
711,FG Rovers,6,9,31,32,91,-59,27,24
712,Sheffield Weds,30,13,3,89,27,62,103,1
712,Barnsley,26,10,10,73,38,35,88,2
712,Plymouth Argyle,26,10,10,86,64,22,88,3
712,Derby County,25,12,9,80,41,39,87,4
712,Ipswich Town,23,15,8,84,52,32,84,5
712,Bolton,24,11,11,63,34,29,83,6
712,Wycombe,23,9,14,71,46,25,78,7
712,P'borough Utd,23,6,17,71,57,14,75,8
712,Portsmouth,19,16,11,64,47,17,73,9
712,Fleetwood Town,16,16,14,52,40,12,64,10
712,Lincoln City,14,22,10,47,50,-3,64,11
712,Charlton Ath,15,15,16,65,58,7,60,12
712,Shrewsbury,16,12,18,50,49,1,60,13
712,Exeter City,15,12,19,59,61,-2,57,14
712,Port Vale,15,10,21,48,59,-11,55,15
712,Morecambe,13,12,21,48,68,-20,51,16
712,Oxford United,13,11,22,49,61,-12,50,17
712,Bristol Rovers,12,12,22,63,80,-17,48,18
712,Cheltenham,12,11,23,36,63,-27,47,19
712,Cambridge Utd,13,6,27,37,71,-34,45,20
712,Burton Albion,11,10,25,51,96,-45,43,21
712,Acc'ton Stanley,9,14,23,40,81,-41,41,22
712,MK Dons,10,8,28,43,73,-30,38,23
712,FG Rovers,7,11,28,35,88,-53,32,24
713,Sheffield Weds,31,10,5,91,36,55,103,1
713,Plymouth Argyle,29,9,8,97,56,41,96,2
713,Ipswich Town,26,13,7,88,43,45,91,3
713,Barnsley,27,8,11,84,49,35,89,4
713,Derby County,23,13,10,68,35,33,82,5
713,Bolton,24,10,12,68,36,32,82,6
713,Wycombe,24,10,12,68,39,29,82,7
713,Portsmouth,21,14,11,73,54,19,77,8
713,P'borough Utd,22,7,17,72,53,19,73,9
713,Charlton Ath,17,14,15,65,55,10,65,10
713,Shrewsbury,17,10,19,54,56,-2,61,11
713,Fleetwood Town,14,17,15,49,49,0,59,12
713,Lincoln City,13,20,13,46,48,-2,59,13
713,Bristol Rovers,15,11,20,61,78,-17,56,14
713,Port Vale,15,11,20,45,64,-19,56,15
713,Exeter City,13,13,20,55,64,-9,52,16
713,Cheltenham,13,12,21,42,63,-21,51,17
713,Oxford United,12,10,24,46,64,-18,46,18
713,Burton Albion,12,10,24,55,88,-33,46,19
713,Morecambe,10,12,24,46,78,-32,42,20
713,MK Dons,9,14,23,44,70,-26,41,21
713,Acc'ton Stanley,8,16,22,37,75,-38,40,22
713,Cambridge Utd,10,5,31,33,81,-48,35,23
713,FG Rovers,6,13,27,37,90,-53,31,24
714,Sheffield Weds,29,11,6,85,32,53,98,1
714,Barnsley,29,6,11,80,37,43,93,2
714,Ipswich Town,24,16,6,88,44,44,88,3
714,Plymouth Argyle,25,12,9,84,54,30,87,4
714,Bolton,25,11,10,75,39,36,86,5
714,Derby County,24,12,10,75,40,35,84,6
714,Portsmouth,21,14,11,64,50,14,77,7
714,Wycombe,22,7,17,64,52,12,73,8
714,Charlton Ath,19,12,15,73,61,12,69,9
714,P'borough Utd,20,6,20,66,58,8,66,10
714,Fleetwood Town,16,17,13,58,52,6,65,11
714,Shrewsbury,19,8,19,56,57,-1,65,12
714,Exeter City,15,11,20,56,65,-9,56,13
714,Port Vale,15,11,20,44,62,-18,56,14
714,Lincoln City,12,19,15,43,51,-8,55,15
714,Oxford United,15,10,21,50,59,-9,55,16
714,Bristol Rovers,14,12,20,61,75,-14,54,17
714,Burton Albion,14,10,22,59,81,-22,52,18
714,Morecambe,11,13,22,45,71,-26,46,19
714,Acc'ton Stanley,11,13,22,38,75,-37,46,20
714,MK Dons,11,11,24,44,68,-24,44,21
714,Cambridge Utd,12,6,28,40,79,-39,42,22
714,Cheltenham,10,11,25,35,62,-27,41,23
714,FG Rovers,5,9,32,35,94,-59,24,24
715,Sheffield Weds,28,14,4,80,27,53,98,1
715,Plymouth Argyle,29,11,6,104,52,52,98,2
715,Barnsley,31,5,10,77,42,35,98,3
715,Ipswich Town,24,16,6,83,45,38,88,4
715,Bolton,22,11,13,69,39,30,77,5
715,Derby County,21,14,11,69,43,26,77,6
715,Portsmouth,20,15,11,68,52,16,75,7
715,Wycombe,21,10,15,63,43,20,73,8
715,P'borough Utd,22,6,18,70,62,8,72,9
715,Charlton Ath,18,14,14,70,59,11,68,10
715,Fleetwood Town,17,13,16,54,45,9,64,11
715,Lincoln City,14,21,11,46,46,0,63,12
715,Oxford United,15,13,18,53,56,-3,58,13
715,Shrewsbury,16,10,20,51,57,-6,58,14
715,Exeter City,15,10,21,54,66,-12,55,15
715,Bristol Rovers,15,8,23,63,88,-25,53,16
715,Port Vale,13,11,22,44,66,-22,50,17
715,MK Dons,12,9,25,44,67,-23,45,18
715,Burton Albion,12,9,25,52,82,-30,45,19
715,Acc'ton Stanley,10,15,21,44,74,-30,45,20
715,Cambridge Utd,13,6,27,44,78,-34,45,21
715,Cheltenham,11,9,26,35,63,-28,42,22
715,Morecambe,8,15,23,41,74,-33,39,23
715,FG Rovers,8,9,29,36,88,-52,33,24
716,Sheffield Weds,28,13,5,77,31,46,97,1
716,Plymouth Argyle,28,11,7,90,46,44,95,2
716,Barnsley,27,7,12,72,41,31,88,3
716,Wycombe,24,9,13,67,42,25,81,4
716,Ipswich Town,22,14,10,78,46,32,80,5
716,Bolton,23,11,12,60,35,25,80,6
716,Portsmouth,21,16,9,72,46,26,79,7
716,Derby County,22,12,12,69,43,26,78,8
716,P'borough Utd,24,6,16,74,52,22,78,9
716,Charlton Ath,16,16,14,63,57,6,64,10
716,Fleetwood Town,15,15,16,53,51,2,60,11
716,Shrewsbury,16,11,19,52,53,-1,59,12
716,Lincoln City,13,20,13,42,50,-8,59,13
716,Cheltenham,17,7,22,42,57,-15,58,14
716,Oxford United,15,11,20,48,54,-6,56,15
716,Bristol Rovers,15,10,21,66,84,-18,55,16
716,Exeter City,13,12,21,53,60,-7,51,17
716,Port Vale,13,11,22,41,64,-23,50,18
716,Burton Albion,13,11,22,54,84,-30,50,19
716,Acc'ton Stanley,10,16,20,41,63,-22,46,20
716,MK Dons,12,9,25,42,68,-26,45,21
716,Morecambe,9,13,24,41,75,-34,40,22
716,Cambridge Utd,11,7,28,36,75,-39,40,23
716,FG Rovers,6,10,30,35,91,-56,28,24
717,Sheffield Weds,29,11,6,80,33,47,98,1
717,Barnsley,30,7,9,79,34,45,97,2
717,Derby County,26,12,8,74,41,33,90,3
717,Ipswich Town,24,17,5,90,46,44,89,4
717,Plymouth Argyle,26,11,9,74,49,25,89,5
717,Bolton,22,12,12,63,39,24,78,6
717,Portsmouth,21,14,11,69,48,21,77,7
717,P'borough Utd,24,5,17,79,60,19,77,8
717,Wycombe,21,9,16,58,44,14,72,9
717,Shrewsbury,20,9,17,61,52,9,69,10
717,Fleetwood Town,14,17,15,45,43,2,59,11
717,Lincoln City,12,23,11,43,45,-2,59,12
717,Port Vale,17,8,21,53,62,-9,59,13
717,Exeter City,15,13,18,59,63,-4,58,14
717,Charlton Ath,15,12,19,64,63,1,57,15
717,Oxford United,13,13,20,44,55,-11,52,16
717,Bristol Rovers,13,10,23,58,78,-20,49,17
717,Cambridge Utd,13,7,26,40,70,-30,46,18
717,Cheltenham,12,10,24,31,61,-30,46,19
717,Burton Albion,11,12,23,55,87,-32,45,20
717,MK Dons,9,12,25,40,68,-28,39,21
717,Morecambe,9,11,26,42,77,-35,38,22
717,Acc'ton Stanley,8,14,24,35,74,-39,38,23
717,FG Rovers,8,11,27,37,81,-44,35,24
718,Sheffield Weds,29,11,6,80,35,45,98,1
718,Barnsley,29,7,10,73,41,32,94,2
718,Derby County,27,11,8,81,37,44,92,3
718,Bolton,26,9,11,70,36,34,87,4
718,Plymouth Argyle,26,9,11,85,57,28,87,5
718,Wycombe,26,7,13,74,43,31,85,6
718,Ipswich Town,22,15,9,80,47,33,81,7
718,P'borough Utd,22,8,16,77,59,18,74,8
718,Portsmouth,17,15,14,70,59,11,66,9
718,Port Vale,18,9,19,62,68,-6,63,10
718,Shrewsbury,18,8,20,54,53,1,62,11
718,Charlton Ath,15,16,15,62,56,6,61,12
718,Fleetwood Town,16,13,17,57,52,5,61,13
718,Exeter City,15,10,21,58,63,-5,55,14
718,Lincoln City,11,20,15,41,52,-11,53,15
718,Bristol Rovers,14,10,22,62,93,-31,52,16
718,Oxford United,13,11,22,50,60,-10,50,17
718,MK Dons,14,8,24,56,75,-19,50,18
718,Cheltenham,13,10,23,32,58,-26,49,19
718,Acc'ton Stanley,11,13,22,44,78,-34,46,20
718,Burton Albion,11,12,23,61,88,-27,45,21
718,Morecambe,10,13,23,43,73,-30,43,22
718,Cambridge Utd,11,9,26,39,73,-34,42,23
718,FG Rovers,7,8,31,36,91,-55,29,24
719,Plymouth Argyle,31,9,6,86,45,41,102,1
719,Sheffield Weds,28,12,6,76,29,47,96,2
719,Ipswich Town,24,16,6,88,43,45,88,3
719,Derby County,25,12,9,78,41,37,87,4
719,Barnsley,24,9,13,66,40,26,81,5
719,Wycombe,24,8,14,67,41,26,80,6
719,Bolton,24,8,14,63,39,24,80,7
719,Portsmouth,19,14,13,63,53,10,71,8
719,P'borough Utd,20,6,20,64,57,7,66,9
719,Shrewsbury,18,10,18,51,52,-1,64,10
719,Lincoln City,14,21,11,45,45,0,63,11
719,Fleetwood Town,16,12,18,57,54,3,60,12
719,Exeter City,16,12,18,55,54,1,60,13
719,Charlton Ath,14,15,17,67,68,-1,57,14
719,Bristol Rovers,15,12,19,66,74,-8,57,15
719,Port Vale,15,10,21,48,62,-14,55,16
719,Cheltenham,14,10,22,37,58,-21,52,17
719,Acc'ton Stanley,13,13,20,36,62,-26,52,18
719,Burton Albion,13,10,23,57,84,-27,49,19
719,Oxford United,11,13,22,46,64,-18,46,20
719,Morecambe,11,11,24,46,75,-29,44,21
719,Cambridge Utd,12,7,27,43,68,-25,43,22
719,MK Dons,11,8,27,40,75,-35,41,23
719,FG Rovers,6,10,30,33,95,-62,28,24
720,Sheffield Weds,28,11,7,79,36,43,95,1
720,Plymouth Argyle,28,11,7,91,54,37,95,2
720,Derby County,25,13,8,80,40,40,88,3
720,Bolton,26,9,11,69,36,33,87,4
720,Barnsley,27,6,13,75,48,27,87,5
720,Ipswich Town,23,15,8,84,47,37,84,6
720,Wycombe,24,8,14,64,41,23,80,7
720,P'borough Utd,22,9,15,85,59,26,75,8
720,Portsmouth,17,18,11,65,53,12,69,9
720,Charlton Ath,17,14,15,70,58,12,65,10
720,Shrewsbury,17,11,18,54,54,0,62,11
720,Lincoln City,13,21,12,40,48,-8,60,12
720,Fleetwood Town,15,13,18,49,52,-3,58,13
720,Port Vale,16,10,20,50,65,-15,58,14
720,Bristol Rovers,15,11,20,63,78,-15,56,15
720,Exeter City,15,10,21,61,68,-7,55,16
720,Oxford United,13,11,22,49,62,-13,50,17
720,Morecambe,12,13,21,47,68,-21,49,18
720,Acc'ton Stanley,11,13,22,44,75,-31,46,19
720,Cheltenham,10,13,23,35,62,-27,43,20
720,Cambridge Utd,12,7,27,38,70,-32,43,21
720,Burton Albion,11,9,26,47,85,-38,42,22
720,MK Dons,10,10,26,41,69,-28,40,23
720,FG Rovers,6,12,28,31,83,-52,30,24
721,Sheffield Weds,33,8,5,91,31,60,107,1
721,Plymouth Argyle,27,8,11,79,56,23,89,2
721,Bolton,25,11,10,67,34,33,86,3
721,Derby County,24,11,11,77,45,32,83,4
721,Barnsley,25,8,13,71,50,21,83,5
721,Wycombe,25,6,15,64,42,22,81,6
721,Ipswich Town,22,14,10,75,47,28,80,7
721,Portsmouth,20,15,11,70,52,18,75,8
721,P'borough Utd,21,6,19,75,61,14,69,9
721,Lincoln City,16,20,10,47,44,3,68,10
721,Shrewsbury,18,13,15,59,52,7,67,11
721,Charlton Ath,17,12,17,64,61,3,63,12
721,Exeter City,17,11,18,66,60,6,62,13
721,Fleetwood Town,15,16,15,47,42,5,61,14
721,Port Vale,17,10,19,51,58,-7,61,15
721,Bristol Rovers,15,10,21,65,78,-13,55,16
721,Oxford United,13,12,21,48,61,-13,51,17
721,Acc'ton Stanley,11,14,21,39,64,-25,47,18
721,Cheltenham,11,12,23,33,58,-25,45,19
721,Burton Albion,12,9,25,56,90,-34,45,20
721,Morecambe,10,14,22,47,72,-25,44,21
721,MK Dons,11,9,26,37,71,-34,42,22
721,Cambridge Utd,9,8,29,33,75,-42,35,23
721,FG Rovers,5,9,32,34,91,-57,24,24
722,Plymouth Argyle,29,11,6,92,49,43,98,1
722,Sheffield Weds,27,13,6,76,32,44,94,2
722,Derby County,25,13,8,78,38,40,88,3
722,Ipswich Town,23,14,9,78,46,32,83,4
722,Barnsley,24,10,12,61,38,23,82,5
722,Bolton,23,10,13,67,39,28,79,6
722,Portsmouth,21,15,10,71,45,26,78,7
722,Wycombe,24,6,16,64,42,22,78,8
722,Shrewsbury,21,8,17,57,49,8,71,9
722,P'borough Utd,20,7,19,73,57,16,67,10
722,Charlton Ath,18,11,17,66,57,9,65,11
722,Fleetwood Town,16,16,14,52,46,6,64,12
722,Exeter City,17,11,18,57,61,-4,62,13
722,Lincoln City,13,20,13,45,45,0,59,14
722,Port Vale,15,10,21,48,65,-17,55,15
722,Oxford United,14,12,20,49,55,-6,54,16
722,Bristol Rovers,12,12,22,59,83,-24,48,17
722,Cheltenham,13,9,24,37,62,-25,48,18
722,Burton Albion,12,11,23,59,90,-31,47,19
722,Acc'ton Stanley,11,12,23,41,79,-38,45,20
722,MK Dons,11,11,24,43,68,-25,44,21
722,Morecambe,9,12,25,45,83,-38,39,22
722,FG Rovers,9,11,26,35,79,-44,38,23
722,Cambridge Utd,9,7,30,38,83,-45,34,24
723,Sheffield Weds,28,13,5,77,31,46,97,1
723,Plymouth Argyle,29,10,7,83,49,34,97,2
723,Bolton,25,11,10,69,35,34,86,3
723,Barnsley,25,10,11,71,41,30,85,4
723,Ipswich Town,23,15,8,85,45,40,84,5
723,Wycombe,25,9,12,66,39,27,84,6
723,Derby County,23,11,12,75,45,30,80,7
723,P'borough Utd,23,5,18,74,53,21,74,8
723,Shrewsbury,21,9,16,57,47,10,72,9
723,Portsmouth,17,16,13,65,53,12,67,10
723,Charlton Ath,17,13,16,66,58,8,64,11
723,Fleetwood Town,15,18,13,49,44,5,63,12
723,Exeter City,15,13,18,61,59,2,58,13
723,Port Vale,14,13,19,48,65,-17,55,14
723,Oxford United,13,13,20,49,58,-9,52,15
723,Lincoln City,10,20,16,38,54,-16,50,16
723,Burton Albion,13,10,23,55,79,-24,49,17
723,Bristol Rovers,13,10,23,56,85,-29,49,18
723,MK Dons,12,9,25,40,65,-25,45,19
723,Morecambe,11,11,24,46,73,-27,44,20
723,Acc'ton Stanley,10,13,23,41,72,-31,43,21
723,Cheltenham,11,10,25,34,69,-35,43,22
723,Cambridge Utd,12,5,29,36,76,-40,41,23
723,FG Rovers,8,11,27,38,84,-46,35,24
724,Sheffield Weds,29,13,4,87,37,50,100,1
724,Plymouth Argyle,28,10,8,91,46,45,94,2
724,Ipswich Town,27,13,6,88,45,43,94,3
724,Derby County,24,14,8,76,41,35,86,4
724,Barnsley,25,8,13,75,49,26,83,5
724,Bolton,24,9,13,64,37,27,81,6
724,P'borough Utd,23,4,19,75,55,20,73,7
724,Portsmouth,18,16,12,66,53,13,70,8
724,Shrewsbury,20,8,18,56,53,3,68,9
724,Wycombe,18,9,19,58,53,5,63,10
724,Fleetwood Town,17,12,17,55,51,4,63,11
724,Exeter City,18,9,19,61,60,1,63,12
724,Lincoln City,14,21,11,42,47,-5,63,13
724,Charlton Ath,16,14,16,67,56,11,62,14
724,Port Vale,17,11,18,56,64,-8,62,15
724,Bristol Rovers,14,10,22,66,89,-23,52,16
724,Oxford United,12,12,22,45,59,-14,48,17
724,Burton Albion,13,9,24,53,84,-31,48,18
724,MK Dons,13,8,25,41,67,-26,47,19
724,Cambridge Utd,13,5,28,38,75,-37,44,20
724,Morecambe,10,13,23,43,68,-25,43,21
724,Cheltenham,11,9,26,31,62,-31,42,22
724,Acc'ton Stanley,10,12,24,35,75,-40,42,23
724,FG Rovers,8,11,27,37,80,-43,35,24
725,Sheffield Weds,30,12,4,78,29,49,102,1
725,Plymouth Argyle,29,10,7,91,53,38,97,2
725,Barnsley,27,10,9,73,38,35,91,3
725,Bolton,26,11,9,70,31,39,89,4
725,Ipswich Town,25,14,7,79,44,35,89,5
725,Derby County,22,14,10,77,45,32,80,6
725,Portsmouth,21,13,12,72,52,20,76,7
725,P'borough Utd,22,6,18,72,57,15,72,8
725,Wycombe,20,10,16,65,49,16,70,9
725,Charlton Ath,18,12,16,70,59,11,66,10
725,Shrewsbury,18,10,18,54,48,6,64,11
725,Lincoln City,12,25,9,47,46,1,61,12
725,Bristol Rovers,16,13,17,71,77,-6,61,13
725,Fleetwood Town,13,15,18,45,50,-5,54,14
725,Oxford United,14,12,20,50,63,-13,54,15
725,Exeter City,12,15,19,57,60,-3,51,16
725,Port Vale,13,10,23,46,74,-28,49,17
725,Cheltenham,13,8,25,37,69,-32,47,18
725,Cambridge Utd,12,9,25,39,67,-28,45,19
725,Burton Albion,11,12,23,56,89,-33,45,20
725,MK Dons,11,8,27,42,72,-30,41,21
725,Acc'ton Stanley,9,12,25,37,72,-35,39,22
725,Morecambe,8,12,26,43,83,-40,36,23
725,FG Rovers,9,9,28,38,82,-44,36,24
726,Sheffield Weds,32,10,4,89,29,60,106,1
726,Plymouth Argyle,29,11,6,85,47,38,98,2
726,Ipswich Town,25,14,7,85,44,41,89,3
726,Barnsley,26,8,12,75,45,30,86,4
726,Bolton,24,10,12,70,39,31,82,5
726,Wycombe,25,7,14,70,43,27,82,6
726,Derby County,23,12,11,76,47,29,81,7
726,Portsmouth,19,14,13,68,55,13,71,8
726,P'borough Utd,21,7,18,65,57,8,70,9
726,Fleetwood Town,16,16,14,52,44,8,64,10
726,Bristol Rovers,17,10,19,74,80,-6,61,11
726,Charlton Ath,15,15,16,60,59,1,60,12
726,Lincoln City,12,22,12,44,51,-7,58,13
726,Shrewsbury,16,8,22,46,54,-8,56,14
726,Exeter City,14,12,20,57,69,-12,54,15
726,Burton Albion,13,13,20,64,82,-18,52,16
726,Morecambe,11,16,19,46,69,-23,49,17
726,Port Vale,12,11,23,42,65,-23,47,18
726,Oxford United,11,13,22,47,63,-16,46,19
726,MK Dons,12,9,25,45,71,-26,45,20
726,Acc'ton Stanley,10,12,24,37,70,-33,42,21
726,Cheltenham,10,11,25,31,63,-32,41,22
726,FG Rovers,10,9,27,42,85,-43,39,23
726,Cambridge Utd,9,10,27,38,77,-39,37,24
727,Sheffield Weds,33,9,4,95,26,69,108,1
727,Plymouth Argyle,29,11,6,88,47,41,98,2
727,Barnsley,28,7,11,75,43,32,91,3
727,Ipswich Town,25,14,7,88,46,42,89,4
727,Derby County,26,11,9,79,41,38,89,5
727,Bolton,25,9,12,69,34,35,84,6
727,Wycombe,23,12,11,59,36,23,81,7
727,P'borough Utd,24,6,16,76,54,22,78,8
727,Portsmouth,17,17,12,68,52,16,68,9
727,Shrewsbury,19,8,19,55,53,2,65,10
727,Fleetwood Town,15,17,14,52,43,9,62,11
727,Lincoln City,13,22,11,45,45,0,61,12
727,Charlton Ath,15,14,17,58,63,-5,59,13
727,Bristol Rovers,15,10,21,63,79,-16,55,14
727,Exeter City,15,9,22,52,63,-11,54,15
727,Port Vale,14,12,20,46,67,-21,54,16
727,Burton Albion,11,13,22,52,86,-34,46,17
727,Oxford United,11,12,23,42,64,-22,45,18
727,Acc'ton Stanley,10,14,22,40,66,-26,44,19
727,MK Dons,11,8,27,40,67,-27,41,20
727,Morecambe,9,12,25,42,81,-39,39,21
727,Cambridge Utd,10,8,28,36,76,-40,38,22
727,Cheltenham,9,10,27,30,68,-38,37,23
727,FG Rovers,7,11,28,33,83,-50,32,24
728,Sheffield Weds,28,12,6,81,34,47,96,1
728,Ipswich Town,26,16,4,87,39,48,94,2
728,Plymouth Argyle,27,9,10,79,50,29,90,3
728,Barnsley,26,6,14,71,38,33,84,4
728,Derby County,24,12,10,71,39,32,84,5
728,Bolton,21,14,11,64,39,25,77,6
728,Wycombe,21,13,12,65,39,26,76,7
728,Portsmouth,19,16,11,65,44,21,73,8
728,P'borough Utd,22,7,17,80,60,20,73,9
728,Fleetwood Town,18,17,11,53,38,15,71,10
728,Shrewsbury,19,11,16,54,45,9,68,11
728,Charlton Ath,16,16,14,66,57,9,64,12
728,Port Vale,17,8,21,49,58,-9,59,13
728,Lincoln City,12,21,13,40,44,-4,57,14
728,Bristol Rovers,14,14,18,61,77,-16,56,15
728,Exeter City,12,13,21,52,61,-9,49,16
728,Acc'ton Stanley,12,13,21,39,70,-31,49,17
728,Morecambe,11,15,20,42,63,-21,48,18
728,Burton Albion,12,11,23,56,90,-34,47,19
728,Oxford United,11,13,22,41,59,-18,46,20
728,MK Dons,11,8,27,46,81,-35,41,21
728,Cheltenham,10,10,26,34,66,-32,40,22
728,Cambridge Utd,10,7,29,31,80,-49,37,23
728,FG Rovers,5,14,27,33,89,-56,29,24
729,Sheffield Weds,31,9,6,90,34,56,102,1
729,Barnsley,28,9,9,83,41,42,93,2
729,Ipswich Town,24,15,7,81,43,38,87,3
729,Derby County,25,11,10,77,44,33,86,4
729,Plymouth Argyle,25,11,10,79,57,22,86,5
729,Wycombe,24,8,14,71,42,29,80,6
729,Bolton,21,12,13,63,39,24,75,7
729,Shrewsbury,20,9,17,51,46,5,69,8
729,P'borough Utd,20,8,18,71,59,12,68,9
729,Fleetwood Town,18,14,14,55,46,9,68,10
729,Charlton Ath,18,11,17,66,58,8,65,11
729,Portsmouth,17,14,15,60,57,3,65,12
729,Exeter City,17,11,18,64,63,1,62,13
729,Port Vale,17,11,18,53,65,-12,62,14
729,Lincoln City,12,19,15,41,53,-12,55,15
729,Bristol Rovers,13,13,20,59,82,-23,52,16
729,Cheltenham,13,9,24,37,58,-21,48,17
729,Acc'ton Stanley,12,11,23,40,68,-28,47,18
729,Cambridge Utd,13,8,25,40,69,-29,47,19
729,Burton Albion,12,9,25,57,91,-34,45,20
729,Morecambe,10,14,22,43,70,-27,44,21
729,Oxford United,10,12,24,47,70,-23,42,22
729,MK Dons,10,9,27,37,68,-31,39,23
729,FG Rovers,8,11,27,38,80,-42,35,24
730,Sheffield Weds,31,11,4,86,32,54,104,1
730,Plymouth Argyle,28,12,6,84,48,36,96,2
730,Ipswich Town,26,15,5,92,43,49,93,3
730,Derby County,23,15,8,77,41,36,84,4
730,Barnsley,24,10,12,64,37,27,82,5
730,Wycombe,24,8,14,66,49,17,80,6
730,Bolton,22,13,11,64,39,25,79,7
730,Portsmouth,18,17,11,59,49,10,71,8
730,P'borough Utd,22,4,20,76,64,12,70,9
730,Charlton Ath,18,14,14,76,56,20,68,10
730,Shrewsbury,17,10,19,51,55,-4,61,11
730,Lincoln City,13,21,12,43,45,-2,60,12
730,Bristol Rovers,15,12,19,65,76,-11,57,13
730,Exeter City,14,14,18,61,63,-2,56,14
730,Fleetwood Town,13,16,17,47,48,-1,55,15
730,Port Vale,15,8,23,40,66,-26,53,16
730,Cheltenham,13,11,22,40,59,-19,50,17
730,Acc'ton Stanley,11,15,20,40,67,-27,48,18
730,Oxford United,12,10,24,45,63,-18,46,19
730,MK Dons,12,10,24,44,66,-22,46,20
730,Burton Albion,11,12,23,52,89,-37,45,21
730,Morecambe,8,15,23,42,70,-28,39,22
730,Cambridge Utd,9,11,26,32,69,-37,38,23
730,FG Rovers,5,12,29,31,83,-52,27,24
731,Plymouth Argyle,30,10,6,89,48,41,100,1
731,Sheffield Weds,29,12,5,80,29,51,99,2
731,Barnsley,29,7,10,85,38,47,94,3
731,Derby County,25,11,10,74,37,37,86,4
731,Ipswich Town,23,14,9,85,46,39,83,5
731,Portsmouth,22,13,11,69,49,20,79,6
731,Bolton,23,9,14,66,44,22,78,7
731,P'borough Utd,22,8,16,80,63,17,74,8
731,Wycombe,21,7,18,59,52,7,70,9
731,Shrewsbury,19,11,16,57,53,4,68,10
731,Exeter City,17,11,18,63,60,3,62,11
731,Lincoln City,14,19,13,48,46,2,61,12
731,Port Vale,17,10,19,54,64,-10,61,13
731,Bristol Rovers,16,10,20,71,81,-10,58,14
731,Burton Albion,15,10,21,62,84,-22,55,15
731,Fleetwood Town,12,17,17,44,49,-5,53,16
731,Charlton Ath,13,13,20,59,67,-8,52,17
731,Cheltenham,13,12,21,35,56,-21,51,18
731,Oxford United,12,12,22,50,63,-13,48,19
731,Acc'ton Stanley,10,13,23,38,76,-38,43,20
731,Morecambe,10,12,24,48,74,-26,42,21
731,MK Dons,10,10,26,39,73,-34,40,22
731,Cambridge Utd,11,7,28,37,75,-38,40,23
731,FG Rovers,5,10,31,29,94,-65,25,24
732,Sheffield Weds,31,10,5,81,25,56,103,1
732,Plymouth Argyle,26,10,10,81,56,25,88,2
732,Ipswich Town,24,13,9,88,44,44,85,3
732,Bolton,25,10,11,64,32,32,85,4
732,Wycombe,25,9,12,67,35,32,84,5
732,Barnsley,24,10,12,67,42,25,82,6
732,Derby County,23,12,11,73,41,32,81,7
732,P'borough Utd,25,6,15,81,58,23,81,8
732,Portsmouth,18,15,13,65,53,12,69,9
732,Charlton Ath,18,13,15,65,58,7,67,10
732,Fleetwood Town,16,16,14,52,46,6,64,11
732,Shrewsbury,17,11,18,51,51,0,62,12
732,Exeter City,16,12,18,57,60,-3,60,13
732,Lincoln City,12,22,12,44,44,0,58,14
732,Port Vale,14,12,20,43,69,-26,54,15
732,Bristol Rovers,13,14,19,64,77,-13,53,16
732,Cheltenham,14,8,24,35,62,-27,50,17
732,Burton Albion,11,14,21,57,84,-27,47,18
732,Oxford United,11,12,23,43,60,-17,45,19
732,Cambridge Utd,12,7,27,40,78,-38,43,20
732,MK Dons,11,9,26,45,68,-23,42,21
732,Morecambe,9,15,22,40,71,-31,42,22
732,Acc'ton Stanley,8,14,24,30,67,-37,38,23
732,FG Rovers,7,10,29,35,87,-52,31,24
733,Sheffield Weds,31,12,3,86,34,52,105,1
733,Plymouth Argyle,29,10,7,82,51,31,97,2
733,Ipswich Town,26,15,5,81,40,41,93,3
733,Barnsley,25,11,10,72,42,30,86,4
733,Bolton,24,10,12,72,37,35,82,5
733,P'borough Utd,24,4,18,88,56,32,76,6
733,Derby County,21,13,12,68,45,23,76,7
733,Portsmouth,19,16,11,63,47,16,73,8
733,Wycombe,20,10,16,60,49,11,70,9
733,Charlton Ath,17,14,15,67,59,8,65,10
733,Shrewsbury,18,11,17,50,54,-4,65,11
733,Fleetwood Town,14,17,15,49,47,2,59,12
733,Lincoln City,13,20,13,46,49,-3,59,13
733,Exeter City,15,9,22,59,65,-6,54,14
733,Bristol Rovers,14,12,20,60,79,-19,54,15
733,Port Vale,15,8,23,51,70,-19,53,16
733,Oxford United,13,11,22,51,61,-10,50,17
733,Morecambe,12,12,22,48,68,-20,48,18
733,Burton Albion,12,11,23,54,82,-28,47,19
733,Cheltenham,12,10,24,36,64,-28,46,20
733,MK Dons,10,13,23,46,69,-23,43,21
733,Cambridge Utd,11,9,26,42,75,-33,42,22
733,Acc'ton Stanley,9,12,25,40,85,-45,39,23
733,FG Rovers,7,12,27,38,81,-43,33,24
734,Sheffield Weds,28,13,5,78,35,43,97,1
734,Plymouth Argyle,29,9,8,87,48,39,96,2
734,Bolton,26,9,11,73,36,37,87,3
734,Derby County,24,12,10,79,41,38,84,4
734,Wycombe,26,6,14,66,41,25,84,5
734,Ipswich Town,22,17,7,76,41,35,83,6
734,Barnsley,23,10,13,72,44,28,79,7
734,Portsmouth,19,16,11,62,47,15,73,8
734,P'borough Utd,23,3,20,78,54,24,72,9
734,Charlton Ath,19,13,14,67,56,11,70,10
734,Shrewsbury,19,11,16,57,48,9,68,11
734,Fleetwood Town,15,18,13,51,45,6,63,12
734,Lincoln City,13,24,9,42,41,1,63,13
734,Exeter City,14,15,17,56,53,3,57,14
734,Bristol Rovers,16,9,21,63,75,-12,57,15
734,Port Vale,16,8,22,49,63,-14,56,16
734,Oxford United,13,12,21,51,57,-6,51,17
734,Burton Albion,13,9,24,52,95,-43,48,18
734,Cheltenham,12,8,26,36,67,-31,44,19
734,Acc'ton Stanley,9,15,22,29,69,-40,42,20
734,MK Dons,11,8,27,41,75,-34,41,21
734,Morecambe,9,13,24,42,77,-35,40,22
734,Cambridge Utd,9,7,30,33,77,-44,34,23
734,FG Rovers,6,11,29,32,87,-55,29,24
735,Sheffield Weds,33,10,3,79,28,51,109,1
735,Ipswich Town,26,14,6,89,42,47,92,2
735,Plymouth Argyle,27,11,8,80,49,31,92,3
735,Bolton,25,9,12,67,33,34,84,4
735,Wycombe,25,9,12,69,38,31,84,5
735,Derby County,23,14,9,75,43,32,83,6
735,Barnsley,24,8,14,65,46,19,80,7
735,Portsmouth,20,14,12,66,49,17,74,8
735,P'borough Utd,21,8,17,74,53,21,71,9
735,Shrewsbury,19,8,19,53,49,4,65,10
735,Fleetwood Town,16,14,16,53,47,6,62,11
735,Charlton Ath,16,14,16,61,60,1,62,12
735,Bristol Rovers,16,10,20,62,72,-10,58,13
735,Lincoln City,11,24,11,43,45,-2,57,14
735,Exeter City,15,11,20,56,60,-4,56,15
735,Oxford United,14,11,21,48,54,-6,53,16
735,Port Vale,12,13,21,40,69,-29,49,17
735,Cheltenham,12,12,22,35,57,-22,48,18
735,Burton Albion,11,13,22,53,81,-28,46,19
735,Acc'ton Stanley,9,14,23,34,67,-33,41,20
735,Morecambe,8,15,23,42,77,-35,39,21
735,MK Dons,8,14,24,39,67,-28,38,22
735,Cambridge Utd,9,9,28,33,79,-46,36,23
735,FG Rovers,6,13,27,35,86,-51,31,24
736,Sheffield Weds,32,10,4,84,32,52,106,1
736,Plymouth Argyle,28,12,6,83,44,39,96,2
736,Ipswich Town,25,16,5,85,43,42,91,3
736,Bolton,26,10,10,73,37,36,88,4
736,Barnsley,26,9,11,73,41,32,87,5
736,Derby County,23,13,10,71,40,31,82,6
736,Wycombe,23,9,14,65,43,22,78,7
736,Portsmouth,19,16,11,69,53,16,73,8
736,P'borough Utd,21,5,20,69,63,6,68,9
736,Shrewsbury,19,9,18,57,49,8,66,10
736,Exeter City,17,13,16,63,55,8,64,11
736,Charlton Ath,15,15,16,66,55,11,60,12
736,Fleetwood Town,15,15,16,49,45,4,60,13
736,Lincoln City,13,20,13,42,47,-5,59,14
736,Port Vale,16,8,22,48,69,-21,56,15
736,Burton Albion,14,10,22,61,87,-26,52,16
736,Oxford United,11,15,20,47,55,-8,48,17
736,Bristol Rovers,13,9,24,63,85,-22,48,18
736,Acc'ton Stanley,10,12,24,42,78,-36,42,19
736,Cambridge Utd,11,8,27,37,78,-41,41,20
736,Cheltenham,9,13,24,31,62,-31,40,21
736,Morecambe,8,16,22,42,76,-34,40,22
736,MK Dons,10,9,27,44,74,-30,39,23
736,FG Rovers,6,12,28,31,84,-53,30,24
737,Sheffield Weds,32,11,3,85,26,59,107,1
737,Plymouth Argyle,27,11,8,86,53,33,92,2
737,Bolton,25,11,10,70,33,37,86,3
737,Derby County,25,11,10,73,40,33,86,4
737,Ipswich Town,22,15,9,86,52,34,81,5
737,Barnsley,22,12,12,63,45,18,78,6
737,P'borough Utd,24,5,17,79,49,30,77,7
737,Wycombe,22,11,13,66,44,22,77,8
737,Charlton Ath,20,12,14,66,52,14,72,9
737,Portsmouth,18,17,11,65,50,15,71,10
737,Fleetwood Town,19,13,14,60,44,16,70,11
737,Exeter City,15,15,16,60,58,2,60,12
737,Shrewsbury,17,7,22,49,56,-7,58,13
737,Lincoln City,11,24,11,42,47,-5,57,14
737,Bristol Rovers,14,11,21,63,79,-16,53,15
737,Cheltenham,14,8,24,38,59,-21,50,16
737,Port Vale,13,11,22,46,68,-22,50,17
737,Burton Albion,13,10,23,58,82,-24,49,18
737,Oxford United,11,13,22,45,59,-14,46,19
737,Acc'ton Stanley,11,11,24,35,75,-40,44,20
737,Morecambe,10,13,23,46,76,-30,43,21
737,MK Dons,11,9,26,43,76,-33,42,22
737,Cambridge Utd,11,8,27,34,75,-41,41,23
737,FG Rovers,5,11,30,30,90,-60,26,24
738,Sheffield Weds,31,11,4,92,32,60,104,1
738,Plymouth Argyle,27,10,9,89,50,39,91,2
738,Ipswich Town,24,16,6,86,41,45,88,3
738,Derby County,24,14,8,80,38,42,86,4
738,Bolton,25,11,10,68,32,36,86,5
738,Barnsley,22,14,10,71,44,27,80,6
738,Wycombe,22,10,14,67,45,22,76,7
738,P'borough Utd,22,7,17,74,59,15,73,8
738,Portsmouth,16,16,14,54,51,3,64,9
738,Lincoln City,14,21,11,50,47,3,63,10
738,Shrewsbury,18,8,20,52,58,-6,62,11
738,Fleetwood Town,14,18,14,50,45,5,60,12
738,Port Vale,16,12,18,53,62,-9,60,13
738,Bristol Rovers,16,10,20,71,81,-10,58,14
738,Charlton Ath,13,14,19,60,64,-4,53,15
738,Morecambe,14,11,21,49,68,-19,53,16
738,Acc'ton Stanley,12,16,18,42,68,-26,52,17
738,Exeter City,13,11,22,53,75,-22,50,18
738,MK Dons,13,9,24,41,65,-24,48,19
738,Oxford United,9,19,18,48,59,-11,46,20
738,Cheltenham,11,9,26,32,68,-36,42,21
738,Cambridge Utd,11,7,28,32,65,-33,40,22
738,Burton Albion,9,10,27,48,101,-53,37,23
738,FG Rovers,8,12,26,37,81,-44,36,24
739,Plymouth Argyle,31,8,7,91,45,46,101,1
739,Sheffield Weds,27,13,6,79,33,46,94,2
739,Wycombe,29,5,12,77,38,39,92,3
739,Ipswich Town,25,15,6,80,39,41,90,4
739,Derby County,26,10,10,72,37,35,88,5
739,Barnsley,26,10,10,73,45,28,88,6
739,Bolton,26,9,11,67,33,34,87,7
739,Portsmouth,21,17,8,69,45,24,80,8
739,P'borough Utd,24,5,17,73,53,20,77,9
739,Fleetwood Town,15,17,14,51,45,6,62,10
739,Charlton Ath,16,14,16,62,57,5,62,11
739,Lincoln City,13,21,12,44,47,-3,60,12
739,Shrewsbury,17,7,22,49,58,-9,58,13
739,Port Vale,15,9,22,52,68,-16,54,14
739,Bristol Rovers,14,10,22,66,90,-24,52,15
739,Exeter City,14,9,23,52,65,-13,51,16
739,Oxford United,13,12,21,44,58,-14,51,17
739,MK Dons,13,8,25,46,68,-22,47,18
739,Burton Albion,10,13,23,53,85,-32,43,19
739,Acc'ton Stanley,10,13,23,35,74,-39,43,20
739,Cheltenham,10,11,25,34,60,-26,41,21
739,Cambridge Utd,11,6,29,35,75,-40,39,22
739,Morecambe,8,12,26,42,73,-31,36,23
739,FG Rovers,5,12,29,32,87,-55,27,24
740,Sheffield Weds,31,11,4,83,28,55,104,1
740,Plymouth Argyle,28,10,8,90,53,37,94,2
740,Bolton,24,13,9,69,35,34,85,3
740,Ipswich Town,23,15,8,83,48,35,84,4
740,Barnsley,25,9,12,66,40,26,84,5
740,Derby County,23,13,10,74,40,34,82,6
740,Wycombe,24,8,14,70,41,29,80,7
740,Portsmouth,20,14,12,63,48,15,74,8
740,P'borough Utd,23,4,19,70,54,16,73,9
740,Shrewsbury,20,11,15,57,46,11,71,10
740,Fleetwood Town,17,15,14,60,48,12,66,11
740,Charlton Ath,16,14,16,66,59,7,62,12
740,Port Vale,17,9,20,54,67,-13,60,13
740,Oxford United,14,12,20,52,59,-7,54,14
740,Exeter City,13,14,19,60,62,-2,53,15
740,Burton Albion,14,9,23,54,88,-34,51,16
740,Lincoln City,10,20,16,38,52,-14,50,17
740,Cheltenham,12,11,23,36,65,-29,47,18
740,Bristol Rovers,11,13,22,56,83,-27,46,19
740,Morecambe,10,14,22,46,71,-25,44,20
740,Acc'ton Stanley,10,14,22,33,70,-37,44,21
740,MK Dons,11,6,29,43,73,-30,39,22
740,Cambridge Utd,10,8,28,36,78,-42,38,23
740,FG Rovers,6,13,27,31,82,-51,31,24
741,Sheffield Weds,29,11,6,84,34,50,98,1
741,Barnsley,28,8,10,77,41,36,92,2
741,Ipswich Town,25,14,7,81,38,43,89,3
741,Plymouth Argyle,26,11,9,86,57,29,89,4
741,Bolton,26,10,10,72,33,39,88,5
741,Derby County,24,11,11,80,48,32,83,6
741,P'borough Utd,24,4,18,78,60,18,76,7
741,Wycombe,22,6,18,62,50,12,72,8
741,Fleetwood Town,18,13,15,48,45,3,67,9
741,Portsmouth,17,14,15,64,60,4,65,10
741,Shrewsbury,19,8,19,54,50,4,65,11
741,Charlton Ath,16,13,17,68,65,3,61,12
741,Exeter City,16,10,20,56,59,-3,58,13
741,Oxford United,14,15,17,51,55,-4,57,14
741,Burton Albion,15,12,19,59,75,-16,57,15
741,Lincoln City,11,22,13,39,44,-5,55,16
741,Morecambe,14,11,21,48,65,-17,53,17
741,Bristol Rovers,13,11,22,64,81,-17,50,18
741,Port Vale,11,12,23,43,73,-30,45,19
741,Cambridge Utd,12,7,27,36,77,-41,43,20
741,Acc'ton Stanley,10,12,24,42,73,-31,42,21
741,MK Dons,10,11,25,41,71,-30,41,22
741,Cheltenham,9,12,25,30,60,-30,39,23
741,FG Rovers,9,10,27,39,88,-49,37,24
742,Sheffield Weds,30,10,6,92,32,60,100,1
742,Plymouth Argyle,28,9,9,95,54,41,93,2
742,Barnsley,27,9,10,73,41,32,90,3
742,Ipswich Town,25,14,7,84,41,43,89,4
742,Derby County,24,10,12,73,46,27,82,5
742,Wycombe,22,10,14,72,48,24,76,6
742,Bolton,22,10,14,63,43,20,76,7
742,P'borough Utd,23,4,19,80,60,20,73,8
742,Portsmouth,17,18,11,57,46,11,69,9
742,Shrewsbury,19,11,16,57,51,6,68,10
742,Charlton Ath,18,12,16,66,56,10,66,11
742,Exeter City,18,10,18,71,63,8,64,12
742,Fleetwood Town,15,15,16,51,44,7,60,13
742,Lincoln City,12,21,13,40,48,-8,57,14
742,Oxford United,15,11,20,52,60,-8,56,15
742,Bristol Rovers,14,12,20,59,81,-22,54,16
742,Cambridge Utd,15,7,24,39,68,-29,52,17
742,Port Vale,13,10,23,42,64,-22,49,18
742,Acc'ton Stanley,11,14,21,39,75,-36,47,19
742,Cheltenham,12,10,24,36,69,-33,46,20
742,Burton Albion,12,10,24,56,93,-37,46,21
742,MK Dons,11,9,26,42,70,-28,42,22
742,Morecambe,10,12,24,43,75,-32,42,23
742,FG Rovers,5,10,31,30,84,-54,25,24
743,Sheffield Weds,29,11,6,85,35,50,98,1
743,Plymouth Argyle,28,10,8,84,52,32,94,2
743,Bolton,27,10,9,77,33,44,91,3
743,Ipswich Town,24,15,7,85,45,40,87,4
743,Barnsley,25,10,11,70,42,28,85,5
743,Derby County,24,9,13,77,50,27,81,6
743,Wycombe,23,9,14,72,46,26,78,7
743,P'borough Utd,24,4,18,83,63,20,76,8
743,Shrewsbury,19,11,16,59,49,10,68,9
743,Fleetwood Town,17,14,15,58,50,8,65,10
743,Portsmouth,16,17,13,62,57,5,65,11
743,Lincoln City,15,20,11,42,46,-4,65,12
743,Exeter City,17,13,16,66,61,5,64,13
743,Charlton Ath,16,13,17,62,62,0,61,14
743,Bristol Rovers,15,10,21,71,87,-16,55,15
743,Port Vale,14,10,22,48,67,-19,52,16
743,Oxford United,12,13,21,46,57,-11,49,17
743,MK Dons,13,8,25,43,66,-23,47,18
743,Acc'ton Stanley,11,14,21,40,67,-27,47,19
743,Burton Albion,13,8,25,55,92,-37,47,20
743,Cambridge Utd,11,9,26,41,79,-38,42,21
743,Morecambe,8,15,23,41,74,-33,39,22
743,Cheltenham,10,7,29,36,72,-36,37,23
743,FG Rovers,5,12,29,36,87,-51,27,24
744,Sheffield Weds,29,13,4,80,33,47,100,1
744,Plymouth Argyle,29,11,6,92,50,42,98,2
744,Derby County,26,9,11,79,39,40,87,3
744,Bolton,23,13,10,66,35,31,82,4
744,Ipswich Town,21,18,7,79,47,32,81,5
744,Barnsley,23,11,12,61,39,22,80,6
744,P'borough Utd,24,6,16,71,51,20,78,7
744,Wycombe,22,11,13,69,45,24,77,8
744,Portsmouth,19,17,10,66,48,18,74,9
744,Shrewsbury,18,10,18,57,53,4,64,10
744,Charlton Ath,15,16,15,61,59,2,61,11
744,Exeter City,17,10,19,62,61,1,61,12
744,Fleetwood Town,16,13,17,46,45,1,61,13
744,Oxford United,15,14,17,52,53,-1,59,14
744,Lincoln City,11,22,13,41,49,-8,55,15
744,Bristol Rovers,13,11,22,63,82,-19,50,16
744,Cheltenham,13,9,24,36,63,-27,48,17
744,Port Vale,11,12,23,40,66,-26,45,18
744,Morecambe,11,12,23,50,78,-28,45,19
744,MK Dons,13,6,27,43,73,-30,45,20
744,Burton Albion,11,11,24,54,83,-29,44,21
744,Acc'ton Stanley,9,15,22,36,68,-32,42,22
744,Cambridge Utd,11,9,26,40,73,-33,42,23
744,FG Rovers,7,11,28,35,86,-51,32,24
745,Sheffield Weds,30,10,6,80,30,50,100,1
745,Ipswich Town,26,15,5,88,42,46,93,2
745,Plymouth Argyle,26,13,7,86,50,36,91,3
745,Bolton,26,10,10,70,33,37,88,4
745,Barnsley,25,8,13,74,49,25,83,5
745,Derby County,22,13,11,76,50,26,79,6
745,P'borough Utd,25,4,17,85,61,24,79,7
745,Wycombe,23,7,16,70,45,25,76,8
745,Charlton Ath,18,15,13,73,57,16,69,9
745,Portsmouth,16,17,13,58,49,9,65,10
745,Shrewsbury,18,11,17,55,53,2,65,11
745,Fleetwood Town,16,14,16,50,49,1,62,12
745,Lincoln City,13,21,12,43,49,-6,60,13
745,Exeter City,16,10,20,61,64,-3,58,14
745,Bristol Rovers,14,14,18,62,76,-14,56,15
745,Port Vale,15,10,21,47,65,-18,55,16
745,Burton Albion,13,11,22,59,81,-22,50,17
745,Acc'ton Stanley,12,14,20,38,64,-26,50,18
745,Oxford United,12,10,24,45,66,-21,46,19
745,Cheltenham,11,12,23,36,62,-26,45,20
745,MK Dons,11,9,26,43,71,-28,42,21
745,Cambridge Utd,11,8,27,38,78,-40,41,22
745,Morecambe,7,13,26,39,76,-37,34,23
745,FG Rovers,6,11,29,31,87,-56,29,24
746,Sheffield Weds,30,11,5,76,28,48,101,1
746,Plymouth Argyle,29,10,7,87,51,36,97,2
746,Ipswich Town,26,14,6,85,40,45,92,3
746,Barnsley,28,8,10,78,42,36,92,4
746,Derby County,24,10,12,76,40,36,82,5
746,Bolton,23,12,11,64,34,30,81,6
746,Wycombe,25,6,15,68,47,21,81,7
746,Shrewsbury,20,10,16,53,46,7,70,8
746,P'borough Utd,19,11,16,72,58,14,68,9
746,Charlton Ath,19,11,16,68,61,7,68,10
746,Portsmouth,15,18,13,55,51,4,63,11
746,Lincoln City,14,21,11,49,46,3,63,12
746,Fleetwood Town,15,15,16,51,46,5,60,13
746,Exeter City,15,14,17,55,58,-3,59,14
746,Oxford United,14,11,21,52,55,-3,53,15
746,Port Vale,14,10,22,44,64,-20,52,16
746,Bristol Rovers,14,10,22,56,83,-27,52,17
746,Morecambe,11,11,24,46,73,-27,44,18
746,MK Dons,11,10,25,41,66,-25,43,19
746,Acc'ton Stanley,9,16,21,35,66,-31,43,20
746,Burton Albion,9,15,22,51,82,-31,42,21
746,Cambridge Utd,11,8,27,35,70,-35,41,22
746,Cheltenham,10,9,27,31,65,-34,39,23
746,FG Rovers,6,11,29,34,90,-56,29,24
747,Sheffield Weds,30,11,5,78,28,50,101,1
747,Derby County,27,11,8,78,36,42,92,2
747,Plymouth Argyle,27,11,8,79,50,29,92,3
747,Barnsley,27,7,12,72,38,34,88,4
747,Ipswich Town,23,16,7,75,40,35,85,5
747,Bolton,22,11,13,66,42,24,77,6
747,Wycombe,21,10,15,60,39,21,73,7
747,Portsmouth,19,15,12,66,49,17,72,8
747,P'borough Utd,22,4,20,74,63,11,70,9
747,Shrewsbury,19,11,16,58,51,7,68,10
747,Bristol Rovers,17,10,19,67,76,-9,61,11
747,Fleetwood Town,15,15,16,50,44,6,60,12
747,Port Vale,17,9,20,52,57,-5,60,13
747,Exeter City,16,12,18,56,62,-6,60,14
747,Charlton Ath,15,13,18,61,61,0,58,15
747,Lincoln City,10,21,15,45,59,-14,51,16
747,Oxford United,13,10,23,47,60,-13,49,17
747,Cambridge Utd,13,9,24,37,66,-29,48,18
747,Acc'ton Stanley,11,15,20,36,66,-30,48,19
747,Cheltenham,11,13,22,34,58,-24,46,20
747,Morecambe,10,13,23,44,75,-31,43,21
747,Burton Albion,10,12,24,48,81,-33,42,22
747,MK Dons,10,11,25,45,72,-27,41,23
747,FG Rovers,7,10,29,31,86,-55,31,24
748,Sheffield Weds,30,13,3,84,28,56,103,1
748,Barnsley,27,9,10,70,33,37,90,2
748,Derby County,26,11,9,75,41,34,89,3
748,Plymouth Argyle,26,10,10,86,54,32,88,4
748,Ipswich Town,24,15,7,77,41,36,87,5
748,Bolton,24,12,10,64,36,28,84,6
748,Wycombe,24,6,16,65,48,17,78,7
748,Portsmouth,19,14,13,67,53,14,71,8
748,Charlton Ath,19,13,14,69,60,9,70,9
748,P'borough Utd,20,9,17,73,56,17,69,10
748,Lincoln City,15,22,9,48,42,6,67,11
748,Shrewsbury,18,9,19,53,49,4,63,12
748,Fleetwood Town,15,15,16,49,44,5,60,13
748,Bristol Rovers,15,11,20,69,82,-13,56,14
748,Exeter City,14,13,19,58,63,-5,55,15
748,Port Vale,13,12,21,48,70,-22,51,16
748,Oxford United,13,10,23,45,57,-12,49,17
748,Acc'ton Stanley,11,15,20,37,64,-27,48,18
748,MK Dons,13,6,27,43,69,-26,45,19
748,Cambridge Utd,12,8,26,35,67,-32,44,20
748,Morecambe,10,13,23,39,65,-26,43,21
748,Burton Albion,10,11,25,50,92,-42,41,22
748,Cheltenham,10,10,26,34,67,-33,40,23
748,FG Rovers,5,11,30,29,86,-57,26,24
749,Sheffield Weds,30,11,5,85,30,55,101,1
749,Plymouth Argyle,28,9,9,85,54,31,93,2
749,Barnsley,26,8,12,64,37,27,86,3
749,Derby County,24,12,10,72,40,32,84,4
749,Ipswich Town,22,17,7,79,46,33,83,5
749,Wycombe,25,8,13,65,44,21,83,6
749,Bolton,24,10,12,70,35,35,82,7
749,P'borough Utd,22,7,17,74,55,19,73,8
749,Fleetwood Town,18,15,13,55,41,14,69,9
749,Lincoln City,16,21,9,49,44,5,69,10
749,Charlton Ath,19,11,16,66,55,11,68,11
749,Shrewsbury,19,7,20,55,53,2,64,12
749,Portsmouth,16,15,15,62,55,7,63,13
749,Exeter City,15,11,20,59,65,-6,56,14
749,Bristol Rovers,14,11,21,60,74,-14,53,15
749,Port Vale,15,8,23,48,68,-20,53,16
749,Morecambe,13,12,21,52,74,-22,51,17
749,Burton Albion,12,11,23,57,82,-25,47,18
749,Oxford United,12,10,24,43,62,-19,46,19
749,Cheltenham,12,9,25,31,62,-31,45,20
749,Acc'ton Stanley,11,12,23,38,74,-36,45,21
749,Cambridge Utd,12,8,26,38,73,-35,44,22
749,MK Dons,11,9,26,39,67,-28,42,23
749,FG Rovers,5,10,31,28,84,-56,25,24
750,Sheffield Weds,31,11,4,87,28,59,104,1
750,Plymouth Argyle,29,11,6,88,49,39,98,2
750,Ipswich Town,26,13,7,91,45,46,91,3
750,Bolton,27,9,10,76,30,46,90,4
750,Barnsley,24,11,11,76,45,31,83,5
750,Derby County,21,16,9,71,44,27,79,6
750,Wycombe,24,7,15,67,40,27,79,7
750,P'borough Utd,22,6,18,79,62,17,72,8
750,Fleetwood Town,18,15,13,60,47,13,69,9
750,Shrewsbury,20,8,18,53,52,1,68,10
750,Portsmouth,16,18,12,61,53,8,66,11
750,Charlton Ath,17,13,16,65,60,5,64,12
750,Bristol Rovers,15,10,21,61,81,-20,55,13
750,Exeter City,14,12,20,61,64,-3,54,14
750,Oxford United,13,14,19,49,57,-8,53,15
750,Lincoln City,10,23,13,41,53,-12,53,16
750,Port Vale,14,9,23,45,71,-26,51,17
750,MK Dons,13,9,24,47,67,-20,48,18
750,Burton Albion,13,9,24,53,89,-36,48,19
750,Morecambe,10,13,23,45,79,-34,43,20
750,Cheltenham,11,9,26,32,65,-33,42,21
750,Cambridge Utd,11,9,26,38,73,-35,42,22
750,Acc'ton Stanley,8,13,25,36,76,-40,37,23
750,FG Rovers,6,10,30,36,88,-52,28,24
751,Sheffield Weds,34,9,3,98,25,73,111,1
751,Plymouth Argyle,28,11,7,93,50,43,95,2
751,Ipswich Town,24,14,8,83,45,38,86,3
751,Wycombe,25,8,13,70,42,28,83,4
751,Bolton,24,10,12,68,39,29,82,5
751,Derby County,23,10,13,65,44,21,79,6
751,Barnsley,23,10,13,64,43,21,79,7
751,Portsmouth,21,13,12,68,49,19,76,8
751,P'borough Utd,20,7,19,70,61,9,67,9
751,Shrewsbury,19,10,17,55,63,-8,67,10
751,Charlton Ath,17,15,14,65,58,7,66,11
751,Lincoln City,15,20,11,48,46,2,65,12
751,Fleetwood Town,16,15,15,49,46,3,63,13
751,Exeter City,17,10,19,61,58,3,61,14
751,Bristol Rovers,15,12,19,64,74,-10,57,15
751,Port Vale,15,11,20,49,65,-16,56,16
751,Oxford United,13,11,22,49,59,-10,50,17
751,Cheltenham,11,11,24,31,61,-30,44,18
751,Burton Albion,11,11,24,56,90,-34,44,19
751,MK Dons,10,12,24,44,67,-23,42,20
751,Acc'ton Stanley,9,13,24,36,75,-39,40,21
751,Cambridge Utd,9,10,27,33,74,-41,37,22
751,Morecambe,8,12,26,44,80,-36,36,23
751,FG Rovers,8,9,29,32,81,-49,33,24
752,Sheffield Weds,30,12,4,93,33,60,102,1
752,Plymouth Argyle,27,9,10,77,49,28,90,2
752,Ipswich Town,25,14,7,86,42,44,89,3
752,Bolton,26,9,11,74,34,40,87,4
752,Barnsley,25,8,13,69,40,29,83,5
752,Derby County,24,10,12,74,41,33,82,6
752,Portsmouth,18,18,10,62,48,14,72,7
752,P'borough Utd,21,8,17,73,65,8,71,8
752,Wycombe,19,11,16,58,46,12,68,9
752,Fleetwood Town,17,15,14,52,45,7,66,10
752,Charlton Ath,18,12,16,61,55,6,66,11
752,Shrewsbury,19,9,18,54,48,6,66,12
752,Exeter City,17,10,19,62,66,-4,61,13
752,Port Vale,17,10,19,50,64,-14,61,14
752,Lincoln City,11,21,14,44,52,-8,54,15
752,Burton Albion,13,11,22,55,80,-25,50,16
752,Acc'ton Stanley,12,12,22,43,69,-26,48,17
752,Oxford United,12,11,23,44,60,-16,47,18
752,Bristol Rovers,12,11,23,59,84,-25,47,19
752,MK Dons,12,9,25,41,68,-27,45,20
752,Morecambe,10,15,21,43,75,-32,45,21
752,Cheltenham,12,8,26,40,68,-28,44,22
752,Cambridge Utd,9,11,26,31,70,-39,38,23
752,FG Rovers,7,14,25,36,79,-43,35,24
753,Sheffield Weds,31,10,5,78,29,49,103,1
753,Plymouth Argyle,30,9,7,93,49,44,99,2
753,Barnsley,25,10,11,70,36,34,85,3
753,Ipswich Town,23,15,8,86,48,38,84,4
753,Wycombe,25,7,14,61,38,23,82,5
753,Derby County,22,14,10,74,42,32,80,6
753,Bolton,22,13,11,64,37,27,79,7
753,P'borough Utd,22,7,17,75,59,16,73,8
753,Shrewsbury,19,9,18,60,53,7,66,9
753,Portsmouth,16,15,15,63,63,0,63,10
753,Fleetwood Town,14,17,15,51,47,4,59,11
753,Exeter City,15,14,17,60,58,2,59,12
753,Charlton Ath,14,14,18,62,62,0,56,13
753,Lincoln City,11,23,12,42,51,-9,56,14
753,Port Vale,15,10,21,46,64,-18,55,15
753,Bristol Rovers,14,12,20,60,75,-15,54,16
753,Cheltenham,13,12,21,35,56,-21,51,17
753,Acc'ton Stanley,12,15,19,39,63,-24,51,18
753,Burton Albion,11,13,22,57,85,-28,46,19
753,Morecambe,10,16,20,45,75,-30,46,20
753,Cambridge Utd,12,9,25,35,72,-37,45,21
753,Oxford United,10,12,24,43,60,-17,42,22
753,MK Dons,10,8,28,43,73,-30,38,23
753,FG Rovers,8,12,26,32,79,-47,36,24
754,Sheffield Weds,31,9,6,90,33,57,102,1
754,Plymouth Argyle,30,9,7,86,47,39,99,2
754,Ipswich Town,26,14,6,86,43,43,92,3
754,Barnsley,28,7,11,81,44,37,91,4
754,Bolton,26,10,10,67,32,35,88,5
754,Derby County,23,14,9,74,43,31,83,6
754,Wycombe,25,7,14,67,44,23,82,7
754,Portsmouth,19,15,12,70,55,15,72,8
754,Shrewsbury,20,12,14,59,47,12,72,9
754,P'borough Utd,21,7,18,71,57,14,70,10
754,Lincoln City,15,18,13,45,47,-2,63,11
754,Charlton Ath,15,14,17,62,61,1,59,12
754,Exeter City,15,12,19,57,64,-7,57,13
754,Fleetwood Town,12,18,16,45,48,-3,54,14
754,Cheltenham,13,12,21,34,56,-22,51,15
754,Port Vale,12,13,21,45,63,-18,49,16
754,Bristol Rovers,12,10,24,55,78,-23,46,17
754,Burton Albion,11,12,23,60,87,-27,45,18
754,Cambridge Utd,12,8,26,43,81,-38,44,19
754,Oxford United,10,12,24,40,59,-19,42,20
754,Acc'ton Stanley,10,12,24,39,72,-33,42,21
754,Morecambe,10,11,25,42,72,-30,41,22
754,MK Dons,10,11,25,43,74,-31,41,23
754,FG Rovers,8,9,29,33,87,-54,33,24
755,Sheffield Weds,31,10,5,94,32,62,103,1
755,Plymouth Argyle,28,11,7,86,48,38,95,2
755,Barnsley,28,7,11,72,38,34,91,3
755,Bolton,27,9,10,71,34,37,90,4
755,Derby County,25,12,9,71,38,33,87,5
755,Wycombe,25,8,13,60,39,21,83,6
755,Ipswich Town,23,13,10,79,45,34,82,7
755,P'borough Utd,23,5,18,77,49,28,74,8
755,Portsmouth,19,15,12,61,47,14,72,9
755,Shrewsbury,21,9,16,53,44,9,72,10
755,Fleetwood Town,17,15,14,53,43,10,66,11
755,Charlton Ath,15,15,16,64,57,7,60,12
755,Lincoln City,12,21,13,41,50,-9,57,13
755,Bristol Rovers,15,9,22,61,79,-18,54,14
755,Exeter City,13,13,20,55,62,-7,52,15
755,Oxford United,13,13,20,50,63,-13,52,16
755,Port Vale,14,10,22,47,66,-19,52,17
755,MK Dons,13,9,24,46,70,-24,48,18
755,Acc'ton Stanley,11,12,23,35,68,-33,45,19
755,Cambridge Utd,12,7,27,36,78,-42,43,20
755,Burton Albion,10,11,25,55,98,-43,41,21
755,Cheltenham,10,10,26,35,66,-31,40,22
755,Morecambe,8,14,24,42,74,-32,38,23
755,FG Rovers,6,8,32,35,91,-56,26,24
756,Sheffield Weds,28,13,5,82,33,49,97,1
756,Ipswich Town,26,15,5,89,42,47,93,2
756,Plymouth Argyle,27,11,8,87,49,38,92,3
756,Barnsley,26,11,9,73,39,34,89,4
756,Bolton,23,13,10,70,34,36,82,5
756,Wycombe,24,8,14,64,43,21,80,6
756,Portsmouth,20,15,11,73,50,23,75,7
756,Derby County,20,14,12,62,43,19,74,8
756,P'borough Utd,21,9,16,68,56,12,72,9
756,Shrewsbury,19,11,16,59,53,6,68,10
756,Charlton Ath,17,13,16,69,59,10,64,11
756,Fleetwood Town,15,17,14,51,42,9,62,12
756,Lincoln City,13,20,13,46,49,-3,59,13
756,Exeter City,15,11,20,54,61,-7,56,14
756,Bristol Rovers,13,12,21,62,82,-20,51,15
756,Port Vale,13,12,21,48,72,-24,51,16
756,Burton Albion,14,9,23,60,90,-30,51,17
756,Cambridge Utd,13,10,23,40,64,-24,49,18
756,Oxford United,11,15,20,45,57,-12,48,19
756,Acc'ton Stanley,10,15,21,42,73,-31,45,20
756,Cheltenham,12,8,26,34,66,-32,44,21
756,Morecambe,9,14,23,40,72,-32,41,22
756,MK Dons,9,9,28,40,73,-33,36,23
756,FG Rovers,5,13,28,36,92,-56,28,24
757,Sheffield Weds,29,11,6,83,31,52,98,1
757,Derby County,27,11,8,80,40,40,92,2
757,Barnsley,28,8,10,80,40,40,92,3
757,Plymouth Argyle,26,13,7,92,60,32,91,4
757,Ipswich Town,25,12,9,88,49,39,87,5
757,Bolton,24,12,10,73,38,35,84,6
757,P'borough Utd,23,6,17,83,60,23,75,7
757,Portsmouth,20,15,11,70,51,19,75,8
757,Charlton Ath,17,13,16,71,65,6,64,9
757,Wycombe,17,12,17,56,51,5,63,10
757,Lincoln City,14,21,11,48,49,-1,63,11
757,Shrewsbury,17,12,17,55,59,-4,63,12
757,Fleetwood Town,16,14,16,55,54,1,62,13
757,Exeter City,16,11,19,61,62,-1,59,14
757,Burton Albion,14,11,21,56,85,-29,53,15
757,Port Vale,14,8,24,45,71,-26,50,16
757,Bristol Rovers,13,10,23,64,88,-24,49,17
757,Oxford United,11,13,22,47,60,-13,46,18
757,MK Dons,12,10,24,40,62,-22,46,19
757,Cheltenham,12,9,25,36,62,-26,45,20
757,Acc'ton Stanley,10,14,22,41,71,-30,44,21
757,Morecambe,9,14,23,48,76,-28,41,22
757,Cambridge Utd,10,9,27,36,74,-38,39,23
757,FG Rovers,9,9,28,35,85,-50,36,24
758,Sheffield Weds,32,10,4,91,32,59,106,1
758,Plymouth Argyle,26,12,8,80,50,30,90,2
758,Ipswich Town,25,13,8,80,39,41,88,3
758,Bolton,25,10,11,72,39,33,85,4
758,Derby County,24,12,10,82,39,43,84,5
758,Barnsley,23,11,12,67,45,22,80,6
758,Wycombe,23,8,15,63,44,19,77,7
758,Portsmouth,18,16,12,66,52,14,70,8
758,P'borough Utd,21,6,19,74,61,13,69,9
758,Lincoln City,14,22,10,41,40,1,64,10
758,Fleetwood Town,16,15,15,46,46,0,63,11
758,Shrewsbury,16,12,18,49,51,-2,60,12
758,Port Vale,17,8,21,54,63,-9,59,13
758,Charlton Ath,15,12,19,60,58,2,57,14
758,Exeter City,15,11,20,55,63,-8,56,15
758,Bristol Rovers,15,9,22,60,81,-21,54,16
758,Burton Albion,14,11,21,56,83,-27,53,17
758,Oxford United,12,13,21,47,59,-12,49,18
758,Cheltenham,13,9,24,35,57,-22,48,19
758,Acc'ton Stanley,10,14,22,39,70,-31,44,20
758,Cambridge Utd,11,10,25,36,69,-33,43,21
758,Morecambe,9,15,22,43,70,-27,42,22
758,MK Dons,10,9,27,42,81,-39,39,23
758,FG Rovers,8,12,26,38,84,-46,36,24
759,Sheffield Weds,29,12,5,82,25,57,99,1
759,Ipswich Town,27,13,6,87,41,46,94,2
759,Plymouth Argyle,27,13,6,77,44,33,94,3
759,Bolton,26,8,12,67,37,30,86,4
759,Derby County,23,15,8,74,38,36,84,5
759,Wycombe,23,9,14,64,43,21,78,6
759,Barnsley,21,14,11,67,43,24,77,7
759,Portsmouth,19,15,12,65,51,14,72,8
759,Charlton Ath,18,14,14,65,56,9,68,9
759,P'borough Utd,18,11,17,70,60,10,65,10
759,Lincoln City,13,23,10,42,41,1,62,11
759,Shrewsbury,17,11,18,54,56,-2,62,12
759,Fleetwood Town,14,17,15,53,49,4,59,13
759,Exeter City,14,16,16,58,61,-3,58,14
759,Oxford United,13,16,17,45,51,-6,55,15
759,Burton Albion,14,10,22,57,83,-26,52,16
759,Bristol Rovers,14,9,23,61,83,-22,51,17
759,Port Vale,13,10,23,42,68,-26,49,18
759,Cheltenham,12,10,24,32,59,-27,46,19
759,Morecambe,10,15,21,51,72,-21,45,20
759,MK Dons,11,7,28,40,72,-32,40,21
759,Cambridge Utd,9,13,24,30,63,-33,40,22
759,Acc'ton Stanley,8,12,26,37,74,-37,36,23
759,FG Rovers,6,13,27,34,84,-50,31,24
760,Sheffield Weds,28,12,6,77,32,45,96,1
760,Plymouth Argyle,29,9,8,84,48,36,96,2
760,Derby County,28,9,9,82,41,41,93,3
760,Barnsley,27,10,9,75,36,39,91,4
760,Ipswich Town,24,15,7,80,40,40,87,5
760,Bolton,22,12,12,69,36,33,78,6
760,P'borough Utd,22,7,17,74,58,16,73,7
760,Shrewsbury,21,10,15,54,49,5,73,8
760,Portsmouth,17,18,11,60,51,9,69,9
760,Wycombe,19,11,16,56,45,11,68,10
760,Fleetwood Town,15,17,14,48,43,5,62,11
760,Exeter City,15,14,17,53,53,0,59,12
760,Charlton Ath,15,13,18,63,65,-2,58,13
760,Lincoln City,13,19,14,44,48,-4,58,14
760,Port Vale,14,10,22,45,66,-21,52,15
760,Acc'ton Stanley,12,14,20,42,64,-22,50,16
760,Oxford United,12,13,21,46,59,-13,49,17
760,Bristol Rovers,13,10,23,62,82,-20,49,18
760,Cheltenham,12,9,25,35,62,-27,45,19
760,Burton Albion,10,14,22,55,87,-32,44,20
760,Cambridge Utd,12,8,26,40,76,-36,44,21
760,Morecambe,10,12,24,41,73,-32,42,22
760,MK Dons,10,11,25,41,69,-28,41,23
760,FG Rovers,8,11,27,35,78,-43,35,24
761,Sheffield Weds,31,11,4,83,27,56,104,1
761,Plymouth Argyle,27,12,7,88,51,37,93,2
761,Barnsley,28,8,10,82,42,40,92,3
761,Ipswich Town,24,16,6,87,46,41,88,4
761,Derby County,22,16,8,68,37,31,82,5
761,Wycombe,24,8,14,67,45,22,80,6
761,Bolton,21,11,14,68,40,28,74,7
761,Portsmouth,19,15,12,64,51,13,72,8
761,P'borough Utd,21,5,20,71,60,11,68,9
761,Shrewsbury,19,11,16,54,48,6,68,10
761,Fleetwood Town,17,14,15,53,45,8,65,11
761,Lincoln City,15,19,12,43,45,-2,64,12
761,Charlton Ath,16,15,15,61,56,5,63,13
761,Bristol Rovers,16,13,17,67,70,-3,61,14
761,Exeter City,14,14,18,54,61,-7,56,15
761,Port Vale,14,10,22,48,67,-19,52,16
761,Oxford United,12,14,20,43,57,-14,50,17
761,Cambridge Utd,12,11,23,39,70,-31,47,18
761,Acc'ton Stanley,11,14,21,43,77,-34,47,19
761,Cheltenham,11,8,27,33,67,-34,41,20
761,MK Dons,10,10,26,45,71,-26,40,21
761,Morecambe,7,16,23,41,74,-33,37,22
761,Burton Albion,9,10,27,53,95,-42,37,23
761,FG Rovers,7,9,30,31,84,-53,30,24
762,Sheffield Weds,30,12,4,79,29,50,102,1
762,Plymouth Argyle,26,11,9,86,59,27,89,2
762,Bolton,25,9,12,74,35,39,84,3
762,Ipswich Town,23,14,9,82,46,36,83,4
762,Barnsley,23,11,12,77,48,29,80,5
762,Wycombe,25,5,16,70,48,22,80,6
762,Derby County,21,14,11,69,47,22,77,7
762,P'borough Utd,24,5,17,77,57,20,77,8
762,Portsmouth,19,15,12,62,53,9,72,9
762,Charlton Ath,17,14,15,67,58,9,65,10
762,Shrewsbury,18,10,18,53,55,-2,64,11
762,Exeter City,15,15,16,61,62,-1,60,12
762,Lincoln City,13,21,12,46,47,-1,60,13
762,Fleetwood Town,14,16,16,49,50,-1,58,14
762,Burton Albion,15,11,20,59,77,-18,56,15
762,Bristol Rovers,15,10,21,63,75,-12,55,16
762,Oxford United,13,13,20,52,59,-7,52,17
762,Port Vale,13,12,21,45,67,-22,51,18
762,Cambridge Utd,13,7,26,41,70,-29,46,19
762,Cheltenham,12,9,25,37,63,-26,45,20
762,Morecambe,10,13,23,41,69,-28,43,21
762,MK Dons,10,10,26,38,71,-33,40,22
762,Acc'ton Stanley,8,15,23,38,77,-39,39,23
762,FG Rovers,8,12,26,39,83,-44,36,24
763,Sheffield Weds,32,11,3,87,30,57,107,1
763,Plymouth Argyle,30,10,6,94,52,42,100,2
763,Ipswich Town,23,16,7,83,51,32,85,3
763,Bolton,25,9,12,67,38,29,84,4
763,Derby County,23,14,9,77,40,37,83,5
763,Barnsley,23,11,12,77,47,30,80,6
763,Wycombe,23,9,14,65,43,22,78,7
763,P'borough Utd,22,5,19,72,55,17,71,8
763,Shrewsbury,20,8,18,52,49,3,68,9
763,Portsmouth,16,19,11,55,43,12,67,10
763,Charlton Ath,16,14,16,68,64,4,62,11
763,Oxford United,15,13,18,56,53,3,58,12
763,Fleetwood Town,15,13,18,49,51,-2,58,13
763,Bristol Rovers,16,10,20,60,75,-15,58,14
763,Lincoln City,11,22,13,41,52,-11,55,15
763,Port Vale,15,9,22,45,67,-22,54,16
763,Exeter City,14,11,21,57,65,-8,53,17
763,Acc'ton Stanley,11,14,21,41,70,-29,47,18
763,Cheltenham,12,10,24,35,59,-24,46,19
763,Burton Albion,11,13,22,56,89,-33,46,20
763,MK Dons,12,7,27,41,70,-29,43,21
763,Cambridge Utd,9,12,25,34,68,-34,39,22
763,Morecambe,8,15,23,39,75,-36,39,23
763,FG Rovers,6,13,27,37,82,-45,31,24
764,Sheffield Weds,30,12,4,84,27,57,102,1
764,Plymouth Argyle,30,9,7,92,55,37,99,2
764,Ipswich Town,24,14,8,78,42,36,86,3
764,Derby County,24,12,10,72,39,33,84,4
764,Barnsley,24,8,14,70,46,24,80,5
764,Wycombe,23,11,12,64,43,21,80,6
764,Bolton,22,12,12,68,43,25,78,7
764,Portsmouth,20,16,10,67,50,17,76,8
764,P'borough Utd,23,6,17,75,62,13,75,9
764,Exeter City,18,12,16,67,54,13,66,10
764,Shrewsbury,18,10,18,51,49,2,64,11
764,Charlton Ath,15,16,15,60,55,5,61,12
764,Fleetwood Town,15,15,16,52,46,6,60,13
764,Lincoln City,12,20,14,42,51,-9,56,14
764,Port Vale,15,9,22,50,65,-15,54,15
764,Cheltenham,14,10,22,35,55,-20,52,16
764,Oxford United,13,12,21,53,61,-8,51,17
764,Bristol Rovers,13,11,22,70,86,-16,50,18
764,Burton Albion,12,12,22,59,88,-29,48,19
764,Cambridge Utd,12,8,26,43,72,-29,44,20
764,MK Dons,11,9,26,39,70,-31,42,21
764,Morecambe,9,13,24,43,77,-34,40,22
764,Acc'ton Stanley,7,15,24,34,74,-40,36,23
764,FG Rovers,6,12,28,32,90,-58,30,24
765,Sheffield Weds,32,10,4,92,33,59,106,1
765,Plymouth Argyle,28,10,8,82,50,32,94,2
765,Derby County,25,11,10,74,36,38,86,3
765,Barnsley,24,11,11,71,46,25,83,4
765,P'borough Utd,25,7,14,78,52,26,82,5
765,Ipswich Town,21,15,10,74,46,28,78,6
765,Bolton,22,11,13,65,43,22,77,7
765,Wycombe,23,8,15,65,45,20,77,8
765,Portsmouth,19,13,14,58,48,10,70,9
765,Shrewsbury,20,7,19,54,52,2,67,10
765,Fleetwood Town,16,17,13,52,42,10,65,11
765,Charlton Ath,17,13,16,72,63,9,64,12
765,Lincoln City,14,21,11,49,47,2,63,13
765,Oxford United,16,10,20,55,62,-7,58,14
765,Bristol Rovers,15,13,18,66,75,-9,58,15
765,Exeter City,14,11,21,54,62,-8,53,16
765,Acc'ton Stanley,13,11,22,42,74,-32,50,17
765,Port Vale,13,10,23,46,70,-24,49,18
765,Cheltenham,13,10,23,35,60,-25,49,19
765,Cambridge Utd,13,7,26,43,69,-26,46,20
765,MK Dons,12,9,25,41,69,-28,45,21
765,Burton Albion,11,10,25,52,87,-35,43,22
765,Morecambe,7,13,26,40,77,-37,34,23
765,FG Rovers,5,10,31,33,85,-52,25,24
766,Derby County,27,11,8,74,38,36,92,1
766,Ipswich Town,26,13,7,87,43,44,91,2
766,Sheffield Weds,26,13,7,72,32,40,91,3
766,Barnsley,28,7,11,77,43,34,91,4
766,Plymouth Argyle,26,11,9,84,54,30,89,5
766,Bolton,23,11,12,71,39,32,80,6
766,Wycombe,23,9,14,63,45,18,78,7
766,P'borough Utd,23,8,15,75,52,23,77,8
766,Portsmouth,19,14,13,60,46,14,71,9
766,Lincoln City,16,22,8,50,41,9,70,10
766,Fleetwood Town,15,17,14,51,46,5,62,11
766,Charlton Ath,16,13,17,66,61,5,61,12
766,Exeter City,15,14,17,57,55,2,59,13
766,Shrewsbury,16,9,21,48,57,-9,57,14
766,Bristol Rovers,14,13,19,67,81,-14,55,15
766,Port Vale,14,10,22,43,67,-24,52,16
766,Oxford United,13,12,21,43,53,-10,51,17
766,Cheltenham,14,8,24,38,60,-22,50,18
766,Acc'ton Stanley,10,14,22,34,63,-29,44,19
766,Burton Albion,11,11,24,49,89,-40,44,20
766,MK Dons,11,9,26,39,67,-28,42,21
766,Morecambe,9,14,23,37,67,-30,41,22
766,Cambridge Utd,9,10,27,35,70,-35,37,23
766,FG Rovers,7,9,30,37,88,-51,30,24
767,Sheffield Weds,29,11,6,87,33,54,98,1
767,Plymouth Argyle,28,11,7,84,50,34,95,2
767,Barnsley,29,6,11,81,40,41,93,3
767,Ipswich Town,25,16,5,85,39,46,91,4
767,Derby County,24,13,9,71,36,35,85,5
767,Bolton,23,12,11,66,34,32,81,6
767,Wycombe,22,10,14,64,46,18,76,7
767,Portsmouth,18,16,12,61,51,10,70,8
767,Fleetwood Town,18,14,14,49,42,7,68,9
767,P'borough Utd,20,7,19,73,63,10,67,10
767,Charlton Ath,16,15,15,65,57,8,63,11
767,Shrewsbury,18,9,19,54,51,3,63,12
767,Port Vale,17,9,20,46,58,-12,60,13
767,Exeter City,15,12,19,55,56,-1,57,14
767,Lincoln City,12,21,13,42,43,-1,57,15
767,Bristol Rovers,15,11,20,61,73,-12,56,16
767,Oxford United,13,13,20,45,57,-12,52,17
767,MK Dons,13,8,25,48,75,-27,47,18
767,Acc'ton Stanley,11,14,21,38,67,-29,47,19
767,Cheltenham,9,15,22,32,60,-28,42,20
767,Cambridge Utd,10,10,26,35,73,-38,40,21
767,Burton Albion,10,10,26,48,95,-47,40,22
767,Morecambe,8,11,27,46,81,-35,35,23
767,FG Rovers,7,10,29,35,91,-56,31,24
768,Sheffield Weds,30,11,5,81,27,54,101,1
768,Plymouth Argyle,28,13,5,88,47,41,97,2
768,Barnsley,26,12,8,70,35,35,90,3
768,Ipswich Town,24,15,7,83,46,37,87,4
768,Bolton,25,9,12,65,38,27,84,5
768,Derby County,24,11,11,74,43,31,83,6
768,Wycombe,22,10,14,66,46,20,76,7
768,Shrewsbury,21,10,15,58,45,13,73,8
768,P'borough Utd,21,8,17,73,58,15,71,9
768,Portsmouth,18,15,13,73,53,20,69,10
768,Fleetwood Town,17,16,13,55,41,14,67,11
768,Charlton Ath,14,18,14,67,58,9,60,12
768,Exeter City,16,10,20,63,66,-3,58,13
768,Lincoln City,9,26,11,41,50,-9,53,14
768,Port Vale,14,11,21,47,70,-23,53,15
768,Cheltenham,13,11,22,35,61,-26,50,16
768,Bristol Rovers,12,11,23,58,89,-31,47,17
768,Oxford United,10,14,22,45,60,-15,44,18
768,Burton Albion,11,11,24,52,83,-31,44,19
768,Acc'ton Stanley,9,15,22,38,70,-32,42,20
768,Morecambe,10,12,24,45,78,-33,42,21
768,MK Dons,10,10,26,39,72,-33,40,22
768,Cambridge Utd,10,9,27,34,72,-38,39,23
768,FG Rovers,8,12,26,37,79,-42,36,24
769,Sheffield Weds,31,11,4,92,35,57,104,1
769,Ipswich Town,25,16,5,85,41,44,91,2
769,Barnsley,26,9,11,71,40,31,87,3
769,Plymouth Argyle,25,11,10,78,51,27,86,4
769,P'borough Utd,24,9,13,87,57,30,81,5
769,Portsmouth,22,14,10,78,51,27,80,6
769,Derby County,22,13,11,71,45,26,79,7
769,Wycombe,23,8,15,71,51,20,77,8
769,Bolton,21,12,13,62,40,22,75,9
769,Fleetwood Town,16,15,15,51,44,7,63,10
769,Charlton Ath,16,15,15,64,59,5,63,11
769,Shrewsbury,16,14,16,52,50,2,62,12
769,Exeter City,16,11,19,62,66,-4,59,13
769,Bristol Rovers,14,14,18,63,78,-15,56,14
769,Lincoln City,10,23,13,38,46,-8,53,15
769,Morecambe,12,15,19,51,68,-17,51,16
769,Port Vale,14,8,24,47,65,-18,50,17
769,Cheltenham,13,9,24,38,68,-30,48,18
769,Acc'ton Stanley,12,12,22,40,72,-32,48,19
769,Burton Albion,12,9,25,57,90,-33,45,20
769,Oxford United,11,11,24,51,68,-17,44,21
769,MK Dons,11,9,26,39,66,-27,42,22
769,Cambridge Utd,11,8,27,36,74,-38,41,23
769,FG Rovers,7,8,31,33,92,-59,29,24
770,Sheffield Weds,31,10,5,85,34,51,103,1
770,Plymouth Argyle,26,11,9,91,58,33,89,2
770,Barnsley,27,7,12,87,43,44,88,3
770,Ipswich Town,24,16,6,84,44,40,88,4
770,Derby County,24,12,10,74,43,31,84,5
770,Wycombe,25,9,12,69,38,31,84,6
770,Bolton,24,9,13,67,37,30,81,7
770,P'borough Utd,24,6,16,74,55,19,78,8
770,Charlton Ath,20,13,13,68,52,16,73,9
770,Portsmouth,17,16,13,66,60,6,67,10
770,Shrewsbury,19,10,17,56,54,2,67,11
770,Fleetwood Town,15,17,14,53,48,5,62,12
770,Port Vale,16,11,19,51,63,-12,59,13
770,Lincoln City,11,21,14,42,49,-7,54,14
770,Oxford United,13,11,22,45,57,-12,50,15
770,Exeter City,13,11,22,58,75,-17,50,16
770,Bristol Rovers,13,11,22,60,82,-22,50,17
770,Burton Albion,12,11,23,52,90,-38,47,18
770,MK Dons,12,9,25,43,65,-22,45,19
770,Acc'ton Stanley,10,14,22,36,62,-26,44,20
770,Morecambe,11,11,24,42,72,-30,44,21
770,Cheltenham,11,10,25,37,65,-28,43,22
770,Cambridge Utd,8,10,28,29,69,-40,34,23
770,FG Rovers,8,10,28,39,93,-54,34,24
771,Sheffield Weds,30,11,5,83,29,54,101,1
771,Barnsley,28,8,10,77,37,40,92,2
771,Plymouth Argyle,26,12,8,80,50,30,90,3
771,Ipswich Town,25,14,7,85,45,40,89,4
771,Bolton,25,12,9,68,34,34,87,5
771,Derby County,24,12,10,74,39,35,84,6
771,Wycombe,20,9,17,62,46,16,69,7
771,Portsmouth,18,15,13,58,49,9,69,8
771,Fleetwood Town,17,17,12,58,46,12,68,9
771,P'borough Utd,20,7,19,76,62,14,67,10
771,Shrewsbury,18,12,16,55,52,3,66,11
771,Charlton Ath,16,14,16,66,62,4,62,12
771,Exeter City,16,11,19,57,63,-6,59,13
771,Bristol Rovers,17,8,21,70,83,-13,59,14
771,Lincoln City,12,21,13,45,51,-6,57,15
771,Port Vale,15,8,23,45,66,-21,53,16
771,Oxford United,13,11,22,46,59,-13,50,17
771,Burton Albion,13,11,22,51,79,-28,50,18
771,Acc'ton Stanley,12,13,21,40,61,-21,49,19
771,Cheltenham,12,11,23,31,56,-25,47,20
771,Cambridge Utd,11,11,24,40,69,-29,44,21
771,MK Dons,10,10,26,41,71,-30,40,22
771,Morecambe,8,14,24,41,82,-41,38,23
771,FG Rovers,5,10,31,32,90,-58,25,24
772,Sheffield Weds,31,11,4,80,27,53,104,1
772,Plymouth Argyle,29,9,8,88,49,39,96,2
772,Ipswich Town,27,13,6,91,42,49,94,3
772,Bolton,28,8,10,75,29,46,92,4
772,Barnsley,24,9,13,73,49,24,81,5
772,Derby County,22,13,11,74,44,30,79,6
772,Wycombe,23,10,13,62,43,19,79,7
772,Portsmouth,18,16,12,65,55,10,70,8
772,P'borough Utd,20,7,19,76,60,16,67,9
772,Shrewsbury,19,6,21,52,53,-1,63,10
772,Bristol Rovers,16,11,19,63,71,-8,59,11
772,Port Vale,16,11,19,54,64,-10,59,12
772,Fleetwood Town,15,13,18,47,48,-1,58,13
772,Charlton Ath,14,16,16,57,64,-7,58,14
772,Lincoln City,11,23,12,47,49,-2,56,15
772,Exeter City,14,11,21,57,67,-10,53,16
772,Oxford United,12,13,21,52,64,-12,49,17
772,Morecambe,12,12,22,50,76,-26,48,18
772,Burton Albion,12,11,23,54,90,-36,47,19
772,Cambridge Utd,12,9,25,39,71,-32,45,20
772,Cheltenham,12,7,27,33,63,-30,43,21
772,MK Dons,11,9,26,42,71,-29,42,22
772,Acc'ton Stanley,9,15,22,38,67,-29,42,23
772,FG Rovers,8,11,27,38,91,-53,35,24
773,Sheffield Weds,29,11,6,81,30,51,98,1
773,Plymouth Argyle,28,10,8,92,49,43,94,2
773,Ipswich Town,26,15,5,91,44,47,93,3
773,Barnsley,28,6,12,77,44,33,90,4
773,Derby County,23,15,8,72,42,30,84,5
773,Bolton,24,11,11,65,34,31,83,6
773,Wycombe,24,7,15,67,43,24,79,7
773,P'borough Utd,22,5,19,69,59,10,71,8
773,Portsmouth,17,17,12,64,48,16,68,9
773,Charlton Ath,18,12,16,66,55,11,66,10
773,Bristol Rovers,18,10,18,65,75,-10,64,11
773,Fleetwood Town,14,17,15,47,44,3,59,12
773,Shrewsbury,16,10,20,48,51,-3,58,13
773,Lincoln City,11,22,13,40,50,-10,55,14
773,Port Vale,15,10,21,52,66,-14,55,15
773,Exeter City,13,13,20,54,63,-9,52,16
773,Oxford United,13,11,22,49,59,-10,50,17
773,Cambridge Utd,13,10,23,35,65,-30,49,18
773,Burton Albion,12,10,24,54,85,-31,46,19
773,Acc'ton Stanley,10,16,20,35,71,-36,46,20
773,Cheltenham,11,12,23,32,58,-26,45,21
773,Morecambe,11,11,24,46,75,-29,44,22
773,MK Dons,10,7,29,36,73,-37,37,23
773,FG Rovers,6,12,28,33,87,-54,30,24
774,Sheffield Weds,30,12,4,84,31,53,102,1
774,Plymouth Argyle,28,9,9,87,59,28,93,2
774,Ipswich Town,23,17,6,81,44,37,86,3
774,Bolton,25,10,11,64,34,30,85,4
774,Barnsley,26,7,13,74,47,27,85,5
774,P'borough Utd,25,7,14,83,55,28,82,6
774,Wycombe,25,7,14,64,43,21,82,7
774,Derby County,23,12,11,72,41,31,81,8
774,Portsmouth,17,17,12,64,55,9,68,9
774,Charlton Ath,17,16,13,72,62,10,67,10
774,Shrewsbury,17,10,19,53,53,0,61,11
774,Fleetwood Town,15,15,16,50,45,5,60,12
774,Exeter City,16,10,20,57,60,-3,58,13
774,Bristol Rovers,16,10,20,70,78,-8,58,14
774,Port Vale,16,9,21,46,63,-17,57,15
774,Lincoln City,11,22,13,45,56,-11,55,16
774,Burton Albion,15,10,21,59,79,-20,55,17
774,Oxford United,13,12,21,49,57,-8,51,18
774,Cheltenham,11,11,24,35,65,-30,44,19
774,Acc'ton Stanley,9,14,23,39,72,-33,41,20
774,Cambridge Utd,10,10,26,42,73,-31,40,21
774,MK Dons,9,11,26,45,74,-29,38,22
774,Morecambe,8,12,26,42,78,-36,36,23
774,FG Rovers,7,10,29,34,87,-53,31,24
775,Sheffield Weds,30,13,3,87,30,57,103,1
775,Ipswich Town,24,16,6,86,39,47,88,2
775,Barnsley,26,10,10,74,43,31,88,3
775,Plymouth Argyle,26,10,10,87,57,30,88,4
775,Derby County,24,13,9,67,35,32,85,5
775,Bolton,22,12,12,64,37,27,78,6
775,Portsmouth,20,15,11,70,53,17,75,7
775,Wycombe,22,9,15,59,42,17,75,8
775,Fleetwood Town,20,13,13,57,41,16,73,9
775,Shrewsbury,21,9,16,56,43,13,72,10
775,P'borough Utd,22,5,19,73,63,10,71,11
775,Exeter City,17,12,17,60,59,1,63,12
775,Lincoln City,13,21,12,44,42,2,60,13
775,Port Vale,17,8,21,54,69,-15,59,14
775,Charlton Ath,14,14,18,64,68,-4,56,15
775,Oxford United,13,13,20,47,57,-10,52,16
775,Bristol Rovers,13,13,20,61,81,-20,52,17
775,Burton Albion,13,11,22,60,86,-26,50,18
775,Morecambe,11,13,22,45,67,-22,46,19
775,Cheltenham,9,14,23,36,67,-31,41,20
775,Cambridge Utd,10,9,27,38,78,-40,39,21
775,Acc'ton Stanley,8,13,25,35,73,-38,37,22
775,MK Dons,9,9,28,38,70,-32,36,23
775,FG Rovers,5,11,30,33,95,-62,26,24
776,Sheffield Weds,32,10,4,83,29,54,106,1
776,Plymouth Argyle,26,14,6,81,51,30,92,2
776,Ipswich Town,24,14,8,85,44,41,86,3
776,Bolton,25,8,13,67,35,32,83,4
776,Barnsley,24,10,12,71,42,29,82,5
776,Wycombe,24,9,13,69,44,25,81,6
776,Derby County,22,14,10,75,43,32,80,7
776,Portsmouth,20,16,10,68,44,24,76,8
776,Shrewsbury,22,8,16,58,51,7,74,9
776,P'borough Utd,22,7,17,74,59,15,73,10
776,Exeter City,18,12,16,63,57,6,66,11
776,Fleetwood Town,16,14,16,56,51,5,62,12
776,Lincoln City,14,19,13,48,48,0,61,13
776,Charlton Ath,14,15,17,62,58,4,57,14
776,MK Dons,15,8,23,48,65,-17,53,15
776,Port Vale,13,12,21,47,64,-17,51,16
776,Bristol Rovers,12,14,20,64,82,-18,50,17
776,Morecambe,12,10,24,46,73,-27,46,18
776,Acc'ton Stanley,10,15,21,41,75,-34,45,19
776,Burton Albion,12,9,25,52,88,-36,45,20
776,Cheltenham,12,8,26,33,60,-27,44,21
776,Oxford United,10,11,25,43,68,-25,41,22
776,Cambridge Utd,11,5,30,35,82,-47,38,23
776,FG Rovers,6,10,30,38,94,-56,28,24
777,Sheffield Weds,29,13,4,76,27,49,100,1
777,Plymouth Argyle,30,8,8,88,51,37,98,2
777,Barnsley,27,8,11,73,41,32,89,3
777,Ipswich Town,24,15,7,80,44,36,87,4
777,Derby County,23,14,9,73,40,33,83,5
777,Wycombe,23,11,12,63,38,25,80,6
777,Bolton,23,10,13,59,41,18,79,7
777,Portsmouth,21,15,10,66,47,19,78,8
777,P'borough Utd,20,10,16,74,58,16,70,9
777,Charlton Ath,19,12,15,74,57,17,69,10
777,Lincoln City,15,19,12,45,46,-1,64,11
777,Shrewsbury,16,9,21,53,56,-3,57,12
777,Fleetwood Town,14,14,18,46,47,-1,56,13
777,Bristol Rovers,15,11,20,61,77,-16,56,14
777,Exeter City,14,12,20,62,65,-3,54,15
777,Morecambe,14,11,21,49,65,-16,53,16
777,Port Vale,13,10,23,46,70,-24,49,17
777,Burton Albion,11,13,22,58,85,-27,46,18
777,Cheltenham,12,10,24,36,64,-28,46,19
777,Acc'ton Stanley,10,14,22,39,72,-33,44,20
777,Oxford United,11,10,25,45,64,-19,43,21
777,MK Dons,10,12,24,45,70,-25,42,22
777,FG Rovers,9,11,26,40,81,-41,38,23
777,Cambridge Utd,10,6,30,31,76,-45,36,24
778,Sheffield Weds,31,10,5,84,31,53,103,1
778,Plymouth Argyle,28,11,7,87,48,39,95,2
778,Ipswich Town,25,14,7,95,48,47,89,3
778,Barnsley,26,10,10,69,36,33,88,4
778,Derby County,24,11,11,71,37,34,83,5
778,Bolton,23,11,12,68,36,32,80,6
778,Wycombe,23,10,13,67,43,24,79,7
778,Shrewsbury,21,9,16,54,49,5,72,8
778,Portsmouth,19,14,13,62,49,13,71,9
778,Fleetwood Town,16,17,13,53,44,9,65,10
778,P'borough Utd,19,7,20,71,60,11,64,11
778,Charlton Ath,16,14,16,63,60,3,62,12
778,Exeter City,15,14,17,59,59,0,59,13
778,Lincoln City,11,24,11,42,47,-5,57,14
778,Oxford United,13,13,20,45,53,-8,52,15
778,Bristol Rovers,14,10,22,62,84,-22,52,16
778,Burton Albion,13,10,23,54,82,-28,49,17
778,Acc'ton Stanley,11,14,21,46,71,-25,47,18
778,Port Vale,13,8,25,42,74,-32,47,19
778,Morecambe,10,15,21,42,68,-26,45,20
778,Cheltenham,11,11,24,35,66,-31,44,21
778,MK Dons,10,11,25,39,67,-28,41,22
778,Cambridge Utd,11,8,27,33,74,-41,41,23
778,FG Rovers,6,10,30,36,93,-57,28,24
779,Sheffield Weds,30,11,5,87,32,55,101,1
779,Plymouth Argyle,27,11,8,89,50,39,92,2
779,Ipswich Town,24,13,9,80,44,36,85,3
779,Barnsley,26,7,13,73,46,27,85,4
779,Bolton,24,11,11,70,35,35,83,5
779,Wycombe,24,9,13,59,40,19,81,6
779,Derby County,22,13,11,68,41,27,79,7
779,Portsmouth,21,15,10,69,44,25,78,8
779,P'borough Utd,25,3,18,73,53,20,78,9
779,Shrewsbury,19,9,18,55,50,5,66,10
779,Bristol Rovers,17,10,19,65,71,-6,61,11
779,Port Vale,17,10,19,49,64,-15,61,12
779,Fleetwood Town,14,18,14,46,42,4,60,13
779,Exeter City,16,12,18,56,56,0,60,14
779,Charlton Ath,14,15,17,64,63,1,57,15
779,Lincoln City,11,23,12,38,42,-4,56,16
779,Oxford United,13,13,20,48,59,-11,52,17
779,Burton Albion,13,10,23,51,82,-31,49,18
779,MK Dons,12,9,25,43,72,-29,45,19
779,Morecambe,10,13,23,43,75,-32,43,20
779,Acc'ton Stanley,10,12,24,42,69,-27,42,21
779,Cheltenham,10,9,27,27,61,-34,39,22
779,Cambridge Utd,10,9,27,37,77,-40,39,23
779,FG Rovers,5,11,30,30,94,-64,26,24
780,Sheffield Weds,31,11,4,96,32,64,104,1
780,Plymouth Argyle,27,12,7,83,49,34,93,2
780,Barnsley,27,8,11,74,37,37,89,3
780,Ipswich Town,23,16,7,84,45,39,85,4
780,Derby County,24,13,9,72,41,31,85,5
780,Bolton,25,10,11,70,40,30,85,6
780,Portsmouth,19,16,11,61,48,13,73,7
780,Wycombe,21,9,16,66,51,15,72,8
780,Charlton Ath,17,15,14,70,57,13,66,9
780,Exeter City,16,14,16,61,57,4,62,10
780,Shrewsbury,18,8,20,53,52,1,62,11
780,P'borough Utd,18,7,21,62,61,1,61,12
780,Lincoln City,14,19,13,45,46,-1,61,13
780,Bristol Rovers,15,12,19,62,71,-9,57,14
780,Port Vale,16,9,21,53,68,-15,57,15
780,Fleetwood Town,13,16,17,47,49,-2,55,16
780,Cheltenham,14,11,21,37,66,-29,53,17
780,Oxford United,11,14,21,45,58,-13,47,18
780,Acc'ton Stanley,10,16,20,37,63,-26,46,19
780,Burton Albion,11,13,22,62,96,-34,46,20
780,Cambridge Utd,11,10,25,35,67,-32,43,21
780,Morecambe,8,14,24,41,71,-30,38,22
780,MK Dons,9,11,26,38,72,-34,38,23
780,FG Rovers,7,10,29,34,91,-57,31,24
781,Sheffield Weds,30,10,6,83,32,51,100,1
781,Bolton,27,9,10,73,34,39,90,2
781,Plymouth Argyle,27,9,10,84,54,30,90,3
781,Derby County,26,9,11,80,39,41,87,4
781,Barnsley,26,7,13,74,41,33,85,5
781,Ipswich Town,23,14,9,77,46,31,83,6
781,P'borough Utd,23,5,18,75,57,18,74,7
781,Wycombe,22,7,17,59,48,11,73,8
781,Charlton Ath,19,14,13,71,54,17,71,9
781,Shrewsbury,21,8,17,60,46,14,71,10
781,Portsmouth,17,16,13,60,52,8,67,11
781,Lincoln City,15,19,12,46,43,3,64,12
781,Port Vale,16,12,18,52,56,-4,60,13
781,Fleetwood Town,15,14,17,50,51,-1,59,14
781,Exeter City,15,10,21,54,59,-5,55,15
781,Acc'ton Stanley,14,11,21,46,70,-24,53,16
781,Oxford United,13,12,21,50,63,-13,51,17
781,Bristol Rovers,13,11,22,62,83,-21,50,18
781,Cambridge Utd,13,6,27,37,71,-34,45,19
781,Burton Albion,12,9,25,51,86,-35,45,20
781,Morecambe,10,13,23,45,74,-29,43,21
781,Cheltenham,11,9,26,32,68,-36,42,22
781,MK Dons,10,8,28,35,78,-43,38,23
781,FG Rovers,8,10,28,30,81,-51,34,24
782,Sheffield Weds,31,9,6,92,35,57,102,1
782,Plymouth Argyle,28,10,8,94,51,43,94,2
782,Ipswich Town,24,17,5,89,47,42,89,3
782,Derby County,25,11,10,75,39,36,86,4
782,Bolton,24,11,11,70,36,34,83,5
782,Barnsley,24,10,12,70,45,25,82,6
782,Wycombe,23,9,14,67,44,23,78,7
782,P'borough Utd,22,6,18,78,66,12,72,8
782,Charlton Ath,18,14,14,71,55,16,68,9
782,Fleetwood Town,17,15,14,56,47,9,66,10
782,Portsmouth,17,14,15,64,56,8,65,11
782,Port Vale,18,8,20,48,64,-16,62,12
782,Shrewsbury,18,7,21,58,63,-5,61,13
782,Lincoln City,13,19,14,45,52,-7,58,14
782,Bristol Rovers,16,10,20,61,72,-11,58,15
782,Exeter City,15,12,19,58,61,-3,57,16
782,MK Dons,12,11,23,43,66,-23,47,17
782,Morecambe,11,14,21,51,77,-26,47,18
782,Burton Albion,13,8,25,57,88,-31,47,19
782,Cambridge Utd,13,7,26,40,70,-30,46,20
782,Oxford United,11,12,23,45,65,-20,45,21
782,Acc'ton Stanley,10,12,24,37,83,-46,42,22
782,Cheltenham,11,8,27,33,66,-33,41,23
782,FG Rovers,6,10,30,35,89,-54,28,24
783,Sheffield Weds,35,8,3,89,27,62,113,1
783,Ipswich Town,26,16,4,95,41,54,94,2
783,Plymouth Argyle,27,11,8,82,50,32,92,3
783,Barnsley,25,9,12,68,48,20,84,4
783,Bolton,22,13,11,64,34,30,79,5
783,Derby County,22,12,12,67,42,25,78,6
783,Wycombe,23,8,15,64,41,23,77,7
783,P'borough Utd,22,8,16,74,55,19,74,8
783,Portsmouth,18,14,14,65,51,14,68,9
783,Shrewsbury,18,10,18,54,50,4,64,10
783,Fleetwood Town,16,15,15,53,54,-1,63,11
783,Port Vale,16,11,19,52,61,-9,59,12
783,Lincoln City,12,20,14,44,49,-5,56,13
783,Exeter City,14,13,19,58,66,-8,55,14
783,Charlton Ath,14,12,20,60,62,-2,54,15
783,Bristol Rovers,14,12,20,57,74,-17,54,16
783,Cheltenham,15,7,24,35,54,-19,52,17
783,Burton Albion,14,10,22,59,80,-21,52,18
783,Oxford United,12,12,22,44,60,-16,48,19
783,MK Dons,11,11,24,38,67,-29,44,20
783,Morecambe,10,12,24,44,73,-29,42,21
783,Cambridge Utd,11,9,26,33,67,-34,42,22
783,Acc'ton Stanley,9,12,25,35,81,-46,39,23
783,FG Rovers,8,11,27,36,83,-47,35,24
784,Sheffield Weds,28,9,9,81,29,52,93,1
784,Barnsley,28,7,11,80,40,40,91,2
784,Plymouth Argyle,26,11,9,75,48,27,89,3
784,Derby County,24,12,10,76,39,37,84,4
784,Ipswich Town,22,16,8,85,49,36,82,5
784,Bolton,24,10,12,65,37,28,82,6
784,Wycombe,25,7,14,64,39,25,82,7
784,Shrewsbury,24,7,15,62,42,20,79,8
784,P'borough Utd,24,5,17,77,55,22,77,9
784,Portsmouth,19,15,12,63,53,10,72,10
784,Fleetwood Town,16,16,14,56,47,9,64,11
784,Charlton Ath,15,17,14,63,56,7,62,12
784,Port Vale,17,10,19,52,64,-12,61,13
784,Exeter City,15,15,16,58,56,2,60,14
784,Lincoln City,13,21,12,45,45,0,60,15
784,Bristol Rovers,14,10,22,65,87,-22,52,16
784,Oxford United,11,12,23,47,66,-19,45,17
784,Cheltenham,11,10,25,31,59,-28,43,18
784,Acc'ton Stanley,9,16,21,37,68,-31,43,19
784,Burton Albion,11,10,25,50,91,-41,43,20
784,Cambridge Utd,10,12,24,38,72,-34,42,21
784,Morecambe,9,14,23,45,78,-33,41,22
784,MK Dons,10,10,26,39,71,-32,40,23
784,FG Rovers,6,10,30,33,96,-63,28,24
785,Sheffield Weds,33,10,3,84,24,60,109,1
785,Plymouth Argyle,25,14,7,80,48,32,89,2
785,Barnsley,27,8,11,68,40,28,89,3
785,Ipswich Town,23,14,9,80,44,36,83,4
785,P'borough Utd,24,7,15,83,55,28,79,5
785,Bolton,22,11,13,65,40,25,77,6
785,Derby County,22,11,13,71,48,23,77,7
785,Wycombe,22,9,15,58,42,16,75,8
785,Shrewsbury,20,10,16,57,46,11,70,9
785,Portsmouth,17,13,16,59,54,5,64,10
785,Charlton Ath,16,14,16,64,59,5,62,11
785,Fleetwood Town,16,14,16,50,46,4,62,12
785,Bristol Rovers,17,8,21,70,80,-10,59,13
785,Exeter City,15,13,18,61,58,3,58,14
785,Port Vale,15,10,21,44,62,-18,55,15
785,Oxford United,14,12,20,52,62,-10,54,16
785,Lincoln City,10,23,13,38,46,-8,53,17
785,Acc'ton Stanley,12,13,21,39,68,-29,49,18
785,Cheltenham,13,9,24,34,56,-22,48,19
785,Burton Albion,12,12,22,51,79,-28,48,20
785,Cambridge Utd,11,10,25,38,69,-31,43,21
785,Morecambe,9,15,22,46,79,-33,42,22
785,MK Dons,11,7,28,39,71,-32,40,23
785,FG Rovers,7,11,28,33,88,-55,32,24
786,Plymouth Argyle,27,12,7,84,49,35,93,1
786,Sheffield Weds,26,14,6,73,30,43,92,2
786,Barnsley,28,8,10,73,36,37,92,3
786,Ipswich Town,26,12,8,88,43,45,90,4
786,Bolton,24,11,11,69,40,29,83,5
786,Derby County,23,12,11,75,43,32,81,6
786,Portsmouth,23,12,11,72,52,20,81,7
786,Wycombe,22,8,16,61,44,17,74,8
786,Charlton Ath,20,12,14,68,52,16,72,9
786,Shrewsbury,19,10,17,57,49,8,67,10
786,P'borough Utd,19,9,18,70,60,10,66,11
786,Exeter City,18,11,17,65,61,4,65,12
786,Fleetwood Town,16,15,15,48,43,5,63,13
786,Lincoln City,12,21,13,42,46,-4,57,14
786,Port Vale,15,10,21,47,66,-19,55,15
786,Cheltenham,14,10,22,37,57,-20,52,16
786,Burton Albion,13,10,23,59,90,-31,49,17
786,Oxford United,11,15,20,43,56,-13,48,18
786,Bristol Rovers,13,9,24,60,84,-24,48,19
786,Acc'ton Stanley,11,15,20,40,70,-30,48,20
786,Morecambe,9,15,22,42,69,-27,42,21
786,Cambridge Utd,9,8,29,33,77,-44,35,22
786,MK Dons,9,7,30,38,76,-38,34,23
786,FG Rovers,7,10,29,29,80,-51,31,24
787,Sheffield Weds,31,9,6,81,30,51,102,1
787,Barnsley,29,7,10,75,38,37,94,2
787,Plymouth Argyle,28,9,9,82,49,33,93,3
787,Derby County,25,11,10,81,41,40,86,4
787,Ipswich Town,23,17,6,79,40,39,86,5
787,Bolton,24,10,12,67,39,28,82,6
787,P'borough Utd,21,7,18,69,56,13,70,7
787,Wycombe,19,11,16,57,45,12,68,8
787,Shrewsbury,20,7,19,56,56,0,67,9
787,Charlton Ath,17,13,16,72,60,12,64,10
787,Portsmouth,17,13,16,65,56,9,64,11
787,Fleetwood Town,16,16,14,48,42,6,64,12
787,Exeter City,16,13,17,56,54,2,61,13
787,Lincoln City,11,25,10,45,48,-3,58,14
787,Bristol Rovers,15,9,22,62,78,-16,54,15
787,Port Vale,13,13,20,43,63,-20,52,16
787,Oxford United,13,12,21,52,61,-9,51,17
787,MK Dons,13,11,22,43,64,-21,50,18
787,Acc'ton Stanley,11,13,22,39,67,-28,46,19
787,Burton Albion,12,10,24,57,88,-31,46,20
787,Cheltenham,9,15,22,31,59,-28,42,21
787,Morecambe,10,12,24,48,81,-33,42,22
787,Cambridge Utd,11,9,26,40,76,-36,42,23
787,FG Rovers,7,10,29,37,94,-57,31,24
788,Sheffield Weds,27,11,8,81,39,42,92,1
788,Bolton,24,11,11,68,33,35,83,2
788,Plymouth Argyle,24,11,11,84,55,29,83,3
788,Barnsley,24,10,12,68,45,23,82,4
788,Derby County,22,12,12,66,42,24,78,5
788,Ipswich Town,19,20,7,73,47,26,77,6
788,Wycombe,22,10,14,64,47,17,76,7
788,P'borough Utd,22,9,15,78,55,23,75,8
788,Portsmouth,20,13,13,68,49,19,73,9
788,Fleetwood Town,17,16,13,55,44,11,67,10
788,Shrewsbury,19,10,17,57,50,7,67,11
788,Charlton Ath,16,16,14,66,55,11,64,12
788,Exeter City,15,16,15,63,62,1,61,13
788,Lincoln City,11,27,8,45,43,2,60,14
788,Bristol Rovers,16,12,18,67,81,-14,60,15
788,Port Vale,16,8,22,47,66,-19,56,16
788,Cheltenham,13,11,22,36,58,-22,50,17
788,Oxford United,12,13,21,48,56,-8,49,18
788,MK Dons,13,9,24,44,67,-23,48,19
788,Morecambe,10,15,21,45,69,-24,45,20
788,Burton Albion,10,14,22,49,78,-29,44,21
788,Acc'ton Stanley,10,13,23,39,71,-32,43,22
788,Cambridge Utd,12,6,28,38,76,-38,42,23
788,FG Rovers,6,11,29,30,91,-61,29,24
789,Sheffield Weds,31,11,4,81,29,52,104,1
789,Ipswich Town,28,13,5,87,37,50,97,2
789,Plymouth Argyle,29,10,7,94,57,37,97,3
789,Barnsley,27,8,11,65,36,29,89,4
789,Bolton,25,12,9,73,31,42,87,5
789,P'borough Utd,24,8,14,78,52,26,80,6
789,Derby County,21,12,13,68,51,17,75,7
789,Wycombe,20,11,15,61,47,14,71,8
789,Portsmouth,18,15,13,65,49,16,69,9
789,Charlton Ath,16,14,16,60,54,6,62,10
789,Fleetwood Town,15,17,14,52,48,4,62,11
789,Shrewsbury,17,8,21,57,68,-11,59,12
789,Lincoln City,11,24,11,42,48,-6,57,13
789,Bristol Rovers,14,12,20,65,83,-18,54,14
789,Exeter City,13,14,19,56,58,-2,53,15
789,Oxford United,13,13,20,44,52,-8,52,16
789,Burton Albion,13,11,22,58,80,-22,50,17
789,Port Vale,13,11,22,44,66,-22,50,18
789,Acc'ton Stanley,12,14,20,43,67,-24,50,19
789,MK Dons,11,10,25,46,68,-22,43,20
789,Cheltenham,11,9,26,34,67,-33,42,21
789,Morecambe,9,14,23,43,71,-28,41,22
789,Cambridge Utd,8,9,29,33,80,-47,33,23
789,FG Rovers,7,12,27,38,88,-50,33,24
790,Sheffield Weds,32,9,5,86,34,52,105,1
790,Plymouth Argyle,28,12,6,83,48,35,96,2
790,Ipswich Town,26,13,7,85,40,45,91,3
790,Derby County,27,10,9,77,39,38,91,4
790,Barnsley,27,9,10,80,41,39,90,5
790,Bolton,25,9,12,73,39,34,84,6
790,Wycombe,24,9,13,65,42,23,81,7
790,P'borough Utd,25,4,17,81,58,23,79,8
790,Shrewsbury,18,11,17,53,51,2,65,9
790,Portsmouth,17,14,15,60,59,1,65,10
790,Charlton Ath,16,14,16,65,63,2,62,11
790,Fleetwood Town,15,16,15,51,50,1,61,12
790,Lincoln City,9,26,11,47,55,-8,53,13
790,Acc'ton Stanley,12,16,18,41,58,-17,52,14
790,Oxford United,13,12,21,53,65,-12,51,15
790,Bristol Rovers,14,9,23,65,84,-19,51,16
790,Burton Albion,14,9,23,55,83,-28,51,17
790,Exeter City,12,13,21,54,67,-13,49,18
790,Cheltenham,12,11,23,41,63,-22,47,19
790,MK Dons,12,9,25,39,62,-23,45,20
790,Port Vale,12,9,25,46,77,-31,45,21
790,Cambridge Utd,12,8,26,40,68,-28,44,22
790,Morecambe,8,11,27,41,79,-38,35,23
790,FG Rovers,5,11,30,32,88,-56,26,24
791,Sheffield Weds,27,14,5,81,30,51,95,1
791,Ipswich Town,25,17,4,83,40,43,92,2
791,Plymouth Argyle,27,9,10,86,60,26,90,3
791,Derby County,24,12,10,76,44,32,84,4
791,Barnsley,24,10,12,68,46,22,82,5
791,Bolton,22,13,11,63,38,25,79,6
791,Wycombe,23,8,15,66,43,23,77,7
791,P'borough Utd,24,5,17,71,53,18,77,8
791,Portsmouth,19,14,13,68,50,18,71,9
791,Shrewsbury,17,12,17,52,51,1,63,10
791,Exeter City,16,14,16,60,50,10,62,11
791,Bristol Rovers,16,12,18,60,65,-5,60,12
791,Fleetwood Town,15,14,17,46,45,1,59,13
791,Port Vale,17,8,21,48,62,-14,59,14
791,Charlton Ath,13,17,16,58,60,-2,56,15
791,Lincoln City,10,25,11,38,42,-4,55,16
791,Oxford United,12,13,21,47,61,-14,49,17
791,Morecambe,11,15,20,47,69,-22,48,18
791,Cheltenham,11,14,21,34,59,-25,47,19
791,Burton Albion,11,13,22,56,81,-25,46,20
791,Cambridge Utd,13,7,26,35,64,-29,46,21
791,Acc'ton Stanley,10,10,26,39,88,-49,40,22
791,MK Dons,10,8,28,40,72,-32,38,23
791,FG Rovers,8,10,28,34,83,-49,34,24
792,Sheffield Weds,28,12,6,78,30,48,96,1
792,Plymouth Argyle,28,10,8,81,53,28,94,2
792,Derby County,25,12,9,79,42,37,87,3
792,Barnsley,25,9,12,72,46,26,84,4
792,Ipswich Town,22,16,8,75,45,30,82,5
792,Bolton,23,12,11,59,33,26,81,6
792,Wycombe,24,9,13,66,41,25,81,7
792,P'borough Utd,24,7,15,76,53,23,79,8
792,Portsmouth,20,14,12,67,47,20,74,9
792,Shrewsbury,18,11,17,53,49,4,65,10
792,Exeter City,17,13,16,67,60,7,64,11
792,Oxford United,17,10,19,53,56,-3,61,12
792,Fleetwood Town,14,18,14,48,43,5,60,13
792,Lincoln City,12,23,11,41,41,0,59,14
792,Charlton Ath,15,12,19,65,61,4,57,15
792,Port Vale,14,10,22,44,62,-18,52,16
792,Bristol Rovers,14,9,23,60,78,-18,51,17
792,MK Dons,14,9,23,45,65,-20,51,18
792,Cheltenham,13,8,25,33,64,-31,47,19
792,Burton Albion,11,12,23,58,84,-26,45,20
792,Acc'ton Stanley,8,17,21,31,65,-34,41,21
792,Cambridge Utd,10,9,27,34,71,-37,39,22
792,Morecambe,9,12,25,40,79,-39,39,23
792,FG Rovers,6,8,32,31,88,-57,26,24
793,Sheffield Weds,30,9,7,84,34,50,99,1
793,Barnsley,28,9,9,75,43,32,93,2
793,Ipswich Town,26,14,6,89,37,52,92,3
793,Plymouth Argyle,24,13,9,86,61,25,85,4
793,Derby County,24,12,10,80,43,37,84,5
793,Wycombe,22,10,14,63,41,22,76,6
793,Bolton,21,11,14,60,42,18,74,7
793,P'borough Utd,23,5,18,69,53,16,74,8
793,Portsmouth,17,16,13,64,55,9,67,9
793,Shrewsbury,18,12,16,55,49,6,66,10
793,Fleetwood Town,15,17,14,53,47,6,62,11
793,Charlton Ath,15,14,17,63,64,-1,59,12
793,Oxford United,15,12,19,48,53,-5,57,13
793,Bristol Rovers,15,11,20,62,75,-13,56,14
793,Lincoln City,11,22,13,39,45,-6,55,15
793,Exeter City,13,15,18,56,60,-4,54,16
793,Port Vale,14,10,22,46,66,-20,52,17
793,Burton Albion,10,16,20,54,86,-32,46,18
793,Acc'ton Stanley,11,13,22,40,76,-36,46,19
793,Cheltenham,11,12,23,36,62,-26,45,20
793,Cambridge Utd,11,12,23,41,70,-29,45,21
793,Morecambe,9,17,20,42,67,-25,44,22
793,MK Dons,10,13,23,41,66,-25,43,23
793,FG Rovers,7,9,30,38,89,-51,30,24
794,Sheffield Weds,30,11,5,83,32,51,101,1
794,Plymouth Argyle,27,11,8,87,48,39,92,2
794,Derby County,26,12,8,77,40,37,90,3
794,Ipswich Town,24,17,5,87,43,44,89,4
794,Bolton,26,10,10,74,36,38,88,5
794,Barnsley,24,10,12,69,43,26,82,6
794,Portsmouth,21,14,11,72,45,27,77,7
794,P'borough Utd,23,7,16,81,56,25,76,8
794,Wycombe,23,7,16,64,49,15,76,9
794,Shrewsbury,19,11,16,58,52,6,68,10
794,Fleetwood Town,17,14,15,54,46,8,65,11
794,Lincoln City,14,23,9,51,48,3,65,12
794,Port Vale,17,10,19,51,62,-11,61,13
794,Charlton Ath,15,14,17,60,64,-4,59,14
794,Exeter City,14,13,19,56,62,-6,55,15
794,Oxford United,13,12,21,46,56,-10,51,16
794,Bristol Rovers,13,9,24,59,83,-24,48,17
794,Burton Albion,11,12,23,56,90,-34,45,18
794,Cheltenham,11,9,26,27,55,-28,42,19
794,Morecambe,9,14,23,39,74,-35,41,20
794,MK Dons,9,12,25,36,65,-29,39,21
794,Acc'ton Stanley,9,12,25,38,81,-43,39,22
794,Cambridge Utd,10,7,29,35,72,-37,37,23
794,FG Rovers,7,9,30,34,92,-58,30,24
795,Sheffield Weds,31,9,6,89,37,52,102,1
795,Plymouth Argyle,30,9,7,86,48,38,99,2
795,Ipswich Town,26,15,5,92,41,51,93,3
795,Barnsley,28,7,11,72,44,28,91,4
795,Wycombe,27,7,12,74,41,33,88,5
795,Bolton,25,12,9,70,36,34,87,6
795,Derby County,23,12,11,70,43,27,81,7
795,P'borough Utd,24,5,17,80,51,29,77,8
795,Portsmouth,18,17,11,63,55,8,71,9
795,Charlton Ath,18,13,15,76,61,15,67,10
795,Shrewsbury,19,9,18,55,49,6,66,11
795,Exeter City,17,11,18,62,59,3,62,12
795,Fleetwood Town,16,14,16,48,48,0,62,13
795,Lincoln City,11,19,16,43,50,-7,52,14
795,Bristol Rovers,13,11,22,66,87,-21,50,15
795,Port Vale,13,9,24,44,70,-26,48,16
795,Acc'ton Stanley,11,14,21,34,65,-31,47,17
795,Cheltenham,12,10,24,39,65,-26,46,18
795,Burton Albion,11,10,25,53,92,-39,43,19
795,Oxford United,10,12,24,43,65,-22,42,20
795,Morecambe,10,12,24,45,77,-32,42,21
795,MK Dons,10,11,25,41,68,-27,41,22
795,Cambridge Utd,10,9,27,34,73,-39,39,23
795,FG Rovers,5,11,30,34,88,-54,26,24
796,Sheffield Weds,30,12,4,88,31,57,102,1
796,Plymouth Argyle,27,12,7,83,49,34,93,2
796,Derby County,27,11,8,78,40,38,92,3
796,Wycombe,27,6,13,64,35,29,87,4
796,Ipswich Town,24,14,8,86,45,41,86,5
796,Bolton,25,10,11,68,38,30,85,6
796,Barnsley,22,9,15,61,52,9,75,7
796,Shrewsbury,20,11,15,54,43,11,71,8
796,P'borough Utd,20,8,18,72,61,11,68,9
796,Charlton Ath,17,13,16,63,57,6,64,10
796,Exeter City,17,12,17,66,63,3,63,11
796,Portsmouth,16,15,15,58,56,2,63,12
796,Fleetwood Town,15,16,15,52,50,2,61,13
796,Port Vale,17,10,19,53,57,-4,61,14
796,Bristol Rovers,16,10,20,64,75,-11,58,15
796,Lincoln City,12,20,14,41,47,-6,56,16
796,Oxford United,13,10,23,51,63,-12,49,17
796,Burton Albion,12,10,24,55,89,-34,46,18
796,Acc'ton Stanley,11,12,23,42,78,-36,45,19
796,Morecambe,11,11,24,46,72,-26,44,20
796,Cheltenham,11,11,24,33,62,-29,44,21
796,MK Dons,11,10,25,41,70,-29,43,22
796,Cambridge Utd,9,8,29,32,73,-41,35,23
796,FG Rovers,6,11,29,36,81,-45,29,24
797,Sheffield Weds,27,14,5,79,32,47,95,1
797,Plymouth Argyle,28,11,7,86,47,39,95,2
797,Ipswich Town,25,14,7,88,45,43,89,3
797,Barnsley,25,9,12,70,44,26,84,4
797,Derby County,23,13,10,72,38,34,82,5
797,Bolton,23,12,11,61,33,28,81,6
797,Portsmouth,22,15,9,72,50,22,81,7
797,Wycombe,24,8,14,67,47,20,80,8
797,P'borough Utd,22,7,17,76,60,16,73,9
797,Fleetwood Town,18,16,12,56,44,12,70,10
797,Charlton Ath,18,14,14,70,53,17,68,11
797,Lincoln City,13,21,12,43,45,-2,60,12
797,Shrewsbury,16,8,22,51,57,-6,56,13
797,Exeter City,15,10,21,58,62,-4,55,14
797,Port Vale,14,12,20,43,62,-19,54,15
797,Burton Albion,12,14,20,53,81,-28,50,16
797,Morecambe,11,16,19,46,68,-22,49,17
797,Oxford United,11,14,21,44,58,-14,47,18
797,Cambridge Utd,13,8,25,42,78,-36,47,19
797,Bristol Rovers,11,12,23,56,80,-24,45,20
797,Cheltenham,11,9,26,35,66,-31,42,21
797,MK Dons,10,8,28,43,76,-33,38,22
797,Acc'ton Stanley,7,15,24,36,74,-38,36,23
797,FG Rovers,8,10,28,38,85,-47,34,24
798,Plymouth Argyle,28,11,7,92,48,44,95,1
798,Sheffield Weds,25,13,8,75,33,42,88,2
798,Barnsley,26,10,10,74,41,33,88,3
798,Bolton,24,12,10,68,33,35,84,4
798,Wycombe,25,7,14,67,44,23,82,5
798,Ipswich Town,21,15,10,77,49,28,78,6
798,Derby County,21,14,11,69,48,21,77,7
798,P'borough Utd,21,9,16,76,61,15,72,8
798,Charlton Ath,19,12,15,70,61,9,69,9
798,Lincoln City,16,20,10,48,43,5,68,10
798,Portsmouth,17,16,13,65,56,9,67,11
798,Shrewsbury,18,10,18,51,50,1,64,12
798,Fleetwood Town,15,15,16,49,44,5,60,13
798,Exeter City,16,12,18,62,61,1,60,14
798,Port Vale,16,9,21,46,63,-17,57,15
798,Bristol Rovers,15,10,21,65,79,-14,55,16
798,Oxford United,12,14,20,47,59,-12,50,17
798,Acc'ton Stanley,11,15,20,39,64,-25,48,18
798,MK Dons,13,8,25,47,70,-23,47,19
798,Burton Albion,11,13,22,53,88,-35,46,20
798,Cheltenham,12,9,25,34,62,-28,45,21
798,Morecambe,11,11,24,45,75,-30,44,22
798,Cambridge Utd,11,9,26,39,73,-34,42,23
798,FG Rovers,6,10,30,33,86,-53,28,24
799,Sheffield Weds,30,11,5,86,35,51,101,1
799,Plymouth Argyle,28,9,9,91,51,40,93,2
799,Derby County,25,11,10,80,44,36,86,3
799,Ipswich Town,23,15,8,84,51,33,84,4
799,Barnsley,24,9,13,66,43,23,81,5
799,Bolton,23,10,13,63,35,28,79,6
799,Wycombe,23,10,13,67,41,26,79,7
799,P'borough Utd,23,6,17,78,55,23,75,8
799,Shrewsbury,22,8,16,59,50,9,74,9
799,Portsmouth,18,16,12,67,50,17,70,10
799,Lincoln City,14,22,10,47,45,2,64,11
799,Charlton Ath,16,15,15,67,59,8,63,12
799,Exeter City,15,13,18,57,56,1,58,13
799,Oxford United,15,12,19,52,53,-1,57,14
799,Fleetwood Town,13,18,15,47,53,-6,57,15
799,Bristol Rovers,15,12,19,62,81,-19,57,16
799,Port Vale,15,10,21,51,66,-15,55,17
799,Burton Albion,12,14,20,55,87,-32,50,18
799,MK Dons,11,11,24,38,64,-26,44,19
799,Morecambe,9,14,23,40,73,-33,41,20
799,Acc'ton Stanley,9,13,24,34,75,-41,40,21
799,Cheltenham,9,10,27,29,64,-35,37,22
799,FG Rovers,9,8,29,37,84,-47,35,23
799,Cambridge Utd,9,7,30,39,81,-42,34,24
800,Plymouth Argyle,29,9,8,86,49,37,96,1
800,Sheffield Weds,26,14,6,75,33,42,92,2
800,Derby County,26,12,8,76,36,40,90,3
800,Barnsley,27,6,13,72,42,30,87,4
800,Wycombe,26,7,13,70,41,29,85,5
800,Bolton,23,14,9,63,32,31,83,6
800,P'borough Utd,25,5,16,80,54,26,80,7
800,Ipswich Town,18,18,10,71,52,19,72,8
800,Portsmouth,18,15,13,60,49,11,69,9
800,Lincoln City,15,21,10,45,40,5,66,10
800,Shrewsbury,18,10,18,50,46,4,64,11
800,Fleetwood Town,15,15,16,50,48,2,60,12
800,Charlton Ath,15,14,17,61,57,4,59,13
800,Exeter City,15,13,18,55,57,-2,58,14
800,Port Vale,15,12,19,46,61,-15,57,15
800,Bristol Rovers,15,10,21,62,79,-17,55,16
800,Acc'ton Stanley,13,14,19,40,65,-25,53,17
800,Oxford United,12,13,21,45,60,-15,49,18
800,Morecambe,11,13,22,46,73,-27,46,19
800,Burton Albion,11,12,23,52,82,-30,45,20
800,MK Dons,12,8,26,42,66,-24,44,21
800,Cheltenham,10,9,27,36,68,-32,39,22
800,Cambridge Utd,9,7,30,35,78,-43,34,23
800,FG Rovers,8,9,29,36,86,-50,33,24
801,Sheffield Weds,31,11,4,85,32,53,104,1
801,Plymouth Argyle,31,9,6,91,49,42,102,2
801,Barnsley,28,7,11,75,40,35,91,3
801,Ipswich Town,24,14,8,80,44,36,86,4
801,Derby County,25,11,10,71,41,30,86,5
801,Bolton,25,9,12,68,38,30,84,6
801,Wycombe,24,10,12,67,41,26,82,7
801,P'borough Utd,23,6,17,75,53,22,75,8
801,Portsmouth,20,14,12,64,51,13,74,9
801,Shrewsbury,20,9,17,57,46,11,69,10
801,Fleetwood Town,16,15,15,53,44,9,63,11
801,Charlton Ath,15,15,16,67,63,4,60,12
801,Port Vale,15,10,21,47,67,-20,55,13
801,Lincoln City,11,20,15,41,47,-6,53,14
801,Exeter City,14,11,21,56,65,-9,53,15
801,Cheltenham,14,7,25,35,60,-25,49,16
801,Bristol Rovers,12,12,22,62,85,-23,48,17
801,Acc'ton Stanley,12,12,22,40,71,-31,48,18
801,Oxford United,12,11,23,45,62,-17,47,19
801,Burton Albion,12,11,23,60,84,-24,47,20
801,MK Dons,12,8,26,41,71,-30,44,21
801,Morecambe,9,14,23,44,77,-33,41,22
801,Cambridge Utd,9,8,29,35,76,-41,35,23
801,FG Rovers,6,10,30,34,86,-52,28,24
802,Sheffield Weds,29,11,6,89,32,57,98,1
802,Plymouth Argyle,27,12,7,80,50,30,93,2
802,Ipswich Town,25,13,8,91,43,48,88,3
802,Bolton,25,9,12,71,39,32,84,4
802,Wycombe,25,9,12,69,38,31,84,5
802,Barnsley,24,9,13,72,47,25,81,6
802,Derby County,22,13,11,71,44,27,79,7
802,Portsmouth,20,15,11,71,50,21,75,8
802,P'borough Utd,22,5,19,73,59,14,71,9
802,Lincoln City,16,19,11,52,47,5,67,10
802,Charlton Ath,17,14,15,64,56,8,65,11
802,Shrewsbury,18,7,21,54,61,-7,61,12
802,Fleetwood Town,15,15,16,47,44,3,60,13
802,Exeter City,15,13,18,58,60,-2,58,14
802,Bristol Rovers,15,11,20,66,87,-21,56,15
802,Port Vale,14,10,22,43,66,-23,52,16
802,Oxford United,12,15,19,53,62,-9,51,17
802,MK Dons,14,9,23,43,66,-23,51,18
802,Burton Albion,13,12,21,55,83,-28,51,19
802,Cheltenham,11,9,26,31,61,-30,42,20
802,Cambridge Utd,10,11,25,36,68,-32,41,21
802,Acc'ton Stanley,8,14,24,37,72,-35,38,22
802,Morecambe,8,13,25,40,79,-39,37,23
802,FG Rovers,6,14,26,34,86,-52,32,24
803,Sheffield Weds,31,12,3,81,26,55,105,1
803,Plymouth Argyle,28,10,8,86,46,40,94,2
803,Ipswich Town,26,13,7,83,40,43,91,3
803,Derby County,26,10,10,75,40,35,88,4
803,Barnsley,24,10,12,71,44,27,82,5
803,P'borough Utd,24,6,16,77,52,25,78,6
803,Portsmouth,21,13,12,60,49,11,76,7
803,Bolton,21,12,13,64,40,24,75,8
803,Wycombe,23,5,18,63,48,15,74,9
803,Charlton Ath,18,13,15,67,56,11,67,10
803,Shrewsbury,19,8,19,54,49,5,65,11
803,Lincoln City,13,23,10,42,42,0,62,12
803,Bristol Rovers,17,11,18,69,75,-6,62,13
803,Fleetwood Town,15,14,17,51,51,0,59,14
803,Exeter City,16,11,19,58,60,-2,59,15
803,Oxford United,13,11,22,49,65,-16,50,16
803,Burton Albion,13,11,22,54,79,-25,50,17
803,Cheltenham,12,10,24,35,63,-28,46,18
803,MK Dons,12,8,26,41,68,-27,44,19
803,Port Vale,11,10,25,38,65,-27,43,20
803,Cambridge Utd,12,7,27,37,76,-39,43,21
803,Acc'ton Stanley,10,12,24,35,71,-36,42,22
803,Morecambe,10,11,25,45,80,-35,41,23
803,FG Rovers,6,11,29,32,82,-50,29,24
804,Plymouth Argyle,31,8,7,95,45,50,101,1
804,Sheffield Weds,27,15,4,78,33,45,96,2
804,Ipswich Town,24,15,7,83,45,38,87,3
804,Derby County,25,11,10,81,42,39,86,4
804,Bolton,24,10,12,70,42,28,82,5
804,Wycombe,25,7,14,71,45,26,82,6
804,Barnsley,24,10,12,68,45,23,82,7
804,P'borough Utd,22,7,17,77,60,17,73,8
804,Portsmouth,18,17,11,65,53,12,71,9
804,Exeter City,19,10,17,63,56,7,67,10
804,Fleetwood Town,17,14,15,59,47,12,65,11
804,Shrewsbury,18,9,19,54,58,-4,63,12
804,Bristol Rovers,15,12,19,65,78,-13,57,13
804,Acc'ton Stanley,14,12,20,45,69,-24,54,14
804,Charlton Ath,14,11,21,66,70,-4,53,15
804,Port Vale,15,8,23,47,70,-23,53,16
804,Lincoln City,10,22,14,46,52,-6,52,17
804,Oxford United,13,12,21,49,59,-10,51,18
804,Burton Albion,12,12,22,54,88,-34,48,19
804,MK Dons,13,8,25,46,71,-25,47,20
804,Morecambe,10,14,22,48,76,-28,44,21
804,Cheltenham,11,7,28,31,66,-35,40,22
804,Cambridge Utd,10,9,27,34,69,-35,39,23
804,FG Rovers,5,12,29,32,88,-56,27,24
805,Plymouth Argyle,29,10,7,82,51,31,97,1
805,Sheffield Weds,28,11,7,77,32,45,95,2
805,Ipswich Town,24,16,6,85,42,43,88,3
805,Barnsley,26,7,13,76,47,29,85,4
805,Derby County,23,14,9,75,40,35,83,5
805,P'borough Utd,25,6,15,75,50,25,81,6
805,Wycombe,23,11,12,75,47,28,80,7
805,Bolton,22,13,11,61,35,26,79,8
805,Portsmouth,21,13,12,71,50,21,76,9
805,Fleetwood Town,15,17,14,54,48,6,62,10
805,Bristol Rovers,17,11,18,72,73,-1,62,11
805,Charlton Ath,16,13,17,68,68,0,61,12
805,Shrewsbury,16,9,21,45,55,-10,57,13
805,Port Vale,16,8,22,46,63,-17,56,14
805,Lincoln City,11,22,13,41,46,-5,55,15
805,Exeter City,13,15,18,53,56,-3,54,16
805,Cheltenham,13,13,20,36,58,-22,52,17
805,Burton Albion,13,11,22,55,83,-28,50,18
805,Oxford United,12,11,23,52,67,-15,47,19
805,Morecambe,10,15,21,49,70,-21,45,20
805,MK Dons,10,10,26,37,71,-34,40,21
805,Cambridge Utd,10,8,28,36,79,-43,38,22
805,Acc'ton Stanley,8,13,25,36,71,-35,37,23
805,FG Rovers,8,9,29,39,94,-55,33,24
806,Sheffield Weds,30,11,5,94,33,61,101,1
806,Plymouth Argyle,28,11,7,86,49,37,95,2
806,Ipswich Town,27,13,6,91,43,48,94,3
806,Barnsley,27,6,13,80,48,32,87,4
806,Bolton,25,10,11,68,36,32,85,5
806,P'borough Utd,25,6,15,93,60,33,81,6
806,Wycombe,24,8,14,69,44,25,80,7
806,Derby County,23,11,12,73,51,22,80,8
806,Portsmouth,19,14,13,61,53,8,71,9
806,Shrewsbury,19,9,18,56,52,4,66,10
806,Fleetwood Town,16,16,14,52,44,8,64,11
806,Bristol Rovers,17,11,18,67,73,-6,62,12
806,Charlton Ath,16,13,17,70,63,7,61,13
806,Exeter City,14,12,20,55,63,-8,54,14
806,Lincoln City,10,21,15,34,42,-8,51,15
806,Port Vale,14,9,23,48,68,-20,51,16
806,MK Dons,13,10,23,49,71,-22,49,17
806,Cheltenham,13,10,23,40,64,-24,49,18
806,Oxford United,11,12,23,47,66,-19,45,19
806,Morecambe,11,12,23,42,73,-31,45,20
806,Burton Albion,11,10,25,51,92,-41,43,21
806,Acc'ton Stanley,8,15,23,39,74,-35,39,22
806,Cambridge Utd,10,9,27,36,75,-39,39,23
806,FG Rovers,6,11,29,31,95,-64,29,24
807,Sheffield Weds,31,10,5,83,29,54,103,1
807,Plymouth Argyle,29,9,8,86,53,33,96,2
807,Bolton,27,9,10,72,35,37,90,3
807,Ipswich Town,25,14,7,89,42,47,89,4
807,Barnsley,26,8,12,74,42,32,86,5
807,Derby County,24,13,9,70,42,28,85,6
807,Wycombe,23,8,15,67,50,17,77,7
807,P'borough Utd,21,6,19,70,57,13,69,8
807,Shrewsbury,20,9,17,53,44,9,69,9
807,Fleetwood Town,16,15,15,49,44,5,63,10
807,Portsmouth,16,15,15,54,53,1,63,11
807,Charlton Ath,16,13,17,66,62,4,61,12
807,Oxford United,16,12,18,55,58,-3,60,13
807,Exeter City,15,10,21,54,62,-8,55,14
807,Bristol Rovers,15,10,21,61,76,-15,55,15
807,Port Vale,15,10,21,54,71,-17,55,16
807,Lincoln City,10,24,12,39,48,-9,54,17
807,Cheltenham,13,9,24,35,59,-24,48,18
807,Burton Albion,11,14,21,56,79,-23,47,19
807,Cambridge Utd,14,5,27,37,72,-35,47,20
807,MK Dons,11,9,26,44,67,-23,42,21
807,Morecambe,9,11,26,42,79,-37,38,22
807,Acc'ton Stanley,8,14,24,36,73,-37,38,23
807,FG Rovers,8,9,29,36,85,-49,33,24
808,Sheffield Weds,30,8,8,81,33,48,98,1
808,Ipswich Town,28,12,6,86,38,48,96,2
808,Barnsley,29,6,11,73,38,35,93,3
808,Plymouth Argyle,26,12,8,80,50,30,90,4
808,Portsmouth,23,14,9,67,45,22,83,5
808,Bolton,23,10,13,66,40,26,79,6
808,P'borough Utd,24,5,17,83,59,24,77,7
808,Wycombe,23,8,15,66,42,24,77,8
808,Derby County,21,13,12,72,50,22,76,9
808,Fleetwood Town,18,15,13,60,46,14,69,10
808,Lincoln City,15,19,12,45,47,-2,64,11
808,Shrewsbury,18,8,20,51,51,0,62,12
808,Exeter City,16,12,18,57,60,-3,60,13
808,Charlton Ath,14,14,18,59,59,0,56,14
808,Bristol Rovers,15,11,20,67,77,-10,56,15
808,Port Vale,14,10,22,46,65,-19,52,16
808,Burton Albion,13,12,21,52,80,-28,51,17
808,Oxford United,12,13,21,47,55,-8,49,18
808,MK Dons,14,7,25,44,70,-26,49,19
808,Morecambe,12,12,22,43,71,-28,48,20
808,Acc'ton Stanley,10,11,25,39,83,-44,41,21
808,Cheltenham,10,9,27,33,65,-32,39,22
808,Cambridge Utd,10,6,30,35,74,-39,36,23
808,FG Rovers,6,9,31,32,86,-54,27,24
809,Plymouth Argyle,29,8,9,80,52,28,95,1
809,Barnsley,28,8,10,77,40,37,92,2
809,Sheffield Weds,27,10,9,71,32,39,91,3
809,Derby County,27,10,9,72,36,36,91,4
809,Ipswich Town,23,15,8,83,47,36,84,5
809,Bolton,24,11,11,69,35,34,83,6
809,Wycombe,22,9,15,65,45,20,75,7
809,Portsmouth,19,14,13,69,59,10,71,8
809,Fleetwood Town,18,15,13,54,42,12,69,9
809,Shrewsbury,19,10,17,57,49,8,67,10
809,Charlton Ath,17,15,14,69,58,11,66,11
809,P'borough Utd,20,4,22,73,63,10,64,12
809,Exeter City,18,10,18,57,56,1,64,13
809,Lincoln City,13,21,12,41,47,-6,60,14
809,Bristol Rovers,16,10,20,66,77,-11,58,15
809,Port Vale,15,11,20,48,63,-15,56,16
809,Burton Albion,14,9,23,60,92,-32,51,17
809,Cheltenham,12,11,23,35,58,-23,47,18
809,Acc'ton Stanley,10,15,21,40,74,-34,45,19
809,Oxford United,10,14,22,46,61,-15,44,20
809,Morecambe,10,14,22,49,73,-24,44,21
809,MK Dons,10,8,28,40,72,-32,38,22
809,Cambridge Utd,9,7,30,36,76,-40,34,23
809,FG Rovers,7,11,28,31,81,-50,32,24
810,Sheffield Weds,30,13,3,84,28,56,103,1
810,Plymouth Argyle,29,8,9,85,50,35,95,2
810,Derby County,27,11,8,77,41,36,92,3
810,Ipswich Town,22,18,6,80,39,41,84,4
810,Barnsley,24,10,12,68,40,28,82,5
810,Wycombe,22,13,11,63,41,22,79,6
810,Bolton,22,12,12,67,36,31,78,7
810,P'borough Utd,23,6,17,79,53,26,75,8
810,Portsmouth,18,17,11,68,54,14,71,9
810,Charlton Ath,16,15,15,65,58,7,63,10
810,Port Vale,18,9,19,52,57,-5,63,11
810,Shrewsbury,17,10,19,51,53,-2,61,12
810,Exeter City,15,15,16,55,57,-2,60,13
810,Fleetwood Town,14,16,16,51,48,3,58,14
810,Lincoln City,10,21,15,41,50,-9,51,15
810,Oxford United,13,12,21,48,64,-16,51,16
810,Burton Albion,13,11,22,59,84,-25,50,17
810,Morecambe,12,13,21,49,68,-19,49,18
810,Cheltenham,14,7,25,34,64,-30,49,19
810,Bristol Rovers,12,10,24,58,90,-32,46,20
810,Acc'ton Stanley,10,14,22,36,71,-35,44,21
810,MK Dons,9,12,25,38,69,-31,39,22
810,Cambridge Utd,10,9,27,36,72,-36,39,23
810,FG Rovers,6,10,30,36,93,-57,28,24
811,Sheffield Weds,30,12,4,81,29,52,102,1
811,Plymouth Argyle,26,11,9,88,55,33,89,2
811,Barnsley,26,8,12,77,43,34,86,3
811,Ipswich Town,23,16,7,88,46,42,85,4
811,Wycombe,25,9,12,71,40,31,84,5
811,Bolton,23,13,10,70,38,32,82,6
811,Derby County,23,12,11,76,43,33,81,7
811,P'borough Utd,23,7,16,78,57,21,76,8
811,Portsmouth,16,19,11,60,53,7,67,9
811,Shrewsbury,18,11,17,54,54,0,65,10
811,Fleetwood Town,15,17,14,52,50,2,62,11
811,Charlton Ath,16,12,18,65,65,0,60,12
811,Lincoln City,12,24,10,49,51,-2,60,13
811,Exeter City,15,13,18,60,60,0,58,14
811,Burton Albion,15,10,21,59,91,-32,55,15
811,Bristol Rovers,13,12,21,59,79,-20,51,16
811,Port Vale,13,11,22,43,66,-23,50,17
811,Cambridge Utd,13,9,24,42,70,-28,48,18
811,Oxford United,11,14,21,46,57,-11,47,19
811,Acc'ton Stanley,10,17,19,44,67,-23,47,20
811,Morecambe,10,13,23,47,77,-30,43,21
811,Cheltenham,10,12,24,33,64,-31,42,22
811,MK Dons,8,11,27,39,71,-32,35,23
811,FG Rovers,6,11,29,34,89,-55,29,24
812,Sheffield Weds,27,13,6,81,36,45,94,1
812,Plymouth Argyle,28,9,9,88,48,40,93,2
812,Barnsley,29,6,11,81,42,39,93,3
812,Derby County,25,12,9,77,40,37,87,4
812,Ipswich Town,25,12,9,78,44,34,87,5
812,Bolton,26,9,11,63,32,31,87,6
812,Wycombe,24,10,12,70,40,30,82,7
812,P'borough Utd,24,7,15,70,48,22,79,8
812,Portsmouth,18,16,12,61,48,13,70,9
812,Shrewsbury,20,10,16,56,47,9,70,10
812,Charlton Ath,18,12,16,65,61,4,66,11
812,Lincoln City,12,22,12,42,48,-6,58,12
812,Port Vale,16,8,22,48,63,-15,56,13
812,Fleetwood Town,11,21,14,47,47,0,54,14
812,Exeter City,14,10,22,56,63,-7,52,15
812,Burton Albion,14,10,22,60,86,-26,52,16
812,Oxford United,13,11,22,49,61,-12,50,17
812,Bristol Rovers,12,11,23,57,88,-31,47,18
812,Cheltenham,11,11,24,34,63,-29,44,19
812,MK Dons,11,10,25,44,70,-26,43,20
812,Acc'ton Stanley,9,14,23,36,66,-30,41,21
812,Morecambe,10,11,25,42,74,-32,41,22
812,Cambridge Utd,10,9,27,33,75,-42,39,23
812,FG Rovers,7,12,27,39,87,-48,33,24
813,Sheffield Weds,30,11,5,89,36,53,101,1
813,Plymouth Argyle,29,11,6,89,47,42,98,2
813,Barnsley,27,10,9,79,41,38,91,3
813,Ipswich Town,24,15,7,82,45,37,87,4
813,P'borough Utd,26,6,14,84,53,31,84,5
813,Bolton,23,12,11,65,36,29,81,6
813,Derby County,21,12,13,69,47,22,75,7
813,Wycombe,22,8,16,66,46,20,74,8
813,Portsmouth,18,18,10,75,53,22,72,9
813,Charlton Ath,18,13,15,65,57,8,67,10
813,Fleetwood Town,17,16,13,52,44,8,67,11
813,Shrewsbury,17,9,20,53,58,-5,60,12
813,Lincoln City,13,19,14,44,50,-6,58,13
813,Port Vale,16,9,21,48,67,-19,57,14
813,Exeter City,14,13,19,59,65,-6,55,15
813,Bristol Rovers,14,11,21,63,92,-29,53,16
813,Burton Albion,14,10,22,58,84,-26,52,17
813,Morecambe,11,14,21,50,75,-25,47,18
813,Oxford United,10,12,24,45,63,-18,42,19
813,MK Dons,10,12,24,42,66,-24,42,20
813,Cheltenham,10,12,24,34,62,-28,42,21
813,Acc'ton Stanley,9,14,23,40,70,-30,41,22
813,Cambridge Utd,10,7,29,36,81,-45,37,23
813,FG Rovers,7,10,29,35,84,-49,31,24
814,Sheffield Weds,28,14,4,81,30,51,98,1
814,Ipswich Town,26,15,5,79,38,41,93,2
814,Plymouth Argyle,28,8,10,80,49,31,92,3
814,Derby County,25,12,9,73,35,38,87,4
814,Bolton,24,11,11,70,36,34,83,5
814,Barnsley,23,10,13,69,44,25,79,6
814,P'borough Utd,24,6,16,86,56,30,78,7
814,Wycombe,21,8,17,59,44,15,71,8
814,Charlton Ath,17,14,15,65,58,7,65,9
814,Portsmouth,15,19,12,60,50,10,64,10
814,Exeter City,17,12,17,61,64,-3,63,11
814,Port Vale,17,10,19,54,61,-7,61,12
814,Shrewsbury,17,9,20,51,58,-7,60,13
814,Lincoln City,13,20,13,46,52,-6,59,14
814,Oxford United,14,12,20,50,57,-7,54,15
814,Fleetwood Town,12,17,17,44,48,-4,53,16
814,Acc'ton Stanley,14,11,21,45,67,-22,53,17
814,Bristol Rovers,14,10,22,65,85,-20,52,18
814,Burton Albion,14,10,22,54,77,-23,52,19
814,Cheltenham,11,12,23,32,60,-28,45,20
814,Morecambe,9,15,22,43,75,-32,42,21
814,MK Dons,10,11,25,43,78,-35,41,22
814,Cambridge Utd,8,10,28,33,73,-40,34,23
814,FG Rovers,8,10,28,36,84,-48,34,24
815,Sheffield Weds,30,12,4,83,32,51,102,1
815,Plymouth Argyle,27,11,8,81,55,26,92,2
815,Ipswich Town,26,13,7,92,43,49,91,3
815,Derby County,26,10,10,79,42,37,88,4
815,Barnsley,25,12,9,70,38,32,87,5
815,Bolton,22,13,11,66,37,29,79,6
815,Wycombe,23,8,15,64,45,19,77,7
815,P'borough Utd,22,8,16,81,63,18,74,8
815,Portsmouth,19,16,11,67,53,14,73,9
815,Charlton Ath,17,14,15,71,61,10,65,10
815,Lincoln City,14,23,9,47,41,6,65,11
815,Exeter City,18,10,18,63,55,8,64,12
815,Fleetwood Town,16,15,15,50,46,4,63,13
815,Shrewsbury,17,9,20,55,55,0,60,14
815,Port Vale,15,11,20,47,66,-19,56,15
815,Bristol Rovers,13,11,22,62,82,-20,50,16
815,Burton Albion,12,12,22,58,87,-29,48,17
815,MK Dons,13,8,25,43,69,-26,47,18
815,Oxford United,11,13,22,44,60,-16,46,19
815,Cheltenham,12,7,27,33,62,-29,43,20
815,Acc'ton Stanley,10,13,23,41,77,-36,43,21
815,Cambridge Utd,12,6,28,41,74,-33,42,22
815,Morecambe,9,11,26,42,77,-35,38,23
815,FG Rovers,5,10,31,31,91,-60,25,24
816,Sheffield Weds,29,10,7,82,32,50,97,1
816,Plymouth Argyle,26,14,6,88,54,34,92,2
816,Ipswich Town,25,13,8,88,42,46,88,3
816,Barnsley,25,11,10,72,44,28,86,4
816,Wycombe,26,6,14,68,37,31,84,5
816,Bolton,24,12,10,62,34,28,84,6
816,P'borough Utd,24,6,16,73,57,16,78,7
816,Portsmouth,20,17,9,63,48,15,77,8
816,Derby County,21,13,12,63,41,22,76,9
816,Shrewsbury,20,7,19,58,57,1,67,10
816,Fleetwood Town,16,15,15,45,41,4,63,11
816,Charlton Ath,15,13,18,57,67,-10,58,12
816,Lincoln City,11,22,13,42,46,-4,55,13
816,Port Vale,14,11,21,47,62,-15,53,14
816,Burton Albion,14,11,21,61,78,-17,53,15
816,Exeter City,13,12,21,54,65,-11,51,16
816,MK Dons,14,9,23,44,62,-18,51,17
816,Bristol Rovers,13,11,22,61,80,-19,50,18
816,Cheltenham,13,11,22,38,60,-22,50,19
816,Oxford United,11,13,22,42,55,-13,46,20
816,Morecambe,9,17,20,42,69,-27,44,21
816,Acc'ton Stanley,9,15,22,34,66,-32,42,22
816,Cambridge Utd,11,6,29,36,73,-37,39,23
816,FG Rovers,6,11,29,34,84,-50,29,24
817,Sheffield Weds,32,9,5,92,30,62,105,1
817,Plymouth Argyle,28,9,9,87,55,32,93,2
817,Ipswich Town,26,14,6,90,45,45,92,3
817,Derby County,26,12,8,72,31,41,90,4
817,Barnsley,26,11,9,76,41,35,89,5
817,Bolton,23,12,11,68,36,32,81,6
817,Wycombe,22,9,15,64,44,20,75,7
817,Portsmouth,18,17,11,61,46,15,71,8
817,P'borough Utd,21,8,17,75,62,13,71,9
817,Shrewsbury,19,9,18,55,54,1,66,10
817,Port Vale,18,10,18,51,55,-4,64,11
817,Charlton Ath,16,13,17,66,62,4,61,12
817,Fleetwood Town,13,20,13,46,41,5,59,13
817,Lincoln City,12,23,11,45,47,-2,59,14
817,Exeter City,14,14,18,62,65,-3,56,15
817,Bristol Rovers,13,12,21,57,83,-26,51,16
817,Burton Albion,12,12,22,58,89,-31,48,17
817,Acc'ton Stanley,11,14,21,41,72,-31,47,18
817,Oxford United,11,11,24,45,61,-16,44,19
817,Morecambe,9,15,22,43,71,-28,42,20
817,Cheltenham,11,9,26,30,63,-33,42,21
817,Cambridge Utd,10,8,28,37,72,-35,38,22
817,MK Dons,9,11,26,37,72,-35,38,23
817,FG Rovers,6,10,30,32,93,-61,28,24
818,Sheffield Weds,32,9,5,91,36,55,105,1
818,Plymouth Argyle,28,12,6,86,47,39,96,2
818,Ipswich Town,25,14,7,86,48,38,89,3
818,Barnsley,26,7,13,69,43,26,85,4
818,Derby County,23,13,10,71,41,30,82,5
818,Portsmouth,22,15,9,69,51,18,81,6
818,Bolton,22,13,11,65,39,26,79,7
818,P'borough Utd,24,6,16,82,57,25,78,8
818,Wycombe,22,8,16,67,45,22,74,9
818,Shrewsbury,20,9,17,58,52,6,69,10
818,Charlton Ath,15,13,18,58,62,-4,58,11
818,Oxford United,14,14,18,53,55,-2,56,12
818,Fleetwood Town,12,19,15,47,47,0,55,13
818,Burton Albion,15,9,22,62,82,-20,54,14
818,Lincoln City,10,23,13,41,47,-6,53,15
818,Bristol Rovers,15,8,23,68,87,-19,53,16
818,Exeter City,13,13,20,55,66,-11,52,17
818,Port Vale,14,9,23,42,67,-25,51,18
818,Cheltenham,13,10,23,37,63,-26,49,19
818,Cambridge Utd,12,7,27,36,70,-34,43,20
818,Morecambe,8,17,21,42,68,-26,41,21
818,MK Dons,10,11,25,39,69,-30,41,22
818,Acc'ton Stanley,9,14,23,34,64,-30,41,23
818,FG Rovers,6,11,29,37,89,-52,29,24
819,Sheffield Weds,30,11,5,89,32,57,101,1
819,Plymouth Argyle,28,11,7,86,46,40,95,2
819,Barnsley,28,9,9,75,36,39,93,3
819,Ipswich Town,24,16,6,81,40,41,88,4
819,Derby County,25,13,8,72,36,36,88,5
819,Wycombe,23,9,14,56,37,19,78,6
819,Bolton,21,14,11,61,35,26,77,7
819,P'borough Utd,21,8,17,70,58,12,71,8
819,Portsmouth,18,14,14,59,51,8,68,9
819,Shrewsbury,19,10,17,56,54,2,67,10
819,Charlton Ath,17,13,16,63,59,4,64,11
819,Lincoln City,15,19,12,45,47,-2,64,12
819,Fleetwood Town,14,16,16,46,42,4,58,13
819,Port Vale,16,10,20,49,66,-17,58,14
819,Exeter City,15,12,19,56,58,-2,57,15
819,Oxford United,12,14,20,46,53,-7,50,16
819,Bristol Rovers,13,11,22,62,83,-21,50,17
819,Burton Albion,13,11,22,59,83,-24,50,18
819,Cheltenham,11,12,23,35,60,-25,45,19
819,Acc'ton Stanley,10,12,24,38,70,-32,42,20
819,Cambridge Utd,11,8,27,35,74,-39,41,21
819,Morecambe,9,12,25,38,69,-31,39,22
819,MK Dons,9,11,26,39,70,-31,38,23
819,FG Rovers,6,12,28,34,91,-57,30,24
820,Sheffield Weds,28,12,6,79,32,47,96,1
820,Plymouth Argyle,27,13,6,84,47,37,94,2
820,Ipswich Town,26,14,6,85,41,44,92,3
820,Bolton,25,11,10,67,33,34,86,4
820,P'borough Utd,26,5,15,85,54,31,83,5
820,Derby County,20,16,10,68,42,26,76,6
820,Wycombe,23,7,16,71,49,22,76,7
820,Portsmouth,20,14,12,65,49,16,74,8
820,Barnsley,21,9,16,63,49,14,72,9
820,Charlton Ath,18,13,15,66,57,9,67,10
820,Lincoln City,15,22,9,46,40,6,67,11
820,Fleetwood Town,17,13,16,55,47,8,64,12
820,Shrewsbury,18,7,21,56,54,2,61,13
820,Exeter City,17,10,19,57,59,-2,61,14
820,Port Vale,15,11,20,49,63,-14,56,15
820,Bristol Rovers,15,11,20,66,91,-25,56,16
820,Oxford United,14,11,21,51,61,-10,53,17
820,Burton Albion,11,14,21,51,79,-28,47,18
820,Acc'ton Stanley,10,14,22,40,68,-28,44,19
820,Cheltenham,12,7,27,32,63,-31,43,20
820,Cambridge Utd,11,10,25,35,72,-37,43,21
820,Morecambe,9,14,23,45,78,-33,41,22
820,MK Dons,10,10,26,38,66,-28,40,23
820,FG Rovers,5,10,31,35,95,-60,25,24
821,Sheffield Weds,31,9,6,91,35,56,102,1
821,Ipswich Town,26,16,4,91,40,51,94,2
821,Plymouth Argyle,27,10,9,82,54,28,91,3
821,Bolton,26,10,10,72,37,35,88,4
821,Wycombe,25,10,11,71,40,31,85,5
821,Derby County,21,16,9,71,44,27,79,6
821,Barnsley,22,12,12,66,44,22,78,7
821,Portsmouth,19,16,11,66,56,10,73,8
821,Charlton Ath,18,14,14,64,57,7,68,9
821,Shrewsbury,20,8,18,53,50,3,68,10
821,P'borough Utd,19,6,21,64,61,3,63,11
821,Fleetwood Town,15,16,15,48,46,2,61,12
821,Bristol Rovers,16,13,17,68,72,-4,61,13
821,Lincoln City,12,21,13,44,49,-5,57,14
821,Exeter City,14,12,20,59,64,-5,54,15
821,Port Vale,14,11,21,48,61,-13,53,16
821,Acc'ton Stanley,12,14,20,41,68,-27,50,17
821,Burton Albion,13,9,24,57,88,-31,48,18
821,Oxford United,10,15,21,45,57,-12,45,19
821,Cheltenham,12,8,26,38,70,-32,44,20
821,Morecambe,8,16,22,42,73,-31,40,21
821,Cambridge Utd,10,9,27,39,72,-33,39,22
821,MK Dons,9,8,29,40,74,-34,35,23
821,FG Rovers,8,11,27,42,90,-48,35,24
822,Plymouth Argyle,28,10,8,78,48,30,94,1
822,Sheffield Weds,27,10,9,80,35,45,91,2
822,Ipswich Town,25,14,7,94,42,52,89,3
822,Derby County,26,10,10,73,40,33,88,4
822,Bolton,25,10,11,66,35,31,85,5
822,Wycombe,24,10,12,63,39,24,82,6
822,P'borough Utd,24,6,16,81,56,25,78,7
822,Barnsley,23,8,15,69,51,18,77,8
822,Shrewsbury,20,9,17,57,55,2,69,9
822,Portsmouth,17,17,12,60,49,11,68,10
822,Charlton Ath,16,13,17,65,62,3,61,11
822,Fleetwood Town,15,16,15,51,49,2,61,12
822,Bristol Rovers,16,12,18,66,74,-8,60,13
822,Lincoln City,13,19,14,48,54,-6,58,14
822,Exeter City,15,11,20,58,66,-8,56,15
822,Cheltenham,15,10,21,39,58,-19,55,16
822,Oxford United,12,14,20,56,64,-8,50,17
822,Port Vale,13,10,23,45,70,-25,49,18
822,MK Dons,12,10,24,42,63,-21,46,19
822,Burton Albion,12,10,24,54,85,-31,46,20
822,Acc'ton Stanley,10,15,21,38,66,-28,45,21
822,Morecambe,10,13,23,48,80,-32,43,22
822,Cambridge Utd,9,8,29,35,77,-42,35,23
822,FG Rovers,7,11,28,33,81,-48,32,24
823,Sheffield Weds,30,10,6,80,31,49,100,1
823,Barnsley,28,9,9,69,38,31,93,2
823,Plymouth Argyle,26,11,9,81,53,28,89,3
823,Bolton,26,10,10,77,33,44,88,4
823,Derby County,25,12,9,83,48,35,87,5
823,Ipswich Town,23,13,10,86,48,38,82,6
823,P'borough Utd,25,4,17,77,52,25,79,7
823,Wycombe,22,10,14,61,44,17,76,8
823,Shrewsbury,20,11,15,54,43,11,71,9
823,Fleetwood Town,17,17,12,52,40,12,68,10
823,Portsmouth,16,17,13,62,55,7,65,11
823,Charlton Ath,14,17,15,70,59,11,59,12
823,Exeter City,16,11,19,66,67,-1,59,13
823,Lincoln City,12,20,14,44,49,-5,56,14
823,Port Vale,15,8,23,48,72,-24,53,15
823,Bristol Rovers,14,9,23,59,79,-20,51,16
823,Cheltenham,14,8,24,38,64,-26,50,17
823,Oxford United,12,10,24,45,65,-20,46,18
823,MK Dons,12,10,24,43,64,-21,46,19
823,Morecambe,11,13,22,48,79,-31,46,20
823,Burton Albion,10,13,23,50,80,-30,43,21
823,Acc'ton Stanley,9,14,23,39,74,-35,41,22
823,Cambridge Utd,10,10,26,33,76,-43,40,23
823,FG Rovers,7,9,30,31,83,-52,30,24
824,Sheffield Weds,29,13,4,80,25,55,100,1
824,Plymouth Argyle,27,12,7,82,50,32,93,2
824,Bolton,25,10,11,72,37,35,85,3
824,Ipswich Town,22,17,7,85,47,38,83,4
824,Barnsley,24,10,12,69,41,28,82,5
824,Wycombe,24,10,12,66,40,26,82,6
824,Derby County,23,11,12,71,42,29,80,7
824,Portsmouth,20,16,10,64,48,16,76,8
824,P'borough Utd,22,7,17,73,56,17,73,9
824,Shrewsbury,18,9,19,56,55,1,63,10
824,Charlton Ath,17,11,18,68,61,7,62,11
824,Port Vale,17,10,19,53,64,-11,61,12
824,Lincoln City,13,21,12,50,47,3,60,13
824,Bristol Rovers,15,12,19,62,71,-9,57,14
824,Fleetwood Town,13,16,17,43,46,-3,55,15
824,Oxford United,13,14,19,48,57,-9,53,16
824,Exeter City,13,11,22,54,64,-10,50,17
824,Burton Albion,13,11,22,55,90,-35,50,18
824,Cambridge Utd,13,8,25,45,71,-26,47,19
824,MK Dons,12,9,25,41,68,-27,45,20
824,Morecambe,10,13,23,42,76,-34,43,21
824,Acc'ton Stanley,9,14,23,40,76,-36,41,22
824,Cheltenham,10,9,27,32,63,-31,39,23
824,FG Rovers,9,8,29,34,90,-56,35,24
825,Plymouth Argyle,30,11,5,94,47,47,101,1
825,Sheffield Weds,30,10,6,83,31,52,100,2
825,Bolton,27,9,10,76,34,42,90,3
825,Derby County,25,12,9,85,47,38,87,4
825,Barnsley,26,7,13,77,47,30,85,5
825,Ipswich Town,21,15,10,84,54,30,78,6
825,Wycombe,22,6,18,61,44,17,72,7
825,P'borough Utd,22,5,19,73,57,16,71,8
825,Portsmouth,18,15,13,66,54,12,69,9
825,Shrewsbury,19,10,17,53,51,2,67,10
825,Lincoln City,13,24,9,47,42,5,63,11
825,Charlton Ath,16,14,16,68,62,6,62,12
825,Exeter City,15,13,18,62,64,-2,58,13
825,Fleetwood Town,14,15,17,48,50,-2,57,14
825,Bristol Rovers,15,9,22,60,77,-17,54,15
825,Oxford United,12,13,21,45,58,-13,49,16
825,Port Vale,12,12,22,43,68,-25,48,17
825,MK Dons,12,11,23,44,65,-21,47,18
825,Cambridge Utd,13,8,25,43,72,-29,47,19
825,Cheltenham,12,10,24,33,67,-34,46,20
825,Acc'ton Stanley,10,14,22,44,77,-33,44,21
825,Morecambe,9,15,22,44,78,-34,42,22
825,Burton Albion,10,11,25,53,97,-44,41,23
825,FG Rovers,10,9,27,39,82,-43,39,24
826,Sheffield Weds,29,12,5,85,33,52,99,1
826,Ipswich Town,27,14,5,86,37,49,95,2
826,Barnsley,27,10,9,73,38,35,91,3
826,Plymouth Argyle,25,12,9,90,54,36,87,4
826,Derby County,24,15,7,75,40,35,87,5
826,Wycombe,24,9,13,70,46,24,81,6
826,Bolton,23,11,12,63,35,28,80,7
826,P'borough Utd,22,6,18,77,58,19,72,8
826,Portsmouth,19,14,13,58,54,4,71,9
826,Shrewsbury,19,11,16,50,44,6,68,10
826,Fleetwood Town,16,16,14,55,42,13,64,11
826,Lincoln City,12,23,11,46,49,-3,59,12
826,Exeter City,14,15,17,55,61,-6,57,13
826,Charlton Ath,12,17,17,60,66,-6,53,14
826,Port Vale,14,10,22,47,65,-18,52,15
826,Acc'ton Stanley,13,13,20,41,64,-23,52,16
826,Oxford United,13,12,21,48,59,-11,51,17
826,Bristol Rovers,13,10,23,64,87,-23,49,18
826,Burton Albion,12,11,23,52,86,-34,47,19
826,Cheltenham,11,9,26,35,63,-28,42,20
826,Cambridge Utd,12,6,28,42,74,-32,42,21
826,MK Dons,10,9,27,42,78,-36,39,22
826,Morecambe,8,14,24,43,74,-31,38,23
826,FG Rovers,8,11,27,32,82,-50,35,24
827,Sheffield Weds,30,11,5,84,32,52,101,1
827,Plymouth Argyle,29,11,6,89,47,42,98,2
827,Bolton,26,9,11,69,36,33,87,3
827,Ipswich Town,23,15,8,91,47,44,84,4
827,Derby County,24,9,13,76,46,30,81,5
827,Barnsley,24,9,13,70,45,25,81,6
827,Portsmouth,20,17,9,66,49,17,77,7
827,Wycombe,22,8,16,66,47,19,74,8
827,P'borough Utd,22,7,17,74,56,18,73,9
827,Fleetwood Town,17,16,13,52,43,9,67,10
827,Shrewsbury,18,11,17,49,46,3,65,11
827,Bristol Rovers,18,8,20,69,75,-6,62,12
827,Port Vale,18,8,20,49,68,-19,62,13
827,Lincoln City,13,19,14,47,48,-1,58,14
827,Charlton Ath,13,15,18,60,60,0,54,15
827,Exeter City,14,11,21,58,70,-12,53,16
827,Oxford United,13,12,21,49,61,-12,51,17
827,Burton Albion,12,12,22,54,85,-31,48,18
827,Acc'ton Stanley,11,12,23,42,75,-33,45,19
827,Cambridge Utd,12,8,26,38,71,-33,44,20
827,MK Dons,11,10,25,43,69,-26,43,21
827,Morecambe,10,12,24,45,79,-34,42,22
827,Cheltenham,11,7,28,29,63,-34,40,23
827,FG Rovers,8,9,29,34,85,-51,33,24
828,Plymouth Argyle,29,10,7,86,50,36,97,1
828,Barnsley,30,5,11,78,39,39,95,2
828,Sheffield Weds,27,13,6,77,34,43,94,3
828,Ipswich Town,26,14,6,94,44,50,92,4
828,Derby County,23,11,12,69,43,26,80,5
828,Bolton,23,10,13,70,44,26,79,6
828,Wycombe,23,8,15,68,40,28,77,7
828,P'borough Utd,22,5,19,71,60,11,71,8
828,Portsmouth,18,16,12,67,50,17,70,9
828,Lincoln City,15,21,10,47,42,5,66,10
828,Shrewsbury,19,8,19,59,58,1,65,11
828,Exeter City,16,13,17,61,64,-3,61,12
828,Charlton Ath,16,12,18,73,68,5,60,13
828,Port Vale,14,12,20,47,63,-16,54,14
828,Bristol Rovers,14,11,21,62,81,-19,53,15
828,Burton Albion,14,10,22,61,89,-28,52,16
828,Fleetwood Town,11,17,18,45,50,-5,50,17
828,Oxford United,12,12,22,50,63,-13,48,18
828,Acc'ton Stanley,10,16,20,41,69,-28,46,19
828,Cheltenham,12,9,25,38,68,-30,45,20
828,Morecambe,10,13,23,48,83,-35,43,21
828,FG Rovers,11,9,26,38,78,-40,42,22
828,MK Dons,11,8,27,44,75,-31,41,23
828,Cambridge Utd,10,9,27,39,78,-39,39,24
829,Sheffield Weds,31,10,5,80,30,50,103,1
829,Barnsley,26,9,11,76,44,32,87,2
829,Plymouth Argyle,24,14,8,82,54,28,86,3
829,Ipswich Town,24,13,9,81,47,34,85,4
829,Bolton,25,8,13,71,40,31,83,5
829,Derby County,24,10,12,73,41,32,82,6
829,P'borough Utd,24,4,18,75,59,16,76,7
829,Shrewsbury,22,7,17,59,46,13,73,8
829,Wycombe,20,11,15,59,43,16,71,9
829,Portsmouth,17,17,12,56,50,6,68,10
829,Charlton Ath,16,15,15,64,57,7,63,11
829,Fleetwood Town,15,18,13,47,42,5,63,12
829,Exeter City,15,14,17,57,60,-3,59,13
829,Lincoln City,13,20,13,44,48,-4,59,14
829,Bristol Rovers,16,11,19,66,76,-10,59,15
829,Port Vale,16,10,20,45,60,-15,58,16
829,Oxford United,12,12,22,46,58,-12,48,17
829,Burton Albion,12,12,22,53,81,-28,48,18
829,Cambridge Utd,13,8,25,44,70,-26,47,19
829,Cheltenham,11,12,23,35,57,-22,45,20
829,MK Dons,11,10,25,40,67,-27,43,21
829,Morecambe,9,14,23,40,70,-30,41,22
829,Acc'ton Stanley,8,14,24,34,71,-37,38,23
829,FG Rovers,6,11,29,33,89,-56,29,24
830,Sheffield Weds,29,12,5,87,29,58,99,1
830,Plymouth Argyle,27,11,8,91,51,40,92,2
830,Barnsley,26,10,10,68,37,31,88,3
830,Derby County,25,9,12,78,44,34,84,4
830,Ipswich Town,22,15,9,84,53,31,81,5
830,Wycombe,23,10,13,66,40,26,79,6
830,Portsmouth,21,16,9,74,55,19,79,7
830,Bolton,22,11,13,63,35,28,77,8
830,P'borough Utd,24,4,18,73,53,20,76,9
830,Lincoln City,16,21,9,48,44,4,69,10
830,Charlton Ath,17,14,15,71,57,14,65,11
830,Exeter City,17,12,17,61,60,1,63,12
830,Port Vale,18,9,19,58,61,-3,63,13
830,Fleetwood Town,15,16,15,50,50,0,61,14
830,Shrewsbury,17,9,20,50,52,-2,60,15
830,Bristol Rovers,15,11,20,61,83,-22,56,16
830,Burton Albion,12,12,22,57,82,-25,48,17
830,Oxford United,12,11,23,46,60,-14,47,18
830,Acc'ton Stanley,11,14,21,36,65,-29,47,19
830,MK Dons,12,7,27,42,74,-32,43,20
830,Morecambe,10,11,25,44,82,-38,41,21
830,Cheltenham,11,6,29,36,75,-39,39,22
830,Cambridge Utd,10,7,29,35,81,-46,37,23
830,FG Rovers,6,10,30,37,93,-56,28,24
831,Plymouth Argyle,29,9,8,85,45,40,96,1
831,Barnsley,28,9,9,74,39,35,93,2
831,Sheffield Weds,26,12,8,75,34,41,90,3
831,Ipswich Town,24,16,6,80,40,40,88,4
831,Derby County,25,11,10,69,43,26,86,5
831,Wycombe,25,10,11,68,38,30,85,6
831,Bolton,22,13,11,61,37,24,79,7
831,P'borough Utd,22,6,18,76,54,22,72,8
831,Shrewsbury,20,11,15,57,44,13,71,9
831,Portsmouth,19,13,14,63,56,7,70,10
831,Fleetwood Town,16,17,13,54,46,8,65,11
831,Charlton Ath,16,16,14,61,55,6,64,12
831,Port Vale,16,12,18,51,61,-10,60,13
831,Bristol Rovers,14,13,19,59,70,-11,55,14
831,Exeter City,14,12,20,59,62,-3,54,15
831,Lincoln City,10,24,12,39,45,-6,54,16
831,Cheltenham,14,9,23,38,61,-23,51,17
831,Oxford United,12,13,21,48,59,-11,49,18
831,MK Dons,12,9,25,44,68,-24,45,19
831,Burton Albion,10,11,25,49,88,-39,41,20
831,Acc'ton Stanley,9,13,24,46,84,-38,40,21
831,Morecambe,10,10,26,42,82,-40,40,22
831,Cambridge Utd,11,5,30,39,77,-38,38,23
831,FG Rovers,6,10,30,29,78,-49,28,24
832,Sheffield Weds,32,11,3,86,27,59,107,1
832,Plymouth Argyle,30,10,6,85,51,34,100,2
832,Bolton,27,8,11,77,33,44,89,3
832,Barnsley,25,8,13,68,43,25,83,4
832,Ipswich Town,21,18,7,81,43,38,81,5
832,Derby County,22,13,11,67,40,27,79,6
832,P'borough Utd,24,5,17,73,58,15,77,7
832,Wycombe,22,10,14,59,41,18,76,8
832,Fleetwood Town,19,14,13,54,42,12,71,9
832,Shrewsbury,21,8,17,59,51,8,71,10
832,Portsmouth,18,15,13,61,51,10,69,11
832,Charlton Ath,16,16,14,68,59,9,64,12
832,Exeter City,16,12,18,57,56,1,60,13
832,Lincoln City,11,21,14,38,48,-10,54,14
832,Port Vale,14,10,22,45,65,-20,52,15
832,Bristol Rovers,12,15,19,61,81,-20,51,16
832,Acc'ton Stanley,13,11,22,39,67,-28,50,17
832,Cheltenham,12,11,23,34,57,-23,47,18
832,Burton Albion,11,12,23,53,81,-28,45,19
832,Oxford United,10,12,24,44,66,-22,42,20
832,MK Dons,10,10,26,40,67,-27,40,21
832,Cambridge Utd,10,9,27,34,73,-39,39,22
832,Morecambe,8,14,24,44,77,-33,38,23
832,FG Rovers,7,9,30,38,88,-50,30,24
833,Sheffield Weds,30,10,6,81,33,48,100,1
833,Plymouth Argyle,30,8,8,102,58,44,98,2
833,Bolton,25,11,10,74,39,35,86,3
833,Barnsley,25,9,12,79,48,31,84,4
833,Wycombe,25,9,12,65,40,25,84,5
833,Ipswich Town,22,16,8,86,49,37,82,6
833,Derby County,22,13,11,66,38,28,79,7
833,Shrewsbury,23,8,15,64,54,10,77,8
833,Portsmouth,20,15,11,66,47,19,75,9
833,P'borough Utd,22,6,18,75,58,17,72,10
833,Charlton Ath,16,14,16,65,60,5,62,11
833,Fleetwood Town,15,15,16,52,47,5,60,12
833,Lincoln City,12,21,13,43,46,-3,57,13
833,Exeter City,15,10,21,55,66,-11,55,14
833,Port Vale,14,12,20,44,61,-17,54,15
833,Bristol Rovers,14,10,22,61,75,-14,52,16
833,Oxford United,11,13,22,45,57,-12,46,17
833,Cheltenham,11,13,22,34,58,-24,46,18
833,Acc'ton Stanley,11,13,22,39,71,-32,46,19
833,MK Dons,12,9,25,38,62,-24,45,20
833,Morecambe,11,12,23,47,76,-29,45,21
833,Burton Albion,11,11,24,50,91,-41,44,22
833,Cambridge Utd,9,9,28,37,78,-41,36,23
833,FG Rovers,7,11,28,34,90,-56,32,24
834,Plymouth Argyle,30,10,6,94,47,47,100,1
834,Sheffield Weds,29,12,5,83,29,54,99,2
834,Ipswich Town,24,17,5,83,41,42,89,3
834,Derby County,23,13,10,70,40,30,82,4
834,Bolton,21,15,10,63,35,28,78,5
834,Barnsley,23,9,14,72,49,23,78,6
834,Portsmouth,20,16,10,64,49,15,76,7
834,Wycombe,21,9,16,61,48,13,72,8
834,P'borough Utd,20,8,18,72,57,15,68,9
834,Shrewsbury,18,11,17,50,51,-1,65,10
834,Fleetwood Town,15,16,15,49,47,2,61,11
834,Lincoln City,14,18,14,50,49,1,60,12
834,Exeter City,15,13,18,59,55,4,58,13
834,Charlton Ath,13,17,16,62,64,-2,56,14
834,Port Vale,16,8,22,50,66,-16,56,15
834,Bristol Rovers,13,12,21,61,86,-25,51,16
834,Cheltenham,13,10,23,35,68,-33,49,17
834,Oxford United,12,11,23,44,57,-13,47,18
834,MK Dons,13,8,25,47,68,-21,47,19
834,Cambridge Utd,13,8,25,44,74,-30,47,20
834,Acc'ton Stanley,9,18,19,37,63,-26,45,21
834,Morecambe,10,15,21,41,68,-27,45,22
834,Burton Albion,11,12,23,51,84,-33,45,23
834,FG Rovers,8,10,28,38,85,-47,34,24
835,Sheffield Weds,32,10,4,88,30,58,106,1
835,Plymouth Argyle,27,11,8,85,53,32,92,2
835,Ipswich Town,22,17,7,75,41,34,83,3
835,Barnsley,24,9,13,76,49,27,81,4
835,Derby County,23,12,11,71,47,24,81,5
835,P'borough Utd,25,5,16,86,57,29,80,6
835,Wycombe,22,10,14,64,46,18,76,7
835,Bolton,20,13,13,62,39,23,73,8
835,Portsmouth,20,12,14,67,55,12,72,9
835,Shrewsbury,19,11,16,60,50,10,68,10
835,Exeter City,16,13,17,58,60,-2,61,11
835,Lincoln City,14,19,13,50,58,-8,61,12
835,Port Vale,17,10,19,49,65,-16,61,13
835,Charlton Ath,14,14,18,60,65,-5,56,14
835,Bristol Rovers,15,11,20,65,78,-13,56,15
835,Fleetwood Town,13,16,17,46,46,0,55,16
835,Oxford United,14,11,21,47,57,-10,53,17
835,Cheltenham,15,8,23,36,57,-21,53,18
835,Burton Albion,13,12,21,59,80,-21,51,19
835,Acc'ton Stanley,10,14,22,45,74,-29,44,20
835,Cambridge Utd,11,9,26,35,64,-29,42,21
835,MK Dons,10,11,25,44,72,-28,41,22
835,Morecambe,9,14,23,44,73,-29,41,23
835,FG Rovers,5,12,29,30,86,-56,27,24
836,Plymouth Argyle,31,10,5,94,43,51,103,1
836,Sheffield Weds,29,12,5,72,28,44,99,2
836,Ipswich Town,25,14,7,88,42,46,89,3
836,Derby County,25,13,8,80,37,43,88,4
836,Barnsley,26,9,11,74,44,30,87,5
836,Bolton,25,11,10,69,33,36,86,6
836,Wycombe,25,6,15,72,47,25,81,7
836,P'borough Utd,21,10,15,70,53,17,73,8
836,Shrewsbury,19,8,19,50,51,-1,65,9
836,Fleetwood Town,15,14,17,52,48,4,59,10
836,Portsmouth,13,20,13,57,58,-1,59,11
836,Port Vale,16,10,20,51,68,-17,58,12
836,Charlton Ath,14,15,17,60,61,-1,57,13
836,Exeter City,14,13,19,57,60,-3,55,14
836,Lincoln City,10,23,13,43,52,-9,53,15
836,Oxford United,12,15,19,45,57,-12,51,16
836,Bristol Rovers,13,11,22,60,80,-20,50,17
836,Cambridge Utd,14,8,24,40,70,-30,50,18
836,Cheltenham,12,12,22,34,60,-26,48,19
836,MK Dons,11,11,24,46,70,-24,44,20
836,Morecambe,9,15,22,48,75,-27,42,21
836,Burton Albion,11,8,27,57,94,-37,41,22
836,Acc'ton Stanley,8,17,21,37,74,-37,41,23
836,FG Rovers,6,11,29,32,83,-51,29,24
837,Sheffield Weds,31,11,4,83,26,57,104,1
837,Plymouth Argyle,28,9,9,84,53,31,93,2
837,Ipswich Town,26,14,6,89,42,47,92,3
837,Barnsley,27,8,11,80,41,39,89,4
837,Derby County,23,14,9,74,39,35,83,5
837,Wycombe,24,7,15,66,44,22,79,6
837,Bolton,22,12,12,63,37,26,78,7
837,P'borough Utd,21,9,16,76,59,17,72,8
837,Portsmouth,18,17,11,61,50,11,71,9
837,Charlton Ath,19,13,14,70,57,13,70,10
837,Shrewsbury,19,9,18,56,54,2,66,11
837,Fleetwood Town,16,15,15,49,45,4,63,12
837,Lincoln City,13,22,11,46,45,1,61,13
837,Port Vale,15,10,21,45,64,-19,55,14
837,Exeter City,13,12,21,50,61,-11,51,15
837,Bristol Rovers,14,9,23,61,85,-24,51,16
837,Cheltenham,13,11,22,39,60,-21,50,17
837,Oxford United,11,15,20,47,62,-15,48,18
837,Acc'ton Stanley,9,18,19,41,68,-27,45,19
837,Burton Albion,11,12,23,58,87,-29,45,20
837,Cambridge Utd,12,7,27,37,68,-31,43,21
837,MK Dons,10,12,24,40,67,-27,42,22
837,Morecambe,7,13,26,39,80,-41,34,23
837,FG Rovers,6,9,31,36,96,-60,27,24
838,Sheffield Weds,30,10,6,82,30,52,100,1
838,Derby County,27,11,8,81,41,40,92,2
838,Plymouth Argyle,27,11,8,83,47,36,92,3
838,Bolton,27,8,11,66,30,36,89,4
838,Ipswich Town,24,14,8,81,41,40,86,5
838,Wycombe,25,9,12,66,41,25,84,6
838,Portsmouth,23,14,9,80,44,36,83,7
838,Barnsley,23,10,13,69,43,26,79,8
838,P'borough Utd,23,5,18,79,64,15,74,9
838,Fleetwood Town,16,16,14,50,46,4,64,10
838,Shrewsbury,16,11,19,52,52,0,59,11
838,Lincoln City,13,20,13,43,48,-5,59,12
838,Exeter City,15,12,19,57,58,-1,57,13
838,Charlton Ath,14,13,19,62,63,-1,55,14
838,Port Vale,14,11,21,49,72,-23,53,15
838,Oxford United,13,11,22,52,62,-10,50,16
838,Burton Albion,13,11,22,54,86,-32,50,17
838,Cheltenham,12,11,23,33,58,-25,47,18
838,Bristol Rovers,11,12,23,59,87,-28,45,19
838,Morecambe,10,14,22,44,76,-32,44,20
838,Acc'ton Stanley,10,13,23,37,66,-29,43,21
838,MK Dons,10,10,26,46,80,-34,40,22
838,Cambridge Utd,10,8,28,33,74,-41,38,23
838,FG Rovers,7,13,26,33,82,-49,34,24
839,Sheffield Weds,30,11,5,79,29,50,101,1
839,Plymouth Argyle,28,10,8,81,50,31,94,2
839,Barnsley,28,8,10,76,40,36,92,3
839,Derby County,26,11,9,76,41,35,89,4
839,Ipswich Town,24,13,9,80,45,35,85,5
839,Bolton,24,10,12,67,39,28,82,6
839,Portsmouth,18,18,10,58,46,12,72,7
839,P'borough Utd,22,4,20,70,57,13,70,8
839,Wycombe,19,12,15,52,41,11,69,9
839,Fleetwood Town,17,16,13,54,43,11,67,10
839,Shrewsbury,18,10,18,52,47,5,64,11
839,Charlton Ath,14,17,15,69,61,8,59,12
839,Lincoln City,11,23,12,46,50,-4,56,13
839,Oxford United,13,15,18,55,59,-4,54,14
839,Exeter City,13,14,19,51,57,-6,53,15
839,Burton Albion,13,12,21,57,78,-21,51,16
839,Port Vale,13,12,21,45,67,-22,51,17
839,Bristol Rovers,13,10,23,56,74,-18,49,18
839,MK Dons,11,12,23,40,63,-23,45,19
839,Cheltenham,12,9,25,33,64,-31,45,20
839,Acc'ton Stanley,10,14,22,38,76,-38,44,21
839,Morecambe,9,15,22,45,75,-30,42,22
839,Cambridge Utd,11,7,28,35,70,-35,40,23
839,FG Rovers,8,11,27,39,82,-43,35,24
840,Sheffield Weds,31,11,4,86,29,57,104,1
840,Plymouth Argyle,29,10,7,95,52,43,97,2
840,Ipswich Town,26,14,6,80,39,41,92,3
840,Barnsley,25,10,11,64,38,26,85,4
840,Derby County,23,13,10,75,44,31,82,5
840,Bolton,21,12,13,63,38,25,75,6
840,Wycombe,21,10,15,61,48,13,73,7
840,P'borough Utd,21,7,18,69,60,9,70,8
840,Portsmouth,18,16,12,64,56,8,70,9
840,Lincoln City,15,22,9,46,40,6,67,10
840,Exeter City,18,10,18,58,56,2,64,11
840,Fleetwood Town,16,14,16,46,44,2,62,12
840,Charlton Ath,14,18,14,66,53,13,60,13
840,Shrewsbury,16,10,20,49,52,-3,58,14
840,Bristol Rovers,14,13,19,66,83,-17,55,15
840,Port Vale,14,8,24,44,67,-23,50,16
840,Oxford United,12,12,22,41,59,-18,48,17
840,Morecambe,11,14,21,47,67,-20,47,18
840,Burton Albion,11,11,24,54,83,-29,44,19
840,Cambridge Utd,11,11,24,36,71,-35,44,20
840,Cheltenham,10,12,24,36,65,-29,42,21
840,Acc'ton Stanley,9,15,22,45,76,-31,42,22
840,MK Dons,10,11,25,43,69,-26,41,23
840,FG Rovers,8,12,26,44,89,-45,36,24
841,Sheffield Weds,31,11,4,82,28,54,104,1
841,Ipswich Town,25,16,5,93,44,49,91,2
841,Bolton,24,12,10,68,35,33,84,3
841,Barnsley,25,9,12,65,44,21,84,4
841,Plymouth Argyle,24,10,12,76,59,17,82,5
841,P'borough Utd,24,6,16,78,56,22,78,6
841,Derby County,22,11,13,74,46,28,77,7
841,Wycombe,22,11,13,68,44,24,77,8
841,Shrewsbury,20,11,15,60,47,13,71,9
841,Charlton Ath,18,13,15,70,60,10,67,10
841,Portsmouth,18,13,15,61,55,6,67,11
841,Fleetwood Town,16,18,12,51,40,11,66,12
841,Exeter City,16,13,17,64,62,2,61,13
841,Oxford United,15,11,20,51,55,-4,56,14
841,Lincoln City,12,19,15,43,51,-8,55,15
841,Burton Albion,14,10,22,62,94,-32,52,16
841,Bristol Rovers,14,9,23,68,84,-16,51,17
841,Port Vale,13,11,22,49,71,-22,50,18
841,MK Dons,13,8,25,45,67,-22,47,19
841,Cheltenham,12,8,26,35,66,-31,44,20
841,Morecambe,10,13,23,45,71,-26,43,21
841,Cambridge Utd,11,7,28,35,74,-39,40,22
841,Acc'ton Stanley,9,12,25,35,78,-43,39,23
841,FG Rovers,8,10,28,38,85,-47,34,24
842,Sheffield Weds,30,8,8,87,39,48,98,1
842,Plymouth Argyle,28,11,7,86,50,36,95,2
842,Barnsley,27,8,11,80,48,32,89,3
842,Derby County,23,14,9,69,37,32,83,4
842,Ipswich Town,22,16,8,79,47,32,82,5
842,Wycombe,25,6,15,66,42,24,81,6
842,Bolton,22,11,13,61,41,20,77,7
842,Shrewsbury,23,8,15,68,50,18,77,8
842,Portsmouth,18,15,13,63,54,9,69,9
842,P'borough Utd,20,8,18,79,66,13,68,10
842,Charlton Ath,15,16,15,69,59,10,61,11
842,Lincoln City,13,19,14,50,56,-6,58,12
842,Fleetwood Town,14,15,17,46,43,3,57,13
842,Bristol Rovers,15,12,19,64,77,-13,57,14
842,Exeter City,14,14,18,54,56,-2,56,15
842,Oxford United,13,13,20,52,62,-10,52,16
842,Burton Albion,14,9,23,55,86,-31,51,17
842,Acc'ton Stanley,12,14,20,44,69,-25,50,18
842,Cheltenham,13,10,23,35,63,-28,49,19
842,Port Vale,13,8,25,42,68,-26,47,20
842,MK Dons,13,7,26,42,67,-25,46,21
842,Cambridge Utd,13,7,26,37,70,-33,46,22
842,Morecambe,9,14,23,43,70,-27,41,23
842,FG Rovers,7,9,30,32,83,-51,30,24
843,Sheffield Weds,33,9,4,89,27,62,108,1
843,Plymouth Argyle,31,9,6,92,47,45,102,2
843,Ipswich Town,27,13,6,88,41,47,94,3
843,Barnsley,25,8,13,69,44,25,83,4
843,P'borough Utd,25,6,15,78,52,26,81,5
843,Bolton,23,10,13,70,40,30,79,6
843,Derby County,22,11,13,70,43,27,77,7
843,Wycombe,21,10,15,61,43,18,73,8
843,Charlton Ath,18,13,15,71,58,13,67,9
843,Portsmouth,16,17,13,60,62,-2,65,10
843,Fleetwood Town,15,15,16,50,47,3,60,11
843,Lincoln City,13,21,12,47,51,-4,60,12
843,Exeter City,15,14,17,60,62,-2,59,13
843,Bristol Rovers,16,11,19,66,76,-10,59,14
843,Shrewsbury,17,6,23,53,62,-9,57,15
843,Port Vale,14,10,22,46,65,-19,52,16
843,Oxford United,12,12,22,45,55,-10,48,17
843,MK Dons,12,12,22,47,66,-19,48,18
843,Burton Albion,12,11,23,57,96,-39,47,19
843,Morecambe,11,13,22,43,72,-29,46,20
843,Cheltenham,12,9,25,33,65,-32,45,21
843,Acc'ton Stanley,11,11,24,44,79,-35,44,22
843,Cambridge Utd,10,9,27,35,69,-34,39,23
843,FG Rovers,6,10,30,38,90,-52,28,24
844,Sheffield Weds,31,10,5,85,30,55,103,1
844,Plymouth Argyle,28,11,7,90,50,40,95,2
844,Barnsley,27,10,9,77,38,39,91,3
844,Ipswich Town,24,15,7,84,47,37,87,4
844,Derby County,23,13,10,71,41,30,82,5
844,Bolton,23,11,12,70,42,28,80,6
844,Wycombe,23,9,14,60,43,17,78,7
844,P'borough Utd,21,7,18,70,57,13,70,8
844,Portsmouth,18,14,14,66,51,15,68,9
844,Lincoln City,15,22,9,48,43,5,67,10
844,Charlton Ath,16,14,16,69,64,5,62,11
844,Shrewsbury,18,7,21,55,55,0,61,12
844,Port Vale,17,9,20,43,59,-16,60,13
844,Bristol Rovers,14,12,20,62,73,-11,54,14
844,Exeter City,14,11,21,56,63,-7,53,15
844,Fleetwood Town,12,16,18,45,48,-3,52,16
844,Morecambe,12,13,21,52,74,-22,49,17
844,Oxford United,11,15,20,52,66,-14,48,18
844,Cheltenham,11,13,22,33,60,-27,46,19
844,Burton Albion,12,10,24,52,92,-40,46,20
844,Acc'ton Stanley,9,16,21,38,72,-34,43,21
844,Cambridge Utd,12,7,27,37,73,-36,43,22
844,MK Dons,11,8,27,40,67,-27,41,23
844,FG Rovers,8,11,27,39,86,-47,35,24
845,Sheffield Weds,32,11,3,91,30,61,107,1
845,Plymouth Argyle,30,10,6,97,47,50,100,2
845,Ipswich Town,24,15,7,85,42,43,87,3
845,Wycombe,27,5,14,74,46,28,86,4
845,Derby County,22,13,11,74,47,27,79,5
845,Bolton,22,11,13,63,37,26,77,6
845,Barnsley,22,11,13,70,51,19,77,7
845,Portsmouth,19,15,12,63,50,13,72,8
845,Shrewsbury,20,8,18,55,54,1,68,9
845,P'borough Utd,21,3,22,69,66,3,66,10
845,Charlton Ath,17,14,15,73,67,6,65,11
845,Fleetwood Town,16,16,14,49,49,0,64,12
845,Lincoln City,14,21,11,48,46,2,63,13
845,Exeter City,15,12,19,60,65,-5,57,14
845,Port Vale,15,10,21,47,64,-17,55,15
845,Oxford United,13,15,18,49,55,-6,54,16
845,Cheltenham,15,9,22,41,60,-19,54,17
845,Bristol Rovers,13,11,22,66,80,-14,50,18
845,Burton Albion,12,12,22,56,83,-27,48,19
845,Cambridge Utd,11,9,26,38,72,-34,42,20
845,Morecambe,9,13,24,45,75,-30,40,21
845,MK Dons,9,12,25,44,69,-25,39,22
845,Acc'ton Stanley,8,14,24,32,72,-40,38,23
845,FG Rovers,5,12,29,31,93,-62,27,24
846,Sheffield Weds,31,11,4,90,28,62,104,1
846,Plymouth Argyle,28,11,7,89,53,36,95,2
846,Derby County,26,10,10,75,35,40,88,3
846,Bolton,25,11,10,72,34,38,86,4
846,Ipswich Town,24,14,8,84,49,35,86,5
846,Barnsley,25,10,11,79,45,34,85,6
846,P'borough Utd,24,5,17,73,55,18,77,7
846,Wycombe,22,8,16,66,51,15,74,8
846,Shrewsbury,21,9,16,61,51,10,72,9
846,Portsmouth,18,16,12,66,54,12,70,10
846,Fleetwood Town,15,17,14,51,46,5,62,11
846,Charlton Ath,16,13,17,64,58,6,61,12
846,Cheltenham,15,10,21,43,57,-14,55,13
846,Lincoln City,11,22,13,44,59,-15,55,14
846,Port Vale,14,10,22,50,68,-18,52,15
846,Exeter City,13,12,21,56,68,-12,51,16
846,Oxford United,13,11,22,52,64,-12,50,17
846,Bristol Rovers,13,10,23,59,79,-20,49,18
846,MK Dons,13,10,23,47,69,-22,49,19
846,Acc'ton Stanley,11,13,22,42,74,-32,46,20
846,Cambridge Utd,13,7,26,39,74,-35,46,21
846,Morecambe,9,14,23,45,75,-30,41,22
846,Burton Albion,9,9,28,47,98,-51,36,23
846,FG Rovers,7,9,30,35,85,-50,30,24
847,Sheffield Weds,29,11,6,83,33,50,98,1
847,Barnsley,28,7,11,71,42,29,91,2
847,Plymouth Argyle,26,11,9,83,53,30,89,3
847,Bolton,26,10,10,69,37,32,88,4
847,Ipswich Town,23,15,8,87,48,39,84,5
847,P'borough Utd,23,5,18,75,57,18,74,6
847,Wycombe,21,11,14,61,43,18,74,7
847,Derby County,20,12,14,68,48,20,72,8
847,Charlton Ath,18,15,13,69,56,13,69,9
847,Shrewsbury,19,10,17,57,50,7,67,10
847,Portsmouth,17,15,14,61,54,7,66,11
847,Fleetwood Town,14,16,16,44,43,1,58,12
847,Lincoln City,12,22,12,40,48,-8,58,13
847,Bristol Rovers,16,9,21,61,77,-16,57,14
847,Oxford United,14,13,19,48,56,-8,55,15
847,Exeter City,14,12,20,58,60,-2,54,16
847,Cheltenham,13,12,21,35,56,-21,51,17
847,Port Vale,13,11,22,47,66,-19,50,18
847,Burton Albion,13,10,23,60,84,-24,49,19
847,Cambridge Utd,13,10,23,40,67,-27,49,20
847,Morecambe,10,16,20,50,67,-17,46,21
847,Acc'ton Stanley,11,13,22,41,74,-33,46,22
847,MK Dons,10,7,29,40,78,-38,37,23
847,FG Rovers,7,11,28,38,89,-51,32,24
848,Sheffield Weds,31,11,4,99,31,68,104,1
848,Plymouth Argyle,29,11,6,90,48,42,98,2
848,Ipswich Town,23,16,7,81,40,41,85,3
848,Bolton,22,14,10,66,35,31,80,4
848,Barnsley,24,8,14,67,44,23,80,5
848,Derby County,21,14,11,77,51,26,77,6
848,Wycombe,23,8,15,66,47,19,77,7
848,Shrewsbury,21,8,17,54,51,3,71,8
848,P'borough Utd,20,8,18,71,60,11,68,9
848,Port Vale,19,10,17,51,56,-5,67,10
848,Portsmouth,16,16,14,65,57,8,64,11
848,Charlton Ath,17,12,17,56,52,4,63,12
848,Fleetwood Town,15,17,14,48,45,3,62,13
848,Exeter City,16,11,19,61,58,3,59,14
848,Burton Albion,14,14,18,59,74,-15,56,15
848,Lincoln City,10,21,15,40,49,-9,51,16
848,Oxford United,13,10,23,50,71,-21,49,17
848,Cheltenham,14,7,25,34,60,-26,49,18
848,Morecambe,12,12,22,46,73,-27,48,19
848,Bristol Rovers,12,11,23,57,89,-32,47,20
848,Acc'ton Stanley,10,16,20,42,69,-27,46,21
848,MK Dons,11,7,28,42,76,-34,40,22
848,FG Rovers,9,11,26,40,86,-46,38,23
848,Cambridge Utd,9,9,28,33,73,-40,36,24
849,Sheffield Weds,31,11,4,88,30,58,104,1
849,Plymouth Argyle,31,10,5,91,48,43,103,2
849,Derby County,27,10,9,87,42,45,91,3
849,Bolton,27,10,9,77,34,43,91,4
849,Ipswich Town,24,17,5,85,40,45,89,5
849,Barnsley,27,8,11,73,38,35,89,6
849,Portsmouth,20,15,11,66,54,12,75,7
849,P'borough Utd,23,5,18,73,52,21,74,8
849,Wycombe,22,5,19,62,48,14,71,9
849,Charlton Ath,18,12,16,62,58,4,66,10
849,Fleetwood Town,16,15,15,51,44,7,63,11
849,Lincoln City,13,20,13,43,47,-4,59,12
849,Burton Albion,16,11,19,62,82,-20,59,13
849,Shrewsbury,16,9,21,52,62,-10,57,14
849,Exeter City,14,13,19,58,69,-11,55,15
849,Bristol Rovers,15,10,21,64,84,-20,55,16
849,Port Vale,13,11,22,43,62,-19,50,17
849,Oxford United,11,12,23,43,60,-17,45,18
849,Morecambe,11,12,23,44,70,-26,45,19
849,Cheltenham,11,9,26,32,65,-33,42,20
849,Acc'ton Stanley,10,12,24,34,70,-36,42,21
849,Cambridge Utd,10,8,28,33,71,-38,38,22
849,MK Dons,8,10,28,40,74,-34,34,23
849,FG Rovers,5,11,30,32,91,-59,26,24
850,Sheffield Weds,30,12,4,89,29,60,102,1
850,Plymouth Argyle,28,9,9,83,51,32,93,2
850,Barnsley,25,12,9,77,40,37,87,3
850,Ipswich Town,23,17,6,89,41,48,86,4
850,Derby County,25,10,11,78,44,34,85,5
850,Bolton,24,11,11,65,34,31,83,6
850,Wycombe,23,9,14,68,44,24,78,7
850,Portsmouth,19,18,9,67,52,15,75,8
850,P'borough Utd,20,7,19,69,58,11,67,9
850,Charlton Ath,18,12,16,67,57,10,66,10
850,Shrewsbury,18,10,18,54,55,-1,64,11
850,Lincoln City,14,21,11,48,51,-3,63,12
850,Fleetwood Town,14,17,15,55,48,7,59,13
850,Port Vale,16,10,20,49,62,-13,58,14
850,Exeter City,14,12,20,52,61,-9,54,15
850,Burton Albion,15,9,22,55,86,-31,54,16
850,Bristol Rovers,14,11,21,57,76,-19,53,17
850,Oxford United,12,14,20,51,63,-12,50,18
850,Morecambe,11,13,22,50,75,-25,46,19
850,MK Dons,12,8,26,45,71,-26,44,20
850,Cheltenham,12,8,26,37,72,-35,44,21
850,Acc'ton Stanley,8,15,23,33,74,-41,39,22
850,Cambridge Utd,9,9,28,33,73,-40,36,23
850,FG Rovers,5,12,29,31,85,-54,27,24
851,Sheffield Weds,31,9,6,90,32,58,102,1
851,Plymouth Argyle,29,8,9,83,51,32,95,2
851,Ipswich Town,26,14,6,91,40,51,92,3
851,Barnsley,25,11,10,75,43,32,86,4
851,Derby County,24,12,10,74,45,29,84,5
851,Bolton,23,11,12,65,41,24,80,6
851,Wycombe,22,10,14,68,47,21,76,7
851,P'borough Utd,23,6,17,77,56,21,75,8
851,Portsmouth,19,16,11,71,50,21,73,9
851,Shrewsbury,19,10,17,52,53,-1,67,10
851,Charlton Ath,16,16,14,67,63,4,64,11
851,Exeter City,17,11,18,63,59,4,62,12
851,Lincoln City,13,20,13,40,46,-6,59,13
851,Fleetwood Town,13,19,14,47,45,2,58,14
851,Port Vale,15,10,21,45,62,-17,55,15
851,Bristol Rovers,13,9,24,61,84,-23,48,16
851,Oxford United,11,14,21,43,57,-14,47,17
851,Cheltenham,13,8,25,35,61,-26,47,18
851,Cambridge Utd,11,13,22,38,64,-26,46,19
851,Acc'ton Stanley,10,15,21,42,77,-35,45,20
851,Burton Albion,11,10,25,52,87,-35,43,21
851,MK Dons,10,9,27,45,77,-32,39,22
851,Morecambe,8,13,25,38,78,-40,37,23
851,FG Rovers,7,12,27,36,80,-44,33,24
852,Sheffield Weds,29,13,4,82,35,47,100,1
852,Barnsley,30,7,9,85,41,44,97,2
852,Ipswich Town,25,13,8,83,51,32,88,3
852,Bolton,25,10,11,75,40,35,85,4
852,Plymouth Argyle,24,12,10,79,55,24,84,5
852,Derby County,24,11,11,69,44,25,83,6
852,Portsmouth,22,14,10,79,49,30,80,7
852,Wycombe,23,7,16,71,47,24,76,8
852,P'borough Utd,21,9,16,76,59,17,72,9
852,Fleetwood Town,16,15,15,52,50,2,63,10
852,Charlton Ath,16,14,16,68,62,6,62,11
852,Exeter City,16,13,17,62,59,3,61,12
852,Shrewsbury,17,10,19,53,53,0,61,13
852,Port Vale,14,13,19,48,65,-17,55,14
852,Lincoln City,10,23,13,44,48,-4,53,15
852,Oxford United,12,14,20,45,57,-12,50,16
852,Acc'ton Stanley,12,12,22,44,74,-30,48,17
852,Bristol Rovers,12,11,23,59,83,-24,47,18
852,Cheltenham,12,11,23,36,61,-25,47,19
852,Morecambe,11,13,22,52,82,-30,46,20
852,Burton Albion,10,12,24,58,87,-29,42,21
852,MK Dons,11,8,27,41,71,-30,41,22
852,Cambridge Utd,10,11,25,38,69,-31,41,23
852,FG Rovers,8,8,30,36,93,-57,32,24
853,Sheffield Weds,30,11,5,80,29,51,101,1
853,Barnsley,30,6,10,79,39,40,96,2
853,Ipswich Town,26,13,7,85,41,44,91,3
853,Plymouth Argyle,26,11,9,80,54,26,89,4
853,Bolton,25,10,11,68,36,32,85,5
853,Wycombe,22,10,14,63,44,19,76,6
853,P'borough Utd,23,6,17,70,55,15,75,7
853,Derby County,21,11,14,70,50,20,74,8
853,Fleetwood Town,18,15,13,55,45,10,69,9
853,Charlton Ath,18,14,14,68,54,14,68,10
853,Portsmouth,16,17,13,59,52,7,65,11
853,Shrewsbury,18,11,17,50,49,1,65,12
853,Exeter City,18,10,18,60,57,3,64,13
853,Bristol Rovers,16,10,20,62,73,-11,58,14
853,Oxford United,16,9,21,54,56,-2,57,15
853,Lincoln City,11,21,14,43,52,-9,54,16
853,Port Vale,14,11,21,45,61,-16,53,17
853,MK Dons,13,9,24,45,67,-22,48,18
853,Acc'ton Stanley,9,15,22,35,71,-36,42,19
853,Cheltenham,9,13,24,33,62,-29,40,20
853,Burton Albion,9,12,25,52,89,-37,39,21
853,Morecambe,8,14,24,43,81,-38,38,22
853,Cambridge Utd,8,11,27,34,71,-37,35,23
853,FG Rovers,8,10,28,39,84,-45,34,24
854,Sheffield Weds,30,10,6,83,32,51,100,1
854,Plymouth Argyle,28,12,6,90,49,41,96,2
854,Ipswich Town,27,13,6,90,38,52,94,3
854,Barnsley,28,8,10,82,41,41,92,4
854,Derby County,22,15,9,78,39,39,81,5
854,Bolton,23,12,11,67,36,31,81,6
854,P'borough Utd,24,5,17,80,56,24,77,7
854,Wycombe,22,11,13,64,41,23,77,8
854,Portsmouth,16,20,10,63,51,12,68,9
854,Charlton Ath,15,16,15,67,61,6,61,10
854,Fleetwood Town,15,15,16,50,49,1,60,11
854,Shrewsbury,17,9,20,51,54,-3,60,12
854,Lincoln City,12,21,13,43,48,-5,57,13
854,Oxford United,14,13,19,50,62,-12,55,14
854,Port Vale,14,11,21,47,64,-17,53,15
854,Bristol Rovers,14,11,21,64,84,-20,53,16
854,Cheltenham,15,8,23,37,60,-23,53,17
854,Exeter City,13,12,21,56,71,-15,51,18
854,Burton Albion,13,8,25,59,96,-37,47,19
854,Morecambe,10,14,22,48,76,-28,44,20
854,MK Dons,12,8,26,46,74,-28,44,21
854,Cambridge Utd,10,11,25,40,77,-37,41,22
854,Acc'ton Stanley,8,14,24,35,74,-39,38,23
854,FG Rovers,6,11,29,37,94,-57,29,24
855,Sheffield Weds,30,10,6,84,35,49,100,1
855,Plymouth Argyle,29,10,7,85,52,33,97,2
855,Barnsley,28,5,13,78,41,37,89,3
855,Derby County,26,11,9,76,47,29,89,4
855,Ipswich Town,24,13,9,84,48,36,85,5
855,Bolton,25,9,12,68,37,31,84,6
855,Wycombe,25,7,14,68,41,27,82,7
855,P'borough Utd,22,7,17,82,55,27,73,8
855,Portsmouth,19,13,14,63,51,12,70,9
855,Shrewsbury,19,9,18,57,50,7,66,10
855,Fleetwood Town,14,18,14,46,44,2,60,11
855,Cheltenham,16,12,18,43,52,-9,60,12
855,Oxford United,14,12,20,47,54,-7,54,13
855,Lincoln City,10,24,12,45,53,-8,54,14
855,Bristol Rovers,15,8,23,60,79,-19,53,15
855,Charlton Ath,13,13,20,55,61,-6,52,16
855,Port Vale,14,9,23,46,65,-19,51,17
855,Exeter City,13,11,22,54,70,-16,50,18
855,Acc'ton Stanley,12,10,24,38,77,-39,46,19
855,Burton Albion,11,12,23,51,79,-28,45,20
855,Morecambe,11,12,23,44,75,-31,45,21
855,Cambridge Utd,12,8,26,37,74,-37,44,22
855,MK Dons,10,10,26,40,67,-27,40,23
855,FG Rovers,8,11,27,37,81,-44,35,24
856,Sheffield Weds,33,9,4,87,27,60,108,1
856,Plymouth Argyle,31,9,6,100,47,53,102,2
856,Ipswich Town,24,16,6,85,47,38,88,3
856,Derby County,23,13,10,78,48,30,82,4
856,Bolton,24,10,12,68,38,30,82,5
856,Wycombe,24,8,14,74,46,28,80,6
856,Barnsley,24,7,15,70,47,23,79,7
856,Portsmouth,21,14,11,67,52,15,77,8
856,P'borough Utd,22,5,19,68,58,10,71,9
856,Shrewsbury,18,9,19,61,56,5,63,10
856,Charlton Ath,14,16,16,66,63,3,58,11
856,Fleetwood Town,14,16,16,48,47,1,58,12
856,Lincoln City,11,23,12,45,48,-3,56,13
856,Exeter City,15,11,20,59,63,-4,56,14
856,Burton Albion,14,11,21,55,85,-30,53,15
856,Port Vale,14,10,22,44,69,-25,52,16
856,Oxford United,13,12,21,47,57,-10,51,17
856,Cheltenham,13,12,21,35,53,-18,51,18
856,Bristol Rovers,13,11,22,57,81,-24,50,19
856,MK Dons,13,9,24,46,69,-23,48,20
856,Acc'ton Stanley,10,13,23,39,73,-34,43,21
856,Cambridge Utd,11,8,27,41,79,-38,41,22
856,Morecambe,8,12,26,47,87,-40,36,23
856,FG Rovers,8,10,28,35,82,-47,34,24
857,Sheffield Weds,32,10,4,85,27,58,106,1
857,Plymouth Argyle,29,10,7,98,53,45,97,2
857,Barnsley,28,8,10,77,39,38,92,3
857,Ipswich Town,25,16,5,86,44,42,91,4
857,Derby County,25,12,9,76,45,31,87,5
857,Bolton,22,11,13,64,39,25,77,6
857,Wycombe,22,9,15,63,44,19,75,7
857,Portsmouth,20,15,11,67,49,18,75,8
857,P'borough Utd,22,6,18,82,66,16,72,9
857,Shrewsbury,20,11,15,61,50,11,71,10
857,Charlton Ath,18,12,16,73,60,13,66,11
857,Fleetwood Town,18,12,16,51,46,5,66,12
857,Exeter City,15,12,19,59,62,-3,57,13
857,Lincoln City,11,23,12,46,49,-3,56,14
857,Bristol Rovers,15,10,21,64,77,-13,55,15
857,Cheltenham,13,9,24,35,61,-26,48,16
857,Oxford United,12,10,24,46,62,-16,46,17
857,Port Vale,12,10,24,43,68,-25,46,18
857,Burton Albion,12,9,25,52,90,-38,45,19
857,Cambridge Utd,13,6,27,36,74,-38,45,20
857,MK Dons,11,10,25,41,70,-29,43,21
857,Morecambe,9,11,26,42,78,-36,38,22
857,Acc'ton Stanley,8,14,24,33,73,-40,38,23
857,FG Rovers,8,8,30,33,87,-54,32,24
858,Sheffield Weds,31,10,5,79,29,50,103,1
858,Plymouth Argyle,25,13,8,78,48,30,88,2
858,Derby County,23,14,9,74,42,32,83,3
858,Ipswich Town,21,17,8,79,49,30,80,4
858,Wycombe,24,7,15,64,42,22,79,5
858,Portsmouth,21,15,10,67,50,17,78,6
858,P'borough Utd,24,5,17,71,54,17,77,7
858,Barnsley,22,9,15,66,45,21,75,8
858,Bolton,20,13,13,63,39,24,73,9
858,Charlton Ath,17,13,16,68,59,9,64,10
858,Lincoln City,13,24,9,47,45,2,63,11
858,Bristol Rovers,18,9,19,64,71,-7,63,12
858,Exeter City,16,14,16,59,55,4,62,13
858,Shrewsbury,17,8,21,53,58,-5,59,14
858,Port Vale,17,8,21,51,66,-15,59,15
858,Fleetwood Town,14,16,16,50,45,5,58,16
858,Burton Albion,15,12,19,59,82,-23,57,17
858,Acc'ton Stanley,12,16,18,45,65,-20,52,18
858,Oxford United,12,12,22,42,56,-14,48,19
858,Cheltenham,12,8,26,39,68,-29,44,20
858,MK Dons,11,9,26,41,73,-32,42,21
858,Morecambe,10,11,25,45,75,-30,41,22
858,Cambridge Utd,11,6,29,35,71,-36,39,23
858,FG Rovers,6,11,29,34,86,-52,29,24
859,Sheffield Weds,32,10,4,97,31,66,106,1
859,Plymouth Argyle,28,10,8,80,46,34,94,2
859,Derby County,25,14,7,81,37,44,89,3
859,Barnsley,26,9,11,81,44,37,87,4
859,Ipswich Town,21,17,8,84,46,38,80,5
859,Bolton,22,11,13,60,37,23,77,6
859,P'borough Utd,23,5,18,83,54,29,74,7
859,Wycombe,19,13,14,57,44,13,70,8
859,Portsmouth,18,16,12,67,59,8,70,9
859,Fleetwood Town,17,15,14,52,42,10,66,10
859,Shrewsbury,19,9,18,54,55,-1,66,11
859,Lincoln City,15,18,13,45,46,-1,63,12
859,Exeter City,15,12,19,56,70,-14,57,13
859,Port Vale,15,10,21,46,65,-19,55,14
859,Burton Albion,14,12,20,64,84,-20,54,15
859,Charlton Ath,12,14,20,59,66,-7,50,16
859,Bristol Rovers,13,11,22,61,87,-26,50,17
859,MK Dons,14,7,25,48,69,-21,49,18
859,Morecambe,11,15,20,50,69,-19,48,19
859,Oxford United,12,11,23,45,60,-15,47,20
859,Acc'ton Stanley,12,11,23,36,75,-39,47,21
859,Cambridge Utd,12,8,26,40,74,-34,44,22
859,Cheltenham,9,11,26,30,64,-34,38,23
859,FG Rovers,7,13,26,35,87,-52,34,24
860,Sheffield Weds,29,14,3,81,25,56,101,1
860,Plymouth Argyle,27,11,8,82,55,27,92,2
860,Ipswich Town,25,14,7,80,40,40,89,3
860,Derby County,26,11,9,80,42,38,89,4
860,Barnsley,25,9,12,70,40,30,84,5
860,P'borough Utd,25,6,15,72,52,20,81,6
860,Bolton,23,11,12,71,47,24,80,7
860,Wycombe,22,10,14,66,44,22,76,8
860,Portsmouth,17,18,11,60,50,10,69,9
860,Lincoln City,16,21,9,47,43,4,69,10
860,Charlton Ath,17,15,14,67,54,13,66,11
860,Shrewsbury,17,11,18,51,51,0,62,12
860,Exeter City,16,12,18,58,57,1,60,13
860,Fleetwood Town,13,18,15,43,42,1,57,14
860,Port Vale,14,12,20,50,64,-14,54,15
860,Bristol Rovers,12,12,22,56,81,-25,48,16
860,Oxford United,11,14,21,45,53,-8,47,17
860,Morecambe,10,15,21,50,71,-21,45,18
860,Cambridge Utd,12,9,25,38,69,-31,45,19
860,Burton Albion,11,9,26,56,92,-36,42,20
860,Cheltenham,10,11,25,34,62,-28,41,21
860,MK Dons,10,11,25,42,72,-30,41,22
860,Acc'ton Stanley,9,13,24,36,74,-38,40,23
860,FG Rovers,6,11,29,31,86,-55,29,24
861,Sheffield Weds,33,8,5,90,31,59,107,1
861,Plymouth Argyle,29,12,5,86,45,41,99,2
861,Ipswich Town,25,16,5,78,37,41,91,3
861,Barnsley,26,10,10,72,36,36,88,4
861,Derby County,25,10,11,82,42,40,85,5
861,Bolton,24,10,12,68,40,28,82,6
861,Wycombe,23,8,15,69,44,25,77,7
861,P'borough Utd,22,9,15,79,55,24,75,8
861,Portsmouth,19,13,14,70,58,12,70,9
861,Charlton Ath,17,16,13,69,50,19,67,10
861,Shrewsbury,18,10,18,53,56,-3,64,11
861,Lincoln City,14,19,13,41,51,-10,61,12
861,Exeter City,14,12,20,60,66,-6,54,13
861,Oxford United,14,11,21,53,59,-6,53,14
861,Bristol Rovers,14,11,21,61,83,-22,53,15
861,Fleetwood Town,11,18,17,45,51,-6,51,16
861,Port Vale,13,11,22,44,66,-22,50,17
861,Cheltenham,13,8,25,38,69,-31,47,18
861,Cambridge Utd,13,7,26,38,68,-30,46,19
861,MK Dons,13,6,27,43,73,-30,45,20
861,Acc'ton Stanley,10,14,22,40,69,-29,44,21
861,Morecambe,10,11,25,44,80,-36,41,22
861,Burton Albion,10,10,26,53,94,-41,40,23
861,FG Rovers,7,10,29,33,86,-53,31,24
862,Sheffield Weds,30,11,5,85,33,52,101,1
862,Plymouth Argyle,30,9,7,90,53,37,99,2
862,Ipswich Town,25,15,6,82,43,39,90,3
862,Barnsley,27,8,11,74,43,31,89,4
862,Bolton,26,10,10,76,32,44,88,5
862,Derby County,24,11,11,76,43,33,83,6
862,P'borough Utd,25,3,18,75,53,22,78,7
862,Wycombe,22,11,13,63,42,21,77,8
862,Shrewsbury,20,8,18,52,49,3,68,9
862,Portsmouth,16,18,12,55,47,8,66,10
862,Lincoln City,15,20,11,41,43,-2,65,11
862,Fleetwood Town,15,15,16,47,45,2,60,12
862,Exeter City,15,12,19,59,64,-5,57,13
862,Charlton Ath,13,17,16,59,58,1,56,14
862,Bristol Rovers,14,10,22,60,78,-18,52,15
862,Oxford United,13,12,21,45,57,-12,51,16
862,Port Vale,12,12,22,40,63,-23,48,17
862,MK Dons,11,12,23,44,67,-23,45,18
862,Burton Albion,11,11,24,51,87,-36,44,19
862,Acc'ton Stanley,9,15,22,37,67,-30,42,20
862,Cheltenham,10,11,25,35,67,-32,41,21
862,Cambridge Utd,10,10,26,43,77,-34,40,22
862,Morecambe,8,14,24,43,74,-31,38,23
862,FG Rovers,9,9,28,41,88,-47,36,24
863,Sheffield Weds,29,12,5,87,32,55,99,1
863,Plymouth Argyle,27,12,7,87,52,35,93,2
863,Barnsley,27,10,9,73,38,35,91,3
863,Bolton,25,10,11,68,38,30,85,4
863,Wycombe,25,9,12,68,40,28,84,5
863,Ipswich Town,22,14,10,81,46,35,80,6
863,Derby County,22,12,12,73,44,29,78,7
863,P'borough Utd,23,7,16,79,62,17,76,8
863,Portsmouth,19,13,14,71,55,16,70,9
863,Charlton Ath,19,12,15,76,56,20,69,10
863,Shrewsbury,18,10,18,53,58,-5,64,11
863,Fleetwood Town,14,18,14,46,44,2,60,12
863,Bristol Rovers,16,9,21,61,70,-9,57,13
863,Lincoln City,12,20,14,44,49,-5,56,14
863,Exeter City,14,13,19,58,65,-7,55,15
863,Burton Albion,14,11,21,55,82,-27,53,16
863,Oxford United,13,11,22,46,59,-13,50,17
863,MK Dons,14,8,24,51,69,-18,50,18
863,Port Vale,13,11,22,46,70,-24,50,19
863,Cheltenham,13,11,22,38,62,-24,50,20
863,Acc'ton Stanley,9,15,22,35,72,-37,42,21
863,Cambridge Utd,11,7,28,38,80,-42,40,22
863,Morecambe,8,12,26,40,84,-44,36,23
863,FG Rovers,6,11,29,36,83,-47,29,24
864,Sheffield Weds,30,12,4,83,31,52,102,1
864,Plymouth Argyle,29,9,8,87,48,39,96,2
864,Ipswich Town,25,14,7,83,46,37,89,3
864,Barnsley,26,11,9,74,39,35,89,4
864,Wycombe,24,8,14,71,44,27,80,5
864,Bolton,23,10,13,67,36,31,79,6
864,Derby County,22,11,13,72,44,28,77,7
864,Portsmouth,20,16,10,67,50,17,76,8
864,P'borough Utd,23,6,17,79,57,22,75,9
864,Charlton Ath,17,15,14,67,56,11,66,10
864,Shrewsbury,17,12,17,49,48,1,63,11
864,Port Vale,17,10,19,50,62,-12,61,12
864,Fleetwood Town,14,18,14,51,44,7,60,13
864,Lincoln City,12,23,11,39,43,-4,59,14
864,Exeter City,13,12,21,57,72,-15,51,15
864,Cheltenham,14,9,23,38,54,-16,51,16
864,Bristol Rovers,13,12,21,61,78,-17,51,17
864,Oxford United,11,13,22,44,58,-14,46,18
864,Acc'ton Stanley,10,15,21,34,68,-34,45,19
864,Burton Albion,10,14,22,56,92,-36,44,20
864,Cambridge Utd,12,7,27,39,77,-38,43,21
864,MK Dons,10,10,26,42,72,-30,40,22
864,Morecambe,9,12,25,45,78,-33,39,23
864,FG Rovers,6,11,29,33,91,-58,29,24
865,Sheffield Weds,30,11,5,92,34,58,101,1
865,Plymouth Argyle,26,12,8,84,49,35,90,2
865,Bolton,26,9,11,74,33,41,87,3
865,Wycombe,26,7,13,61,36,25,85,4
865,Derby County,24,11,11,75,43,32,83,5
865,Ipswich Town,23,13,10,80,48,32,82,6
865,Barnsley,24,10,12,64,37,27,82,7
865,P'borough Utd,23,4,19,80,58,22,73,8
865,Shrewsbury,21,9,16,59,46,13,72,9
865,Portsmouth,18,16,12,62,49,13,70,10
865,Charlton Ath,16,17,13,62,50,12,65,11
865,Fleetwood Town,14,15,17,49,48,1,57,12
865,Bristol Rovers,15,12,19,63,75,-12,57,13
865,Port Vale,16,9,21,50,68,-18,57,14
865,Lincoln City,12,20,14,42,50,-8,56,15
865,Exeter City,15,11,20,52,62,-10,56,16
865,MK Dons,14,9,23,41,64,-23,51,17
865,Burton Albion,12,12,22,53,82,-29,48,18
865,Cambridge Utd,13,8,25,40,76,-36,47,19
865,Oxford United,11,12,23,45,64,-19,45,20
865,Cheltenham,11,9,26,33,66,-33,42,21
865,Acc'ton Stanley,10,11,25,44,85,-41,41,22
865,Morecambe,8,14,24,40,76,-36,38,23
865,FG Rovers,8,11,27,33,79,-46,35,24
866,Sheffield Weds,29,12,5,84,31,53,99,1
866,Plymouth Argyle,26,12,8,82,51,31,90,2
866,Derby County,25,13,8,77,38,39,88,3
866,Bolton,26,10,10,69,32,37,88,4
866,Barnsley,26,9,11,72,38,34,87,5
866,Wycombe,25,9,12,69,40,29,84,6
866,Ipswich Town,22,13,11,76,44,32,79,7
866,P'borough Utd,23,8,15,82,55,27,77,8
866,Portsmouth,20,13,13,67,56,11,73,9
866,Charlton Ath,19,13,14,69,60,9,70,10
866,Shrewsbury,19,10,17,57,48,9,67,11
866,Fleetwood Town,17,14,15,53,46,7,65,12
866,Lincoln City,14,19,13,44,50,-6,61,13
866,Exeter City,14,13,19,54,62,-8,55,14
866,Bristol Rovers,14,12,20,61,80,-19,54,15
866,Port Vale,14,10,22,48,70,-22,52,16
866,Oxford United,13,12,21,47,57,-10,51,17
866,Cheltenham,13,7,26,32,68,-36,46,18
866,Burton Albion,10,13,23,53,84,-31,43,19
866,Acc'ton Stanley,9,14,23,35,67,-32,41,20
866,Cambridge Utd,11,7,28,32,76,-44,40,21
866,FG Rovers,9,10,27,36,76,-40,37,22
866,MK Dons,8,11,27,35,69,-34,35,23
866,Morecambe,7,14,25,41,77,-36,35,24
867,Sheffield Weds,30,9,7,79,30,49,99,1
867,Plymouth Argyle,28,9,9,84,51,33,93,2
867,Bolton,27,10,9,72,33,39,91,3
867,Barnsley,28,7,11,69,38,31,91,4
867,Ipswich Town,25,14,7,92,41,51,89,5
867,Derby County,25,11,10,77,46,31,86,6
867,Portsmouth,20,15,11,62,48,14,75,7
867,Wycombe,22,8,16,59,44,15,74,8
867,P'borough Utd,22,5,19,71,56,15,71,9
867,Shrewsbury,19,10,17,50,46,4,67,10
867,Fleetwood Town,15,17,14,55,45,10,62,11
867,Charlton Ath,16,13,17,64,63,1,61,12
867,Port Vale,17,7,22,46,70,-24,58,13
867,Lincoln City,12,21,13,45,47,-2,57,14
867,Oxford United,15,12,19,49,52,-3,57,15
867,Exeter City,15,10,21,59,65,-6,55,16
867,Bristol Rovers,14,10,22,64,86,-22,52,17
867,Burton Albion,14,10,22,57,80,-23,52,18
867,Cheltenham,13,8,25,37,64,-27,47,19
867,Morecambe,9,13,24,43,75,-32,40,20
867,MK Dons,10,9,27,40,72,-32,39,21
867,Cambridge Utd,10,9,27,35,73,-38,39,22
867,Acc'ton Stanley,7,17,22,38,71,-33,38,23
867,FG Rovers,7,10,29,33,84,-51,31,24
868,Sheffield Weds,31,10,5,85,32,53,103,1
868,Plymouth Argyle,27,11,8,85,51,34,92,2
868,Barnsley,27,10,9,74,36,38,91,3
868,Ipswich Town,25,14,7,83,41,42,89,4
868,Derby County,22,12,12,71,42,29,78,5
868,Bolton,22,11,13,63,37,26,77,6
868,Wycombe,22,8,16,63,44,19,74,7
868,Portsmouth,20,14,12,69,53,16,74,8
868,P'borough Utd,23,3,20,70,56,14,72,9
868,Charlton Ath,19,13,14,71,55,16,70,10
868,Fleetwood Town,18,16,12,52,41,11,70,11
868,Lincoln City,16,21,9,45,39,6,69,12
868,Shrewsbury,17,9,20,48,50,-2,60,13
868,Exeter City,15,14,17,52,53,-1,59,14
868,Bristol Rovers,16,11,19,73,86,-13,59,15
868,Oxford United,13,14,19,49,52,-3,53,16
868,Port Vale,14,11,21,48,66,-18,53,17
868,Cambridge Utd,14,7,25,45,76,-31,49,18
868,Acc'ton Stanley,11,11,24,41,84,-43,44,19
868,Burton Albion,10,12,24,54,85,-31,42,20
868,Cheltenham,11,6,29,33,67,-34,39,21
868,Morecambe,9,12,25,39,77,-38,39,22
868,MK Dons,9,10,27,38,67,-29,37,23
868,FG Rovers,7,8,31,38,99,-61,29,24
869,Sheffield Weds,31,9,6,89,31,58,102,1
869,Barnsley,31,7,8,80,36,44,100,2
869,Plymouth Argyle,27,11,8,89,53,36,92,3
869,Derby County,25,12,9,75,40,35,87,4
869,Ipswich Town,24,14,8,89,44,45,86,5
869,Bolton,22,12,12,65,40,25,78,6
869,Wycombe,22,10,14,60,36,24,76,7
869,Portsmouth,19,16,11,64,55,9,73,8
869,P'borough Utd,21,8,17,73,62,11,71,9
869,Shrewsbury,19,9,18,53,50,3,66,10
869,Charlton Ath,15,13,18,60,63,-3,58,11
869,Bristol Rovers,16,10,20,62,73,-11,58,12
869,Lincoln City,13,18,15,46,49,-3,57,13
869,Exeter City,15,10,21,59,63,-4,55,14
869,Fleetwood Town,12,17,17,46,51,-5,53,15
869,Port Vale,14,10,22,47,68,-21,52,16
869,Oxford United,11,13,22,47,63,-16,46,17
869,Acc'ton Stanley,9,19,18,41,68,-27,46,18
869,MK Dons,12,9,25,45,68,-23,45,19
869,Morecambe,11,11,24,48,82,-34,44,20
869,Cheltenham,11,10,25,35,66,-31,43,21
869,Cambridge Utd,11,10,25,39,71,-32,43,22
869,Burton Albion,10,13,23,56,97,-41,43,23
869,FG Rovers,11,9,26,42,81,-39,42,24
870,Sheffield Weds,31,10,5,83,32,51,103,1
870,Derby County,27,10,9,79,41,38,91,2
870,Ipswich Town,24,16,6,87,43,44,88,3
870,Plymouth Argyle,25,12,9,82,51,31,87,4
870,Bolton,23,11,12,64,38,26,80,5
870,Wycombe,23,8,15,66,42,24,77,6
870,Barnsley,22,11,13,68,48,20,77,7
870,Portsmouth,21,13,12,63,50,13,76,8
870,P'borough Utd,22,6,18,74,58,16,72,9
870,Shrewsbury,21,9,16,60,53,7,72,10
870,Fleetwood Town,18,13,15,54,46,8,67,11
870,Lincoln City,14,20,12,43,43,0,62,12
870,Charlton Ath,15,16,15,62,55,7,61,13
870,Exeter City,16,13,17,61,59,2,61,14
870,Oxford United,16,9,21,54,57,-3,57,15
870,Bristol Rovers,16,9,21,63,73,-10,57,16
870,Burton Albion,13,11,22,56,82,-26,50,17
870,Port Vale,14,7,25,41,71,-30,49,18
870,MK Dons,11,10,25,44,70,-26,43,19
870,Acc'ton Stanley,10,12,24,41,73,-32,42,20
870,Cheltenham,11,9,26,33,71,-38,42,21
870,Cambridge Utd,11,7,28,41,77,-36,40,22
870,Morecambe,9,12,25,43,77,-34,39,23
870,FG Rovers,7,10,29,35,87,-52,31,24
871,Sheffield Weds,27,12,7,84,35,49,93,1
871,Ipswich Town,26,14,6,90,39,51,92,2
871,Plymouth Argyle,27,11,8,93,51,42,92,3
871,Derby County,26,13,7,72,36,36,91,4
871,Wycombe,27,8,11,66,34,32,89,5
871,Barnsley,25,7,14,71,47,24,82,6
871,Bolton,22,13,11,68,35,33,79,7
871,Portsmouth,19,13,14,62,55,7,70,8
871,Shrewsbury,18,11,17,59,53,6,65,9
871,P'borough Utd,19,7,20,68,71,-3,64,10
871,Lincoln City,15,18,13,48,47,1,63,11
871,Bristol Rovers,15,14,17,70,74,-4,59,12
871,Fleetwood Town,14,15,17,51,49,2,57,13
871,Exeter City,15,12,19,62,74,-12,57,14
871,Charlton Ath,14,14,18,64,64,0,56,15
871,Cheltenham,16,7,23,39,58,-19,55,16
871,Oxford United,13,12,21,53,57,-4,51,17
871,Port Vale,14,9,23,46,72,-26,51,18
871,Acc'ton Stanley,12,13,21,41,70,-29,49,19
871,MK Dons,13,7,26,44,69,-25,46,20
871,Cambridge Utd,12,8,26,40,79,-39,44,21
871,Burton Albion,10,12,24,48,86,-38,42,22
871,Morecambe,9,14,23,43,79,-36,41,23
871,FG Rovers,7,10,29,33,81,-48,31,24
872,Sheffield Weds,31,10,5,88,30,58,103,1
872,Barnsley,29,7,10,81,41,40,94,2
872,Plymouth Argyle,27,12,7,74,43,31,93,3
872,Ipswich Town,25,14,7,86,46,40,89,4
872,Derby County,24,13,9,78,45,33,85,5
872,Bolton,22,11,13,61,38,23,77,6
872,P'borough Utd,24,4,18,76,58,18,76,7
872,Wycombe,21,8,17,58,46,12,71,8
872,Portsmouth,18,15,13,63,52,11,69,9
872,Lincoln City,14,20,12,46,42,4,62,10
872,Port Vale,17,10,19,52,61,-9,61,11
872,Shrewsbury,16,11,19,51,54,-3,59,12
872,Bristol Rovers,15,13,18,67,76,-9,58,13
872,Charlton Ath,14,15,17,66,64,2,57,14
872,Oxford United,15,10,21,49,54,-5,55,15
872,Fleetwood Town,12,17,17,42,47,-5,53,16
872,Exeter City,13,13,20,54,63,-9,52,17
872,Cheltenham,12,13,21,39,61,-22,49,18
872,Cambridge Utd,13,9,24,41,68,-27,48,19
872,Acc'ton Stanley,12,12,22,37,65,-28,48,20
872,Burton Albion,12,10,24,52,83,-31,46,21
872,Morecambe,9,13,24,43,79,-36,40,22
872,MK Dons,10,8,28,45,83,-38,38,23
872,FG Rovers,6,14,26,35,85,-50,32,24
873,Sheffield Weds,33,8,5,89,35,54,107,1
873,Plymouth Argyle,28,10,8,82,50,32,94,2
873,Barnsley,28,5,13,76,43,33,89,3
873,Ipswich Town,24,14,8,89,47,42,86,4
873,Derby County,24,12,10,75,45,30,84,5
873,Bolton,23,13,10,68,34,34,82,6
873,Wycombe,23,10,13,67,43,24,79,7
873,P'borough Utd,22,5,19,74,61,13,71,8
873,Portsmouth,18,14,14,59,52,7,68,9
873,Lincoln City,16,19,11,50,44,6,67,10
873,Shrewsbury,19,9,18,56,51,5,66,11
873,Charlton Ath,15,14,17,66,68,-2,59,12
873,Fleetwood Town,13,18,15,49,50,-1,57,13
873,Port Vale,15,11,20,50,69,-19,56,14
873,Exeter City,14,12,20,56,59,-3,54,15
873,Oxford United,14,12,20,50,55,-5,54,16
873,Bristol Rovers,14,11,21,59,77,-18,53,17
873,Burton Albion,13,10,23,60,85,-25,49,18
873,MK Dons,12,10,24,46,70,-24,46,19
873,Acc'ton Stanley,10,14,22,38,67,-29,44,20
873,Morecambe,10,12,24,50,76,-26,42,21
873,Cheltenham,9,12,25,31,70,-39,39,22
873,Cambridge Utd,10,9,27,34,75,-41,39,23
873,FG Rovers,8,10,28,41,89,-48,34,24
874,Sheffield Weds,29,13,4,83,29,54,100,1
874,Derby County,27,12,7,79,40,39,93,2
874,Plymouth Argyle,27,10,9,79,50,29,91,3
874,Bolton,26,9,11,75,37,38,87,4
874,Ipswich Town,22,16,8,81,49,32,82,5
874,Barnsley,23,13,10,69,38,31,82,6
874,Wycombe,24,10,12,68,44,24,82,7
874,Portsmouth,19,17,10,70,54,16,74,8
874,Shrewsbury,20,11,15,57,46,11,71,9
874,P'borough Utd,21,7,18,71,63,8,70,10
874,Lincoln City,16,18,12,48,45,3,66,11
874,Charlton Ath,16,14,16,63,59,4,62,12
874,Fleetwood Town,16,13,17,51,50,1,61,13
874,Bristol Rovers,15,11,20,64,77,-13,56,14
874,Port Vale,15,9,22,52,71,-19,54,15
874,Exeter City,13,13,20,51,58,-7,52,16
874,Cheltenham,14,9,23,40,61,-21,51,17
874,Acc'ton Stanley,12,13,21,46,68,-22,49,18
874,Burton Albion,13,9,24,61,88,-27,48,19
874,Morecambe,10,14,22,47,74,-27,44,20
874,Oxford United,9,12,25,44,67,-23,39,21
874,MK Dons,9,10,27,44,75,-31,37,22
874,Cambridge Utd,9,7,30,32,78,-46,34,23
874,FG Rovers,6,12,28,35,89,-54,30,24
875,Sheffield Weds,27,12,7,76,36,40,93,1
875,Bolton,27,9,10,72,34,38,90,2
875,Ipswich Town,24,15,7,86,45,41,87,3
875,Barnsley,26,9,11,72,41,31,87,4
875,Derby County,25,11,10,77,39,38,86,5
875,Wycombe,25,9,12,70,40,30,84,6
875,Plymouth Argyle,24,12,10,85,57,28,84,7
875,P'borough Utd,23,8,15,75,50,25,77,8
875,Portsmouth,16,20,10,64,53,11,68,9
875,Shrewsbury,19,11,16,53,44,9,68,10
875,Charlton Ath,18,13,15,70,61,9,67,11
875,Fleetwood Town,18,12,16,50,45,5,66,12
875,Lincoln City,13,22,11,45,46,-1,61,13
875,Exeter City,15,12,19,55,60,-5,57,14
875,Port Vale,14,13,19,52,68,-16,55,15
875,Bristol Rovers,14,10,22,52,74,-22,52,16
875,Oxford United,11,12,23,45,64,-19,45,17
875,Cheltenham,12,9,25,35,62,-27,45,18
875,Acc'ton Stanley,10,14,22,39,65,-26,44,19
875,Cambridge Utd,11,10,25,39,72,-33,43,20
875,Morecambe,10,12,24,46,78,-32,42,21
875,MK Dons,10,11,25,44,65,-21,41,22
875,Burton Albion,9,12,25,49,94,-45,39,23
875,FG Rovers,7,10,29,33,91,-58,31,24
876,Sheffield Weds,34,9,3,96,29,67,111,1
876,Plymouth Argyle,28,13,5,79,43,36,97,2
876,Ipswich Town,24,15,7,88,50,38,87,3
876,Barnsley,25,9,12,72,41,31,84,4
876,Derby County,24,11,11,73,46,27,83,5
876,Bolton,23,12,11,63,35,28,81,6
876,Wycombe,23,9,14,65,47,18,78,7
876,Shrewsbury,21,10,15,55,44,11,73,8
876,Portsmouth,17,17,12,65,52,13,68,9
876,P'borough Utd,21,5,20,70,61,9,68,10
876,Fleetwood Town,16,16,14,54,42,12,64,11
876,Port Vale,18,10,18,52,59,-7,64,12
876,Bristol Rovers,16,12,18,66,71,-5,60,13
876,Lincoln City,11,24,11,42,45,-3,57,14
876,Charlton Ath,14,14,18,60,63,-3,56,15
876,Exeter City,14,12,20,59,72,-13,54,16
876,Burton Albion,13,10,23,56,81,-25,49,17
876,Oxford United,12,12,22,44,58,-14,48,18
876,Cambridge Utd,11,11,24,37,66,-29,44,19
876,MK Dons,11,8,27,41,71,-30,41,20
876,Cheltenham,10,9,27,30,65,-35,39,21
876,Acc'ton Stanley,8,14,24,39,76,-37,38,22
876,Morecambe,8,12,26,43,78,-35,36,23
876,FG Rovers,8,10,28,33,87,-54,34,24
877,Sheffield Weds,31,9,6,94,38,56,102,1
877,Plymouth Argyle,27,12,7,82,48,34,93,2
877,Ipswich Town,25,16,5,88,43,45,91,3
877,Barnsley,28,7,11,70,39,31,91,4
877,Derby County,24,12,10,75,40,35,84,5
877,Bolton,25,8,13,70,40,30,83,6
877,Portsmouth,21,15,10,72,51,21,78,7
877,Wycombe,21,12,13,60,40,20,75,8
877,P'borough Utd,21,5,20,71,61,10,68,9
877,Shrewsbury,18,9,19,55,57,-2,63,10
877,Charlton Ath,15,17,14,71,63,8,62,11
877,Bristol Rovers,17,10,19,61,73,-12,61,12
877,Fleetwood Town,14,18,14,47,45,2,60,13
877,Exeter City,14,14,18,62,64,-2,56,14
877,Lincoln City,11,23,12,41,47,-6,56,15
877,Oxford United,15,10,21,51,57,-6,55,16
877,Port Vale,14,10,22,43,66,-23,52,17
877,Burton Albion,12,11,23,55,81,-26,47,18
877,Acc'ton Stanley,11,12,23,42,77,-35,45,19
877,Cambridge Utd,12,8,26,40,70,-30,44,20
877,Cheltenham,10,12,24,32,64,-32,42,21
877,MK Dons,11,7,28,40,69,-29,40,22
877,Morecambe,7,14,25,38,76,-38,35,23
877,FG Rovers,8,9,29,36,87,-51,33,24
878,Sheffield Weds,32,10,4,81,31,50,106,1
878,Plymouth Argyle,29,10,7,83,46,37,97,2
878,Ipswich Town,25,16,5,84,37,47,91,3
878,Derby County,24,11,11,73,44,29,83,4
878,Barnsley,24,9,13,67,38,29,81,5
878,Wycombe,22,10,14,63,39,24,76,6
878,P'borough Utd,23,6,17,81,58,23,75,7
878,Bolton,20,12,14,58,37,21,72,8
878,Shrewsbury,20,10,16,57,50,7,70,9
878,Portsmouth,18,15,13,62,51,11,69,10
878,Fleetwood Town,16,16,14,52,43,9,64,11
878,Charlton Ath,15,15,16,58,54,4,60,12
878,Exeter City,15,12,19,55,58,-3,57,13
878,Lincoln City,11,23,12,42,46,-4,56,14
878,Burton Albion,15,10,21,56,87,-31,55,15
878,Oxford United,13,14,19,49,59,-10,53,16
878,Bristol Rovers,13,13,20,64,81,-17,52,17
878,Port Vale,13,13,20,47,69,-22,52,18
878,Acc'ton Stanley,11,14,21,40,67,-27,47,19
878,Morecambe,10,13,23,45,76,-31,43,20
878,Cheltenham,11,10,25,32,64,-32,43,21
878,Cambridge Utd,11,6,29,39,76,-37,39,22
878,MK Dons,10,8,28,40,71,-31,38,23
878,FG Rovers,8,10,28,35,81,-46,34,24
879,Sheffield Weds,27,13,6,74,31,43,94,1
879,Plymouth Argyle,28,10,8,82,51,31,94,2
879,Ipswich Town,25,16,5,83,42,41,91,3
879,Derby County,24,12,10,67,39,28,84,4
879,P'borough Utd,26,5,15,84,55,29,83,5
879,Barnsley,24,11,11,70,41,29,83,6
879,Bolton,23,10,13,66,38,28,79,7
879,Portsmouth,19,16,11,66,51,15,73,8
879,Wycombe,22,7,17,58,47,11,73,9
879,Exeter City,20,10,16,66,50,16,70,10
879,Shrewsbury,18,13,15,49,43,6,67,11
879,Charlton Ath,17,12,17,64,59,5,63,12
879,Fleetwood Town,15,17,14,49,45,4,62,13
879,Lincoln City,10,24,12,41,47,-6,54,14
879,Bristol Rovers,14,10,22,59,79,-20,52,15
879,Cheltenham,13,9,24,36,59,-23,48,16
879,Oxford United,10,15,21,48,65,-17,45,17
879,Morecambe,10,15,21,45,73,-28,45,18
879,Burton Albion,11,12,23,55,87,-32,45,19
879,Port Vale,11,11,24,43,67,-24,44,20
879,Acc'ton Stanley,10,13,23,37,73,-36,43,21
879,MK Dons,11,9,26,43,67,-24,42,22
879,Cambridge Utd,10,10,26,34,68,-34,40,23
879,FG Rovers,8,12,26,35,77,-42,36,24
880,Sheffield Weds,32,10,4,84,30,54,106,1
880,Plymouth Argyle,29,10,7,94,54,40,97,2
880,Ipswich Town,24,17,5,84,43,41,89,3
880,Wycombe,26,9,11,70,38,32,87,4
880,Barnsley,26,7,13,77,39,38,85,5
880,Derby County,22,15,9,75,45,30,81,6
880,Bolton,23,12,11,68,38,30,81,7
880,P'borough Utd,21,8,17,78,62,16,71,8
880,Charlton Ath,17,16,13,71,56,15,67,9
880,Shrewsbury,19,10,17,54,52,2,67,10
880,Lincoln City,14,19,13,46,47,-1,61,11
880,Bristol Rovers,16,9,21,68,77,-9,57,12
880,Fleetwood Town,13,17,16,48,46,2,56,13
880,Port Vale,15,11,20,48,64,-16,56,14
880,Portsmouth,12,19,15,57,61,-4,55,15
880,Cheltenham,14,11,21,36,56,-20,53,16
880,Oxford United,13,12,21,49,57,-8,51,17
880,Exeter City,13,11,22,56,72,-16,50,18
880,MK Dons,12,9,25,41,69,-28,45,19
880,Acc'ton Stanley,10,15,21,35,64,-29,45,20
880,Burton Albion,11,11,24,53,89,-36,44,21
880,Cambridge Utd,11,10,25,38,70,-32,43,22
880,Morecambe,8,13,25,45,87,-42,37,23
880,FG Rovers,5,11,30,35,94,-59,26,24
881,Sheffield Weds,32,11,3,92,35,57,107,1
881,Plymouth Argyle,28,11,7,83,47,36,95,2
881,Ipswich Town,26,15,5,92,41,51,93,3
881,Bolton,27,8,11,72,34,38,89,4
881,Barnsley,24,13,9,73,41,32,85,5
881,Derby County,25,9,12,76,42,34,84,6
881,Portsmouth,21,14,11,76,47,29,77,7
881,Wycombe,22,10,14,67,45,22,76,8
881,P'borough Utd,21,6,19,73,60,13,69,9
881,Fleetwood Town,16,14,16,50,49,1,62,10
881,Shrewsbury,18,8,20,55,61,-6,62,11
881,Port Vale,18,8,20,49,59,-10,62,12
881,Oxford United,16,10,20,53,62,-9,58,13
881,Charlton Ath,14,15,17,65,61,4,57,14
881,Lincoln City,12,21,13,44,50,-6,57,15
881,Exeter City,14,13,19,56,63,-7,55,16
881,Burton Albion,12,13,21,64,87,-23,49,17
881,Morecambe,11,14,21,50,69,-19,47,18
881,Bristol Rovers,11,10,25,55,83,-28,43,19
881,Cheltenham,10,12,24,32,65,-33,42,20
881,Cambridge Utd,12,5,29,40,86,-46,41,21
881,Acc'ton Stanley,8,14,24,39,83,-44,38,22
881,FG Rovers,9,10,27,36,82,-46,37,23
881,MK Dons,9,8,29,41,81,-40,35,24
882,Sheffield Weds,32,9,5,80,29,51,105,1
882,Plymouth Argyle,27,11,8,84,53,31,92,2
882,Ipswich Town,25,14,7,84,42,42,89,3
882,Derby County,26,10,10,75,42,33,88,4
882,Bolton,25,10,11,76,38,38,85,5
882,Barnsley,25,7,14,77,44,33,82,6
882,Shrewsbury,24,7,15,62,41,21,79,7
882,Wycombe,22,11,13,72,46,26,77,8
882,Portsmouth,19,15,12,59,50,9,72,9
882,P'borough Utd,22,4,20,77,66,11,70,10
882,Fleetwood Town,15,17,14,52,50,2,62,11
882,Lincoln City,13,21,12,48,48,0,60,12
882,Charlton Ath,15,14,17,66,63,3,59,13
882,Bristol Rovers,16,11,19,66,78,-12,59,14
882,Exeter City,15,12,19,64,64,0,57,15
882,Cheltenham,14,10,22,41,61,-20,52,16
882,Port Vale,13,13,20,44,66,-22,52,17
882,Oxford United,13,9,24,44,62,-18,48,18
882,Acc'ton Stanley,9,15,22,39,70,-31,42,19
882,MK Dons,11,9,26,38,70,-32,42,20
882,Cambridge Utd,11,8,27,40,77,-37,41,21
882,Burton Albion,10,10,26,52,89,-37,40,22
882,Morecambe,8,13,25,41,80,-39,37,23
882,FG Rovers,7,10,29,35,87,-52,31,24
883,Sheffield Weds,31,9,6,84,29,55,102,1
883,Plymouth Argyle,27,10,9,87,54,33,91,2
883,Barnsley,28,7,11,74,44,30,91,3
883,Ipswich Town,25,13,8,94,44,50,88,4
883,Bolton,24,11,11,69,36,33,83,5
883,Wycombe,25,8,13,65,42,23,83,6
883,Derby County,23,13,10,71,44,27,82,7
883,P'borough Utd,25,6,15,83,52,31,81,8
883,Charlton Ath,20,13,13,70,54,16,73,9
883,Shrewsbury,21,9,16,58,48,10,72,10
883,Portsmouth,18,17,11,63,53,10,71,11
883,Fleetwood Town,14,18,14,48,44,4,60,12
883,Exeter City,16,12,18,63,64,-1,60,13
883,Lincoln City,12,21,13,44,48,-4,57,14
883,Oxford United,15,10,21,47,54,-7,55,15
883,Port Vale,14,10,22,51,73,-22,52,16
883,Bristol Rovers,12,11,23,57,87,-30,47,17
883,Burton Albion,12,9,25,54,92,-38,45,18
883,Acc'ton Stanley,10,12,24,38,68,-30,42,19
883,Cheltenham,10,12,24,29,61,-32,42,20
883,Morecambe,9,12,25,46,82,-36,39,21
883,FG Rovers,8,12,26,38,80,-42,36,22
883,Cambridge Utd,9,8,29,35,78,-43,35,23
883,MK Dons,8,9,29,36,73,-37,33,24
884,Plymouth Argyle,30,11,5,89,46,43,101,1
884,Sheffield Weds,30,10,6,87,31,56,100,2
884,Derby County,25,12,9,74,37,37,87,3
884,P'borough Utd,27,5,14,81,51,30,86,4
884,Barnsley,25,11,10,75,45,30,86,5
884,Ipswich Town,22,17,7,83,47,36,83,6
884,Bolton,23,12,11,66,39,27,81,7
884,Wycombe,22,8,16,65,47,18,74,8
884,Fleetwood Town,17,16,13,52,43,9,67,9
884,Shrewsbury,19,9,18,57,54,3,66,10
884,Lincoln City,12,23,11,46,50,-4,59,11
884,Charlton Ath,15,13,18,64,63,1,58,12
884,Portsmouth,14,16,16,51,54,-3,58,13
884,Port Vale,14,12,20,50,65,-15,54,14
884,Bristol Rovers,15,9,22,62,80,-18,54,15
884,Exeter City,13,13,20,52,63,-11,52,16
884,Morecambe,12,14,20,44,66,-22,50,17
884,Burton Albion,13,9,24,55,81,-26,48,18
884,Oxford United,11,13,22,49,63,-14,46,19
884,Acc'ton Stanley,10,15,21,37,67,-30,45,20
884,MK Dons,11,10,25,38,62,-24,43,21
884,Cheltenham,12,7,27,36,72,-36,43,22
884,Cambridge Utd,11,9,26,34,68,-34,42,23
884,FG Rovers,7,10,29,37,90,-53,31,24
885,Sheffield Weds,33,9,4,100,29,71,108,1
885,Ipswich Town,26,14,6,95,44,51,92,2
885,Bolton,26,10,10,75,37,38,88,3
885,Plymouth Argyle,26,10,10,91,59,32,88,4
885,Barnsley,26,7,13,76,45,31,85,5
885,Derby County,24,11,11,73,45,28,83,6
885,Shrewsbury,24,7,15,65,48,17,79,7
885,Portsmouth,20,13,13,65,55,10,73,8
885,P'borough Utd,22,5,19,71,57,14,71,9
885,Charlton Ath,17,16,13,71,62,9,67,10
885,Wycombe,18,9,19,56,51,5,63,11
885,Exeter City,17,12,17,63,59,4,63,12
885,Fleetwood Town,15,14,17,50,52,-2,59,13
885,Bristol Rovers,16,8,22,76,90,-14,56,14
885,Lincoln City,11,22,13,41,47,-6,55,15
885,Oxford United,14,11,21,50,59,-9,53,16
885,Port Vale,14,9,23,47,73,-26,51,17
885,MK Dons,12,9,25,49,70,-21,45,18
885,Cheltenham,11,11,24,33,67,-34,44,19
885,Acc'ton Stanley,10,13,23,39,78,-39,43,20
885,Morecambe,9,15,22,40,71,-31,42,21
885,Cambridge Utd,11,7,28,39,75,-36,40,22
885,Burton Albion,9,13,24,52,96,-44,40,23
885,FG Rovers,9,9,28,37,85,-48,36,24
886,Sheffield Weds,28,11,7,83,32,51,95,1
886,Plymouth Argyle,28,10,8,87,54,33,94,2
886,Ipswich Town,24,13,9,87,49,38,85,3
886,Bolton,25,10,11,70,35,35,85,4
886,Barnsley,25,10,11,76,43,33,85,5
886,Derby County,23,13,10,77,42,35,82,6
886,Wycombe,23,9,14,62,46,16,78,7
886,Portsmouth,19,14,13,65,55,10,71,8
886,Fleetwood Town,18,14,14,56,48,8,68,9
886,Charlton Ath,18,13,15,73,59,14,67,10
886,Shrewsbury,19,10,17,50,55,-5,67,11
886,P'borough Utd,19,5,22,63,61,2,62,12
886,Lincoln City,13,22,11,45,45,0,61,13
886,Oxford United,15,12,19,55,58,-3,57,14
886,Exeter City,15,12,19,57,62,-5,57,15
886,Burton Albion,15,11,20,60,71,-11,56,16
886,Port Vale,15,10,21,44,60,-16,55,17
886,Bristol Rovers,13,12,21,63,84,-21,51,18
886,Cheltenham,12,10,24,31,63,-32,46,19
886,Cambridge Utd,12,9,25,45,76,-31,45,20
886,Acc'ton Stanley,9,15,22,36,67,-31,42,21
886,Morecambe,10,11,25,48,80,-32,41,22
886,MK Dons,9,9,28,36,72,-36,36,23
886,FG Rovers,7,11,28,32,84,-52,32,24
887,Sheffield Weds,32,11,3,86,27,59,107,1
887,Plymouth Argyle,31,10,5,92,47,45,103,2
887,Ipswich Town,27,13,6,88,40,48,94,3
887,Wycombe,28,6,12,76,40,36,90,4
887,Derby County,24,11,11,72,45,27,83,5
887,Bolton,24,8,14,67,42,25,80,6
887,Barnsley,21,12,13,71,50,21,75,7
887,P'borough Utd,22,5,19,70,57,13,71,8
887,Shrewsbury,20,11,15,54,46,8,71,9
887,Portsmouth,18,16,12,60,47,13,70,10
887,Charlton Ath,16,14,16,60,59,1,62,11
887,Exeter City,17,11,18,62,62,0,62,12
887,Fleetwood Town,15,16,15,50,50,0,61,13
887,Lincoln City,13,20,13,44,49,-5,59,14
887,Bristol Rovers,13,12,21,65,86,-21,51,15
887,Oxford United,12,14,20,49,57,-8,50,16
887,Port Vale,13,11,22,45,65,-20,50,17
887,Cheltenham,13,7,26,36,63,-27,46,18
887,Morecambe,11,12,23,46,75,-29,45,19
887,Acc'ton Stanley,9,15,22,34,69,-35,42,20
887,Burton Albion,10,11,25,54,89,-35,41,21
887,MK Dons,9,11,26,44,74,-30,38,22
887,Cambridge Utd,10,7,29,33,69,-36,37,23
887,FG Rovers,7,10,29,33,83,-50,31,24
888,Sheffield Weds,29,12,5,80,29,51,99,1
888,Plymouth Argyle,28,11,7,83,45,38,95,2
888,Barnsley,27,9,10,70,35,35,90,3
888,Derby County,24,13,9,75,40,35,85,4
888,Ipswich Town,23,15,8,85,49,36,84,5
888,Wycombe,26,6,14,62,40,22,84,6
888,Bolton,24,11,11,69,38,31,83,7
888,P'borough Utd,24,6,16,81,59,22,78,8
888,Portsmouth,21,15,10,62,45,17,78,9
888,Lincoln City,13,23,10,42,41,1,62,10
888,Charlton Ath,15,15,16,74,63,11,60,11
888,Shrewsbury,17,9,20,52,53,-1,60,12
888,Fleetwood Town,13,16,17,47,50,-3,55,13
888,Exeter City,14,12,20,57,57,0,54,14
888,Port Vale,14,11,21,41,61,-20,53,15
888,Bristol Rovers,14,10,22,61,77,-16,52,16
888,Cheltenham,13,10,23,36,60,-24,49,17
888,Acc'ton Stanley,12,11,23,39,76,-37,47,18
888,Oxford United,11,13,22,45,60,-15,46,19
888,Morecambe,10,16,20,44,68,-24,46,20
888,Burton Albion,12,10,24,55,90,-35,46,21
888,Cambridge Utd,11,10,25,34,66,-32,43,22
888,MK Dons,9,9,28,36,75,-39,36,23
888,FG Rovers,7,9,30,33,86,-53,30,24
889,Plymouth Argyle,30,9,7,85,47,38,99,1
889,Sheffield Weds,26,15,5,79,37,42,93,2
889,Ipswich Town,24,17,5,79,41,38,89,3
889,Barnsley,26,9,11,75,41,34,87,4
889,Wycombe,25,8,13,72,42,30,83,5
889,Bolton,22,11,13,65,37,28,77,6
889,Derby County,20,16,10,70,44,26,76,7
889,P'borough Utd,23,6,17,71,51,20,75,8
889,Portsmouth,17,16,13,64,56,8,67,9
889,Shrewsbury,18,12,16,54,52,2,66,10
889,Lincoln City,14,19,13,43,47,-4,61,11
889,Fleetwood Town,14,18,14,51,46,5,60,12
889,Port Vale,16,11,19,47,56,-9,59,13
889,Exeter City,15,12,19,64,62,2,57,14
889,Charlton Ath,14,14,18,65,64,1,56,15
889,Bristol Rovers,11,15,20,63,85,-22,48,16
889,Acc'ton Stanley,11,15,20,38,66,-28,48,17
889,Oxford United,11,14,21,42,57,-15,47,18
889,MK Dons,13,8,25,41,67,-26,47,19
889,Burton Albion,11,14,21,52,81,-29,47,20
889,Cheltenham,12,9,25,36,64,-28,45,21
889,Morecambe,10,13,23,43,73,-30,43,22
889,Cambridge Utd,11,10,25,39,73,-34,43,23
889,FG Rovers,7,11,28,34,83,-49,32,24
890,Plymouth Argyle,30,9,7,93,50,43,99,1
890,Sheffield Weds,28,12,6,78,32,46,96,2
890,Barnsley,27,7,12,74,45,29,88,3
890,Ipswich Town,24,15,7,75,40,35,87,4
890,Derby County,24,14,8,80,38,42,86,5
890,Wycombe,26,8,12,71,40,31,86,6
890,Bolton,24,10,12,70,37,33,82,7
890,P'borough Utd,22,5,19,76,58,18,71,8
890,Portsmouth,18,16,12,68,55,13,70,9
890,Charlton Ath,18,13,15,64,56,8,67,10
890,Shrewsbury,18,12,16,55,50,5,66,11
890,Fleetwood Town,16,13,17,52,47,5,61,12
890,Lincoln City,12,21,13,46,51,-5,57,13
890,Bristol Rovers,15,10,21,63,78,-15,55,14
890,MK Dons,13,10,23,43,63,-20,49,15
890,Port Vale,13,10,23,44,67,-23,49,16
890,Cheltenham,13,10,23,32,57,-25,49,17
890,Oxford United,12,12,22,46,61,-15,48,18
890,Exeter City,12,11,23,51,73,-22,47,19
890,Morecambe,11,14,21,49,72,-23,47,20
890,Acc'ton Stanley,11,12,23,41,73,-32,45,21
890,Burton Albion,11,12,23,49,87,-38,45,22
890,Cambridge Utd,11,7,28,39,75,-36,40,23
890,FG Rovers,7,9,30,31,85,-54,30,24
891,Sheffield Weds,31,11,4,88,29,59,104,1
891,Plymouth Argyle,30,8,8,87,54,33,98,2
891,Ipswich Town,27,14,5,92,41,51,95,3
891,Bolton,24,9,13,67,39,28,81,4
891,Barnsley,24,8,14,70,45,25,80,5
891,P'borough Utd,23,7,16,73,55,18,76,6
891,Derby County,21,12,13,76,45,31,75,7
891,Wycombe,20,12,14,62,49,13,72,8
891,Portsmouth,18,14,14,63,58,5,68,9
891,Shrewsbury,18,9,19,57,55,2,63,10
891,Charlton Ath,15,17,14,65,61,4,62,11
891,Exeter City,16,13,17,59,56,3,61,12
891,Fleetwood Town,15,15,16,53,50,3,60,13
891,Burton Albion,15,12,19,62,80,-18,57,14
891,Oxford United,14,14,18,50,57,-7,56,15
891,Bristol Rovers,15,11,20,61,78,-17,56,16
891,Port Vale,14,12,20,48,67,-19,54,17
891,Lincoln City,10,23,13,39,49,-10,53,18
891,Morecambe,12,11,23,50,72,-22,47,19
891,Cheltenham,11,12,23,35,62,-27,45,20
891,Acc'ton Stanley,10,13,23,36,74,-38,43,21
891,Cambridge Utd,11,7,28,42,77,-35,40,22
891,MK Dons,9,11,26,42,75,-33,38,23
891,FG Rovers,6,11,29,36,85,-49,29,24
892,Sheffield Weds,29,10,7,87,37,50,97,1
892,Plymouth Argyle,27,13,6,90,52,38,94,2
892,Ipswich Town,23,17,6,80,42,38,86,3
892,Barnsley,25,10,11,73,42,31,85,4
892,Derby County,22,13,11,69,39,30,79,5
892,Bolton,23,10,13,63,39,24,79,6
892,Wycombe,23,9,14,72,49,23,78,7
892,P'borough Utd,24,5,17,75,57,18,77,8
892,Portsmouth,19,16,11,69,53,16,73,9
892,Fleetwood Town,16,16,14,52,44,8,64,10
892,Exeter City,16,13,17,57,56,1,61,11
892,Shrewsbury,17,10,19,51,53,-2,61,12
892,Charlton Ath,16,11,19,76,69,7,59,13
892,Lincoln City,12,21,13,44,53,-9,57,14
892,Bristol Rovers,15,10,21,61,82,-21,55,15
892,Port Vale,15,10,21,44,67,-23,55,16
892,Burton Albion,15,9,22,56,80,-24,54,17
892,Oxford United,13,11,22,46,56,-10,50,18
892,MK Dons,12,9,25,42,67,-25,45,19
892,Cheltenham,12,9,25,39,65,-26,45,20
892,Morecambe,10,14,22,46,74,-28,44,21
892,Cambridge Utd,11,11,24,40,69,-29,44,22
892,Acc'ton Stanley,9,15,22,37,70,-33,42,23
892,FG Rovers,5,14,27,34,88,-54,29,24
893,Sheffield Weds,30,12,4,83,27,56,102,1
893,Plymouth Argyle,29,12,5,91,49,42,99,2
893,Barnsley,26,7,13,77,47,30,85,3
893,Bolton,25,9,12,71,35,36,84,4
893,Derby County,23,11,12,77,48,29,80,5
893,Ipswich Town,22,12,12,80,48,32,78,6
893,P'borough Utd,24,5,17,75,54,21,77,7
893,Portsmouth,19,18,9,68,42,26,75,8
893,Shrewsbury,22,8,16,59,50,9,74,9
893,Wycombe,22,7,17,64,43,21,73,10
893,Fleetwood Town,19,14,13,53,40,13,71,11
893,Charlton Ath,15,15,16,62,59,3,60,12
893,Lincoln City,13,20,13,42,47,-5,59,13
893,Exeter City,14,13,19,57,69,-12,55,14
893,Bristol Rovers,13,12,21,62,79,-17,51,15
893,MK Dons,13,10,23,47,71,-24,49,16
893,Cheltenham,13,9,24,32,55,-23,48,17
893,Port Vale,12,12,22,43,73,-30,48,18
893,Burton Albion,12,11,23,52,87,-35,47,19
893,Morecambe,11,13,22,47,75,-28,46,20
893,Oxford United,11,12,23,48,63,-15,45,21
893,Cambridge Utd,12,9,25,43,70,-27,45,22
893,Acc'ton Stanley,9,12,25,36,80,-44,39,23
893,FG Rovers,6,11,29,29,87,-58,29,24
894,Sheffield Weds,30,11,5,89,37,52,101,1
894,Plymouth Argyle,27,11,8,82,54,28,92,2
894,Barnsley,27,6,13,76,46,30,87,3
894,Wycombe,27,6,13,70,41,29,87,4
894,Ipswich Town,24,14,8,87,46,41,86,5
894,Bolton,24,12,10,72,36,36,84,6
894,Derby County,22,11,13,72,49,23,77,7
894,P'borough Utd,24,3,19,84,57,27,75,8
894,Shrewsbury,20,9,17,59,50,9,69,9
894,Portsmouth,18,14,14,64,56,8,68,10
894,Exeter City,18,10,18,65,72,-7,64,11
894,Charlton Ath,17,12,17,68,60,8,63,12
894,Fleetwood Town,15,15,16,48,44,4,60,13
894,Lincoln City,12,22,12,40,44,-4,58,14
894,Oxford United,13,14,19,47,56,-9,53,15
894,Bristol Rovers,14,11,21,67,83,-16,53,16
894,Cheltenham,14,11,21,37,61,-24,53,17
894,Port Vale,14,10,22,49,67,-18,52,18
894,Acc'ton Stanley,13,11,22,44,70,-26,50,19
894,Burton Albion,13,10,23,54,86,-32,49,20
894,Morecambe,11,11,24,48,81,-33,44,21
894,MK Dons,12,7,27,44,71,-27,43,22
894,Cambridge Utd,9,7,30,34,75,-41,34,23
894,FG Rovers,5,10,31,30,88,-58,25,24
895,Sheffield Weds,31,9,6,80,30,50,102,1
895,Plymouth Argyle,29,10,7,89,50,39,97,2
895,Ipswich Town,26,15,5,98,44,54,93,3
895,Bolton,26,9,11,70,34,36,87,4
895,Barnsley,26,8,12,73,40,33,86,5
895,Derby County,23,12,11,70,41,29,81,6
895,P'borough Utd,23,6,17,76,57,19,75,7
895,Wycombe,22,7,17,59,44,15,73,8
895,Lincoln City,16,19,11,51,45,6,67,9
895,Portsmouth,16,18,12,61,54,7,66,10
895,Shrewsbury,19,8,19,53,53,0,65,11
895,Fleetwood Town,15,16,15,53,44,9,61,12
895,Charlton Ath,14,18,14,62,59,3,60,13
895,Exeter City,16,11,19,60,61,-1,59,14
895,Bristol Rovers,14,12,20,68,82,-14,54,15
895,Oxford United,12,13,21,43,53,-10,49,16
895,Burton Albion,12,13,21,55,85,-30,49,17
895,Port Vale,12,12,22,42,72,-30,48,18
895,Morecambe,10,13,23,43,75,-32,43,19
895,Acc'ton Stanley,9,16,21,32,67,-35,43,20
895,MK Dons,11,9,26,39,67,-28,42,21
895,Cheltenham,11,9,26,32,62,-30,42,22
895,Cambridge Utd,9,10,27,32,72,-40,37,23
895,FG Rovers,8,11,27,36,86,-50,35,24
896,Plymouth Argyle,29,11,6,87,46,41,98,1
896,Sheffield Weds,27,16,3,82,32,50,97,2
896,Ipswich Town,25,15,6,88,43,45,90,3
896,Barnsley,26,10,10,72,45,27,88,4
896,Bolton,25,11,10,77,36,41,86,5
896,Derby County,22,16,8,79,44,35,82,6
896,P'borough Utd,23,6,17,78,54,24,75,7
896,Wycombe,21,9,16,59,46,13,72,8
896,Fleetwood Town,17,17,12,54,44,10,68,9
896,Charlton Ath,18,13,15,73,57,16,67,10
896,Lincoln City,15,21,10,44,40,4,66,11
896,Portsmouth,15,18,13,61,55,6,63,12
896,Shrewsbury,16,11,19,46,48,-2,59,13
896,Port Vale,16,11,19,50,59,-9,59,14
896,Bristol Rovers,15,13,18,63,72,-9,58,15
896,Exeter City,13,12,21,57,70,-13,51,16
896,Morecambe,13,12,21,55,79,-24,51,17
896,Oxford United,11,14,21,48,63,-15,47,18
896,Cheltenham,11,11,24,35,65,-30,44,19
896,Burton Albion,11,11,24,58,94,-36,44,20
896,Acc'ton Stanley,9,14,23,38,82,-44,41,21
896,MK Dons,10,7,29,49,85,-36,37,22
896,Cambridge Utd,10,7,29,40,83,-43,37,23
896,FG Rovers,5,12,29,35,86,-51,27,24
897,Sheffield Weds,30,12,4,83,32,51,102,1
897,Plymouth Argyle,27,12,7,85,50,35,93,2
897,Ipswich Town,25,13,8,81,46,35,88,3
897,Barnsley,26,7,13,75,44,31,85,4
897,Wycombe,26,7,13,67,37,30,85,5
897,Derby County,23,12,11,72,40,32,81,6
897,Bolton,23,10,13,66,42,24,79,7
897,P'borough Utd,25,3,18,86,58,28,78,8
897,Shrewsbury,20,10,16,58,49,9,70,9
897,Portsmouth,17,15,14,61,57,4,66,10
897,Exeter City,17,12,17,64,57,7,63,11
897,Fleetwood Town,16,14,16,50,47,3,62,12
897,Lincoln City,14,18,14,50,52,-2,60,13
897,Charlton Ath,12,20,14,63,58,5,56,14
897,Port Vale,15,11,20,48,66,-18,56,15
897,Oxford United,14,12,20,48,55,-7,54,16
897,Bristol Rovers,14,10,22,59,77,-18,52,17
897,Cambridge Utd,13,8,25,43,67,-24,47,18
897,Acc'ton Stanley,11,14,21,43,73,-30,47,19
897,Cheltenham,12,8,26,34,69,-35,44,20
897,Burton Albion,10,13,23,54,94,-40,43,21
897,MK Dons,11,8,27,43,73,-30,41,22
897,Morecambe,9,13,24,46,75,-29,40,23
897,FG Rovers,6,10,30,29,90,-61,28,24
898,Sheffield Weds,32,11,3,83,29,54,107,1
898,Plymouth Argyle,28,11,7,84,44,40,95,2
898,Bolton,26,10,10,73,34,39,88,3
898,Barnsley,26,9,11,80,43,37,87,4
898,Ipswich Town,22,17,7,80,48,32,83,5
898,Derby County,23,12,11,76,44,32,81,6
898,Portsmouth,19,16,11,62,48,14,73,7
898,Wycombe,21,10,15,56,43,13,73,8
898,P'borough Utd,21,5,20,73,62,11,68,9
898,Lincoln City,15,22,9,50,46,4,67,10
898,Exeter City,18,11,17,68,59,9,65,11
898,Shrewsbury,19,8,19,55,52,3,65,12
898,Fleetwood Town,16,13,17,44,45,-1,61,13
898,Bristol Rovers,14,11,21,65,80,-15,53,14
898,Burton Albion,14,10,22,62,86,-24,52,15
898,Charlton Ath,12,15,19,60,66,-6,51,16
898,Oxford United,13,12,21,53,60,-7,51,17
898,Morecambe,12,13,21,53,70,-17,49,18
898,Port Vale,12,10,24,43,69,-26,46,19
898,MK Dons,12,9,25,41,70,-29,45,20
898,Cheltenham,12,8,26,31,65,-34,44,21
898,Cambridge Utd,12,7,27,37,71,-34,43,22
898,Acc'ton Stanley,10,13,23,38,73,-35,43,23
898,FG Rovers,5,13,28,33,93,-60,28,24
899,Sheffield Weds,32,10,4,95,34,61,106,1
899,Plymouth Argyle,28,9,9,85,51,34,93,2
899,Ipswich Town,25,14,7,88,44,44,89,3
899,Bolton,26,10,10,68,35,33,88,4
899,Derby County,25,11,10,75,43,32,86,5
899,Barnsley,24,12,10,68,43,25,84,6
899,Wycombe,24,8,14,74,45,29,80,7
899,Portsmouth,21,16,9,74,49,25,79,8
899,P'borough Utd,24,5,17,83,59,24,77,9
899,Lincoln City,15,21,10,52,44,8,66,10
899,Charlton Ath,17,12,17,71,65,6,63,11
899,Exeter City,16,12,18,62,64,-2,60,12
899,Shrewsbury,16,9,21,54,57,-3,57,13
899,Fleetwood Town,14,14,18,47,54,-7,56,14
899,Bristol Rovers,14,11,21,68,84,-16,53,15
899,Oxford United,13,12,21,55,64,-9,51,16
899,Port Vale,14,9,23,43,67,-24,51,17
899,Acc'ton Stanley,12,13,21,48,70,-22,49,18
899,Burton Albion,13,9,24,60,91,-31,48,19
899,MK Dons,11,9,26,45,73,-28,42,20
899,Cheltenham,10,8,28,37,71,-34,38,21
899,Morecambe,8,13,25,40,82,-42,37,22
899,Cambridge Utd,10,7,29,37,87,-50,37,23
899,FG Rovers,9,8,29,35,88,-53,35,24
900,Plymouth Argyle,31,9,6,99,45,54,102,1
900,Wycombe,28,7,11,69,40,29,91,2
900,Sheffield Weds,26,12,8,74,35,39,90,3
900,Ipswich Town,25,14,7,82,42,40,89,4
900,Derby County,24,13,9,76,45,31,85,5
900,Barnsley,25,9,12,78,44,34,84,6
900,Bolton,21,14,11,65,35,30,77,7
900,P'borough Utd,22,7,17,70,54,16,73,8
900,Shrewsbury,20,10,16,52,48,4,70,9
900,Portsmouth,17,15,14,60,57,3,66,10
900,Fleetwood Town,16,15,15,54,48,6,63,11
900,Exeter City,17,11,18,59,56,3,62,12
900,Lincoln City,14,20,12,44,47,-3,62,13
900,Charlton Ath,16,13,17,60,61,-1,61,14
900,Bristol Rovers,14,10,22,63,81,-18,52,15
900,Port Vale,13,13,20,46,64,-18,52,16
900,Oxford United,11,13,22,47,59,-12,46,17
900,Cheltenham,13,7,26,38,64,-26,46,18
900,Morecambe,10,14,22,44,72,-28,44,19
900,Acc'ton Stanley,10,13,23,37,73,-36,43,20
900,MK Dons,11,8,27,44,72,-28,41,21
900,Burton Albion,10,11,25,55,89,-34,41,22
900,Cambridge Utd,11,8,27,44,85,-41,41,23
900,FG Rovers,9,10,27,38,82,-44,37,24
901,Plymouth Argyle,31,8,7,85,45,40,101,1
901,Sheffield Weds,29,10,7,83,37,46,97,2
901,Barnsley,27,9,10,75,40,35,90,3
901,Derby County,26,11,9,77,37,40,89,4
901,Ipswich Town,23,17,6,79,46,33,86,5
901,Bolton,24,11,11,70,37,33,83,6
901,P'borough Utd,23,8,15,75,50,25,77,7
901,Portsmouth,20,15,11,68,51,17,75,8
901,Wycombe,22,8,16,68,42,26,74,9
901,Shrewsbury,20,9,17,56,49,7,69,10
901,Fleetwood Town,15,18,13,46,41,5,63,11
901,Charlton Ath,17,11,18,72,66,6,62,12
901,Lincoln City,13,18,15,42,47,-5,57,13
901,Exeter City,15,11,20,62,64,-2,56,14
901,Bristol Rovers,16,8,22,66,81,-15,56,15
901,Oxford United,14,11,21,54,58,-4,53,16
901,Port Vale,14,10,22,43,69,-26,52,17
901,Burton Albion,12,13,21,54,83,-29,49,18
901,Acc'ton Stanley,12,13,21,41,70,-29,49,19
901,Cheltenham,11,11,24,34,69,-35,44,20
901,MK Dons,9,10,27,38,73,-35,37,21
901,Morecambe,9,10,27,40,80,-40,37,22
901,Cambridge Utd,9,9,28,29,71,-42,36,23
901,FG Rovers,6,11,29,37,88,-51,29,24
902,Plymouth Argyle,29,11,6,84,46,38,98,1
902,Sheffield Weds,28,12,6,77,32,45,96,2
902,Bolton,27,10,9,74,35,39,91,3
902,Ipswich Town,24,13,9,90,53,37,85,4
902,Barnsley,23,15,8,68,39,29,84,5
902,Derby County,24,12,10,75,47,28,84,6
902,Wycombe,23,9,14,66,39,27,78,7
902,P'borough Utd,23,6,17,77,57,20,75,8
902,Portsmouth,18,14,14,58,48,10,68,9
902,Fleetwood Town,18,13,15,59,49,10,67,10
902,Shrewsbury,17,13,16,57,50,7,64,11
902,Lincoln City,13,23,10,49,46,3,62,12
902,Charlton Ath,15,15,16,60,55,5,60,13
902,Exeter City,13,14,19,57,65,-8,53,14
902,Bristol Rovers,13,13,20,61,76,-15,52,15
902,Port Vale,13,11,22,46,67,-21,50,16
902,Oxford United,11,15,20,44,57,-13,48,17
902,Burton Albion,13,9,24,56,85,-29,48,18
902,MK Dons,11,11,24,38,64,-26,44,19
902,Cheltenham,11,10,25,32,63,-31,43,20
902,Acc'ton Stanley,9,15,22,37,71,-34,42,21
902,Cambridge Utd,12,5,29,36,80,-44,41,22
902,Morecambe,8,16,22,41,67,-26,40,23
902,FG Rovers,9,9,28,37,88,-51,36,24
903,Sheffield Weds,30,11,5,90,37,53,101,1
903,Plymouth Argyle,27,12,7,83,51,32,93,2
903,Barnsley,28,8,10,80,40,40,92,3
903,Ipswich Town,24,16,6,87,46,41,88,4
903,Derby County,24,10,12,80,44,36,82,5
903,Bolton,23,11,12,64,36,28,80,6
903,Wycombe,21,11,14,61,39,22,74,7
903,Portsmouth,18,16,12,68,56,12,70,8
903,P'borough Utd,20,8,18,78,60,18,68,9
903,Charlton Ath,17,13,16,65,56,9,64,10
903,Lincoln City,14,20,12,41,45,-4,62,11
903,Exeter City,15,14,17,57,54,3,59,12
903,Shrewsbury,15,13,18,51,60,-9,58,13
903,Fleetwood Town,14,15,17,46,46,0,57,14
903,Port Vale,15,9,22,45,70,-25,54,15
903,Oxford United,13,12,21,52,61,-9,51,16
903,Bristol Rovers,13,12,21,59,74,-15,51,17
903,Burton Albion,14,9,23,53,88,-35,51,18
903,Acc'ton Stanley,12,14,20,44,66,-22,50,19
903,Cambridge Utd,14,7,25,39,69,-30,49,20
903,Cheltenham,11,10,25,32,60,-28,43,21
903,MK Dons,11,8,27,39,72,-33,41,22
903,Morecambe,8,16,22,43,74,-31,40,23
903,FG Rovers,8,11,27,36,89,-53,35,24
904,Sheffield Weds,32,9,5,91,32,59,105,1
904,Plymouth Argyle,30,10,6,93,44,49,100,2
904,Barnsley,26,9,11,67,42,25,87,3
904,Derby County,25,11,10,69,40,29,86,4
904,Bolton,25,9,12,73,37,36,84,5
904,Ipswich Town,21,17,8,75,44,31,80,6
904,P'borough Utd,24,6,16,76,50,26,78,7
904,Wycombe,22,12,12,67,42,25,78,8
904,Portsmouth,18,17,11,63,48,15,71,9
904,Fleetwood Town,17,17,12,54,42,12,68,10
904,Shrewsbury,19,11,16,60,49,11,68,11
904,Lincoln City,14,19,13,48,54,-6,61,12
904,Port Vale,16,9,21,49,60,-11,57,13
904,Charlton Ath,14,14,18,55,62,-7,56,14
904,Bristol Rovers,14,11,21,61,84,-23,53,15
904,Exeter City,13,13,20,56,64,-8,52,16
904,Oxford United,13,10,23,45,63,-18,49,17
904,Morecambe,10,16,20,44,66,-22,46,18
904,Acc'ton Stanley,11,13,22,41,72,-31,46,19
904,Burton Albion,12,10,24,52,84,-32,46,20
904,MK Dons,10,11,25,41,65,-24,41,21
904,Cheltenham,11,8,27,31,70,-39,41,22
904,Cambridge Utd,9,7,30,36,78,-42,34,23
904,FG Rovers,7,9,30,33,88,-55,30,24
905,Plymouth Argyle,28,13,5,87,47,40,97,1
905,Sheffield Weds,27,14,5,77,32,45,95,2
905,Derby County,28,10,8,85,40,45,94,3
905,Barnsley,27,9,10,80,44,36,90,4
905,Ipswich Town,24,14,8,84,47,37,86,5
905,Bolton,22,13,11,64,33,31,79,6
905,Wycombe,22,9,15,64,46,18,75,7
905,P'borough Utd,22,7,17,78,52,26,73,8
905,Portsmouth,19,14,13,70,56,14,71,9
905,Shrewsbury,20,8,18,52,51,1,68,10
905,Charlton Ath,17,12,17,67,62,5,63,11
905,Fleetwood Town,15,16,15,53,46,7,61,12
905,Lincoln City,12,22,12,39,40,-1,58,13
905,Exeter City,14,15,17,59,64,-5,57,14
905,Port Vale,15,11,20,44,65,-21,56,15
905,Oxford United,14,13,19,50,55,-5,55,16
905,Bristol Rovers,14,13,19,62,79,-17,55,17
905,Morecambe,11,12,23,52,80,-28,45,18
905,Acc'ton Stanley,11,12,23,43,74,-31,45,19
905,Cheltenham,11,11,24,32,61,-29,44,20
905,Burton Albion,11,11,24,51,85,-34,44,21
905,Cambridge Utd,10,10,26,39,77,-38,40,22
905,MK Dons,9,7,30,39,77,-38,34,23
905,FG Rovers,6,10,30,36,94,-58,28,24
906,Sheffield Weds,29,11,6,85,36,49,98,1
906,Plymouth Argyle,28,12,6,83,46,37,96,2
906,Barnsley,29,6,11,76,39,37,93,3
906,Ipswich Town,25,16,5,84,42,42,91,4
906,Bolton,23,12,11,65,37,28,81,5
906,Derby County,22,12,12,68,46,22,78,6
906,Wycombe,22,8,16,65,46,19,74,7
906,Portsmouth,20,13,13,63,51,12,73,8
906,P'borough Utd,20,10,16,73,62,11,70,9
906,Fleetwood Town,17,15,14,47,43,4,66,10
906,Charlton Ath,18,11,17,68,58,10,65,11
906,Shrewsbury,18,9,19,55,54,1,63,12
906,Bristol Rovers,15,11,20,66,79,-13,56,13
906,Lincoln City,10,24,12,44,52,-8,54,14
906,Port Vale,15,9,22,46,62,-16,54,15
906,Exeter City,13,14,19,55,62,-7,53,16
906,Morecambe,12,14,20,45,65,-20,50,17
906,Cheltenham,13,9,24,38,65,-27,48,18
906,Burton Albion,12,9,25,60,90,-30,45,19
906,Oxford United,10,14,22,48,61,-13,44,20
906,Acc'ton Stanley,9,17,20,39,66,-27,44,21
906,MK Dons,12,8,26,42,70,-28,44,22
906,Cambridge Utd,9,11,26,35,70,-35,38,23
906,FG Rovers,8,11,27,39,87,-48,35,24
907,Sheffield Weds,30,11,5,87,33,54,101,1
907,Plymouth Argyle,29,12,5,91,48,43,99,2
907,Wycombe,26,8,12,63,36,27,86,3
907,Derby County,24,13,9,75,43,32,85,4
907,Ipswich Town,21,19,6,86,49,37,82,5
907,Bolton,23,13,10,65,34,31,82,6
907,Barnsley,23,12,11,66,39,27,81,7
907,P'borough Utd,23,7,16,84,63,21,76,8
907,Shrewsbury,19,11,16,52,48,4,68,9
907,Portsmouth,17,16,13,61,53,8,67,10
907,Lincoln City,14,21,11,53,50,3,63,11
907,Fleetwood Town,15,17,14,51,46,5,62,12
907,Charlton Ath,14,17,15,62,58,4,59,13
907,Exeter City,14,15,17,58,58,0,57,14
907,Bristol Rovers,12,16,18,63,75,-12,52,15
907,Oxford United,12,13,21,49,62,-13,49,16
907,Acc'ton Stanley,11,14,21,41,68,-27,47,17
907,MK Dons,12,10,24,41,62,-21,46,18
907,Port Vale,12,10,24,48,75,-27,46,19
907,Cheltenham,12,10,24,34,65,-31,46,20
907,Cambridge Utd,10,11,25,35,70,-35,41,21
907,Burton Albion,10,9,27,48,95,-47,39,22
907,Morecambe,8,14,24,43,76,-33,38,23
907,FG Rovers,6,11,29,35,85,-50,29,24
908,Sheffield Weds,31,10,5,86,30,56,103,1
908,Plymouth Argyle,29,11,6,90,45,45,98,2
908,Derby County,25,12,9,76,43,33,87,3
908,Bolton,26,9,11,69,36,33,87,4
908,Ipswich Town,22,18,6,89,52,37,84,5
908,Barnsley,23,10,13,69,46,23,79,6
908,Wycombe,23,8,15,65,46,19,77,7
908,Portsmouth,20,15,11,69,44,25,75,8
908,P'borough Utd,21,9,16,74,58,16,72,9
908,Shrewsbury,19,11,16,57,52,5,68,10
908,Fleetwood Town,16,15,15,53,45,8,63,11
908,Lincoln City,13,22,11,44,46,-2,61,12
908,Bristol Rovers,15,12,19,67,77,-10,57,13
908,Exeter City,15,11,20,58,64,-6,56,14
908,Port Vale,15,10,21,43,69,-26,55,15
908,Charlton Ath,12,15,19,62,64,-2,51,16
908,MK Dons,14,7,25,42,63,-21,49,17
908,Cambridge Utd,13,7,26,44,67,-23,46,18
908,Cheltenham,11,11,24,33,58,-25,44,19
908,Burton Albion,11,11,24,52,89,-37,44,20
908,Oxford United,10,13,23,46,64,-18,43,21
908,Acc'ton Stanley,9,15,22,42,79,-37,42,22
908,Morecambe,10,11,25,51,89,-38,41,23
908,FG Rovers,7,11,28,37,92,-55,32,24
909,Sheffield Weds,29,12,5,83,34,49,99,1
909,Plymouth Argyle,28,8,10,84,51,33,92,2
909,Barnsley,27,10,9,78,42,36,91,3
909,Ipswich Town,24,16,6,85,45,40,88,4
909,Derby County,23,13,10,72,45,27,82,5
909,Bolton,24,8,14,64,39,25,80,6
909,Wycombe,23,8,15,66,46,20,77,7
909,Portsmouth,19,17,10,60,44,16,74,8
909,P'borough Utd,21,7,18,80,64,16,70,9
909,Lincoln City,15,23,8,55,43,12,68,10
909,Fleetwood Town,17,12,17,54,52,2,63,11
909,Shrewsbury,18,9,19,53,56,-3,63,12
909,Bristol Rovers,18,9,19,64,72,-8,63,13
909,Charlton Ath,16,12,18,65,63,2,60,14
909,Exeter City,15,14,17,58,55,3,59,15
909,Port Vale,14,10,22,42,65,-23,52,16
909,Cheltenham,13,10,23,38,60,-22,49,17
909,Oxford United,12,12,22,50,64,-14,48,18
909,MK Dons,12,9,25,42,66,-24,45,19
909,Acc'ton Stanley,11,11,24,40,70,-30,44,20
909,Morecambe,11,11,24,41,72,-31,44,21
909,Burton Albion,11,11,24,52,90,-38,44,22
909,Cambridge Utd,10,9,27,39,72,-33,39,23
909,FG Rovers,6,9,31,34,89,-55,27,24
910,Sheffield Weds,28,11,7,80,35,45,95,1
910,Barnsley,28,5,13,82,43,39,89,2
910,Derby County,25,12,9,79,41,38,87,3
910,Plymouth Argyle,24,14,8,81,49,32,86,4
910,Bolton,24,10,12,66,37,29,82,5
910,Ipswich Town,20,18,8,80,48,32,78,6
910,Portsmouth,21,13,12,72,56,16,76,7
910,Wycombe,20,13,13,65,47,18,73,8
910,P'borough Utd,21,6,19,77,67,10,69,9
910,Shrewsbury,20,9,17,58,53,5,69,10
910,Charlton Ath,17,14,15,70,59,11,65,11
910,Lincoln City,14,22,10,42,41,1,64,12
910,Fleetwood Town,14,18,14,51,43,8,60,13
910,Exeter City,15,13,18,59,62,-3,58,14
910,Port Vale,16,9,21,44,62,-18,57,15
910,Bristol Rovers,15,10,21,62,77,-15,55,16
910,Cheltenham,13,12,21,37,55,-18,51,17
910,Acc'ton Stanley,11,15,20,37,65,-28,48,18
910,Oxford United,11,13,22,46,60,-14,46,19
910,Burton Albion,11,13,22,55,85,-30,46,20
910,MK Dons,11,9,26,41,72,-31,42,21
910,Morecambe,9,13,24,42,78,-36,40,22
910,Cambridge Utd,10,9,27,37,76,-39,39,23
910,FG Rovers,9,9,28,35,87,-52,36,24
911,Sheffield Weds,32,9,5,87,33,54,105,1
911,Plymouth Argyle,29,12,5,95,52,43,99,2
911,Ipswich Town,24,15,7,82,43,39,87,3
911,Wycombe,27,6,13,67,37,30,87,4
911,Barnsley,25,8,13,74,42,32,83,5
911,Bolton,24,10,12,67,42,25,82,6
911,Derby County,22,14,10,73,48,25,80,7
911,P'borough Utd,23,5,18,72,51,21,74,8
911,Portsmouth,18,17,11,69,54,15,71,9
911,Charlton Ath,18,13,15,76,58,18,67,10
911,Shrewsbury,19,8,19,53,51,2,65,11
911,Lincoln City,14,21,11,42,44,-2,63,12
911,Fleetwood Town,16,14,16,49,42,7,62,13
911,Port Vale,16,9,21,52,68,-16,57,14
911,Exeter City,14,11,21,58,69,-11,53,15
911,Bristol Rovers,14,11,21,63,80,-17,53,16
911,Burton Albion,12,11,23,53,85,-32,47,17
911,Oxford United,10,15,21,47,70,-23,45,18
911,MK Dons,12,9,25,42,66,-24,45,19
911,Acc'ton Stanley,11,12,23,41,71,-30,45,20
911,Cambridge Utd,12,7,27,37,72,-35,43,21
911,Cheltenham,11,9,26,35,66,-31,42,22
911,Morecambe,8,13,25,46,83,-37,37,23
911,FG Rovers,7,9,30,38,91,-53,30,24
912,Sheffield Weds,31,10,5,82,31,51,103,1
912,Plymouth Argyle,29,10,7,92,49,43,97,2
912,Derby County,27,9,10,75,39,36,90,3
912,Ipswich Town,25,12,9,87,52,35,87,4
912,Wycombe,27,6,13,69,37,32,87,5
912,Barnsley,25,11,10,74,40,34,86,6
912,Bolton,24,9,13,70,40,30,81,7
912,P'borough Utd,21,6,19,75,62,13,69,8
912,Fleetwood Town,17,17,12,56,39,17,68,9
912,Portsmouth,17,16,13,59,52,7,67,10
912,Port Vale,18,10,18,49,60,-11,64,11
912,Lincoln City,14,21,11,51,47,4,63,12
912,Shrewsbury,17,9,20,54,53,1,60,13
912,Charlton Ath,14,15,17,56,61,-5,57,14
912,Exeter City,15,10,21,62,62,0,55,15
912,Burton Albion,14,9,23,61,91,-30,51,16
912,Bristol Rovers,13,11,22,61,91,-30,50,17
912,Oxford United,12,12,22,43,59,-16,48,18
912,Cheltenham,13,7,26,36,65,-29,46,19
912,MK Dons,12,9,25,45,66,-21,45,20
912,Acc'ton Stanley,10,15,21,37,66,-29,45,21
912,Cambridge Utd,11,8,27,35,73,-38,41,22
912,Morecambe,7,15,24,38,74,-36,36,23
912,FG Rovers,5,11,30,32,90,-58,26,24
913,Sheffield Weds,30,12,4,91,33,58,102,1
913,Plymouth Argyle,26,12,8,92,51,41,90,2
913,Ipswich Town,25,13,8,86,42,44,88,3
913,Derby County,25,12,9,70,35,35,87,4
913,Barnsley,26,9,11,70,44,26,87,5
913,Wycombe,23,9,14,69,48,21,78,6
913,Bolton,21,13,12,62,38,24,76,7
913,P'borough Utd,23,5,18,77,54,23,74,8
913,Portsmouth,18,18,10,71,55,16,72,9
913,Shrewsbury,19,11,16,58,50,8,68,10
913,Fleetwood Town,16,17,13,49,43,6,65,11
913,Port Vale,17,11,18,45,56,-11,62,12
913,Charlton Ath,15,14,17,66,65,1,59,13
913,Exeter City,15,12,19,65,68,-3,57,14
913,Lincoln City,12,20,14,45,57,-12,56,15
913,Bristol Rovers,14,12,20,73,86,-13,54,16
913,MK Dons,12,12,22,44,59,-15,48,17
913,Oxford United,11,14,21,48,62,-14,47,18
913,Cheltenham,13,7,26,37,66,-29,46,19
913,Burton Albion,12,9,25,54,96,-42,45,20
913,Morecambe,9,15,22,48,81,-33,42,21
913,Acc'ton Stanley,10,12,24,33,69,-36,42,22
913,Cambridge Utd,11,7,28,33,76,-43,40,23
913,FG Rovers,6,10,30,33,85,-52,28,24
914,Sheffield Weds,28,14,4,82,31,51,98,1
914,Barnsley,29,9,8,89,41,48,96,2
914,Ipswich Town,26,15,5,91,44,47,93,3
914,Plymouth Argyle,27,12,7,85,48,37,93,4
914,Derby County,27,11,8,78,37,41,92,5
914,Bolton,23,12,11,68,36,32,81,6
914,Wycombe,19,14,13,61,44,17,71,7
914,Shrewsbury,20,10,16,55,51,4,70,8
914,P'borough Utd,21,5,20,71,63,8,68,9
914,Fleetwood Town,17,14,15,55,46,9,65,10
914,Portsmouth,15,17,14,58,52,6,62,11
914,Lincoln City,13,20,13,48,52,-4,59,12
914,Charlton Ath,15,13,18,65,64,1,58,13
914,Exeter City,14,13,19,55,65,-10,55,14
914,Oxford United,14,10,22,50,58,-8,52,15
914,Port Vale,15,7,24,43,67,-24,52,16
914,Bristol Rovers,13,11,22,60,80,-20,50,17
914,Burton Albion,12,11,23,54,86,-32,47,18
914,Morecambe,10,15,21,46,69,-23,45,19
914,Cheltenham,11,12,23,38,66,-28,45,20
914,Cambridge Utd,12,9,25,39,68,-29,45,21
914,Acc'ton Stanley,10,15,21,39,68,-29,45,22
914,MK Dons,12,7,27,41,73,-32,43,23
914,FG Rovers,6,10,30,31,93,-62,28,24
915,Barnsley,31,5,10,85,37,48,98,1
915,Sheffield Weds,29,9,8,87,38,49,96,2
915,Ipswich Town,25,15,6,81,45,36,90,3
915,Plymouth Argyle,26,11,9,83,56,27,89,4
915,Wycombe,27,5,14,77,45,32,86,5
915,Bolton,24,11,11,65,37,28,83,6
915,Derby County,24,10,12,74,43,31,82,7
915,Portsmouth,20,13,13,65,54,11,73,8
915,Shrewsbury,21,9,16,56,46,10,72,9
915,P'borough Utd,21,4,21,76,71,5,67,10
915,Fleetwood Town,16,16,14,49,42,7,64,11
915,Lincoln City,15,19,12,46,46,0,64,12
915,Charlton Ath,17,11,18,74,69,5,62,13
915,Exeter City,17,10,19,62,63,-1,61,14
915,Port Vale,14,12,20,47,64,-17,54,15
915,Bristol Rovers,15,9,22,65,86,-21,54,16
915,Acc'ton Stanley,12,14,20,43,66,-23,50,17
915,Cheltenham,12,10,24,35,60,-25,46,18
915,Burton Albion,12,10,24,58,93,-35,46,19
915,Oxford United,11,11,24,44,62,-18,44,20
915,MK Dons,11,10,25,43,69,-26,43,21
915,Cambridge Utd,12,7,27,34,67,-33,43,22
915,Morecambe,9,11,26,44,78,-34,38,23
915,FG Rovers,5,10,31,31,87,-56,25,24
916,Sheffield Weds,30,13,3,85,26,59,103,1
916,Barnsley,29,6,11,81,42,39,93,2
916,Plymouth Argyle,27,10,9,83,51,32,91,3
916,Bolton,24,10,12,63,34,29,82,4
916,Wycombe,24,9,13,67,38,29,81,5
916,Ipswich Town,21,15,10,76,46,30,78,6
916,Derby County,22,12,12,69,46,23,78,7
916,P'borough Utd,24,5,17,86,59,27,77,8
916,Portsmouth,18,17,11,59,52,7,71,9
916,Exeter City,18,11,17,63,54,9,65,10
916,Charlton Ath,15,15,16,64,65,-1,60,11
916,Shrewsbury,17,9,20,50,55,-5,60,12
916,Fleetwood Town,14,17,15,47,44,3,59,13
916,Lincoln City,12,22,12,40,47,-7,58,14
916,Burton Albion,15,12,19,57,75,-18,57,15
916,Bristol Rovers,15,11,20,63,72,-9,56,16
916,Oxford United,15,11,20,54,63,-9,56,17
916,Acc'ton Stanley,13,11,22,47,77,-30,50,18
916,Port Vale,13,10,23,42,66,-24,49,19
916,Morecambe,11,14,21,45,75,-30,47,20
916,Cheltenham,11,10,25,35,67,-32,43,21
916,MK Dons,10,11,25,48,68,-20,41,22
916,Cambridge Utd,9,10,27,36,71,-35,37,23
916,FG Rovers,5,9,32,35,102,-67,24,24
917,Plymouth Argyle,27,13,6,81,44,37,94,1
917,Barnsley,28,9,9,76,37,39,93,2
917,Sheffield Weds,26,13,7,78,37,41,91,3
917,Ipswich Town,24,15,7,85,47,38,87,4
917,Derby County,23,13,10,71,43,28,82,5
917,Bolton,21,13,12,66,41,25,76,6
917,P'borough Utd,22,6,18,75,57,18,72,7
917,Wycombe,21,9,16,62,48,14,72,8
917,Shrewsbury,20,12,14,55,44,11,72,9
917,Portsmouth,18,17,11,71,52,19,71,10
917,Lincoln City,13,24,9,41,37,4,63,11
917,Charlton Ath,16,13,17,68,64,4,61,12
917,Exeter City,15,13,18,60,62,-2,58,13
917,Acc'ton Stanley,14,12,20,49,73,-24,54,14
917,Fleetwood Town,12,17,17,48,45,3,53,15
917,Oxford United,13,14,19,49,57,-8,53,16
917,Port Vale,14,11,21,53,72,-19,53,17
917,Burton Albion,12,13,21,63,81,-18,49,18
917,Cambridge Utd,14,6,26,39,79,-40,48,19
917,Bristol Rovers,12,9,25,60,95,-35,45,20
917,Cheltenham,10,13,23,31,57,-26,43,21
917,MK Dons,11,8,27,45,73,-28,41,22
917,Morecambe,9,14,23,45,76,-31,41,23
917,FG Rovers,9,9,28,39,89,-50,36,24
918,Sheffield Weds,31,10,5,85,29,56,103,1
918,Plymouth Argyle,27,10,9,83,50,33,91,2
918,Ipswich Town,24,16,6,81,42,39,88,3
918,Derby County,24,13,9,81,46,35,85,4
918,Barnsley,25,7,14,69,44,25,82,5
918,Bolton,21,13,12,61,39,22,76,6
918,Wycombe,23,7,16,60,44,16,76,7
918,Lincoln City,17,20,9,48,42,6,71,8
918,P'borough Utd,22,4,20,81,62,19,70,9
918,Shrewsbury,20,9,17,53,50,3,69,10
918,Portsmouth,17,17,12,59,50,9,68,11
918,Charlton Ath,18,13,15,65,55,10,67,12
918,Bristol Rovers,17,11,18,71,76,-5,62,13
918,Port Vale,16,11,19,48,60,-12,59,14
918,Fleetwood Town,15,13,18,52,50,2,58,15
918,Exeter City,14,13,19,57,61,-4,55,16
918,Burton Albion,15,9,22,53,75,-22,54,17
918,Oxford United,13,11,22,46,60,-14,50,18
918,Cambridge Utd,13,8,25,40,71,-31,47,19
918,Cheltenham,11,9,26,33,63,-30,42,20
918,Morecambe,9,14,23,43,75,-32,41,21
918,MK Dons,10,9,27,42,78,-36,39,22
918,Acc'ton Stanley,8,13,25,31,73,-42,37,23
918,FG Rovers,6,12,28,35,82,-47,30,24
919,Sheffield Weds,30,9,7,81,33,48,99,1
919,Plymouth Argyle,28,11,7,84,52,32,95,2
919,Derby County,26,12,8,87,42,45,90,3
919,Bolton,27,9,10,75,33,42,90,4
919,Barnsley,27,7,12,73,39,34,88,5
919,Ipswich Town,23,16,7,80,42,38,85,6
919,P'borough Utd,24,4,18,72,58,14,76,7
919,Wycombe,22,7,17,56,48,8,73,8
919,Shrewsbury,21,7,18,59,49,10,70,9
919,Portsmouth,18,15,13,68,53,15,69,10
919,Port Vale,16,11,19,46,60,-14,59,11
919,Charlton Ath,14,16,16,64,63,1,58,12
919,Lincoln City,12,22,12,39,41,-2,58,13
919,Fleetwood Town,13,16,17,43,43,0,55,14
919,Bristol Rovers,15,10,21,64,81,-17,55,15
919,MK Dons,15,8,23,47,68,-21,53,16
919,Acc'ton Stanley,13,14,19,44,68,-24,53,17
919,Cheltenham,12,12,22,34,59,-25,48,18
919,Exeter City,11,13,22,53,64,-11,46,19
919,Morecambe,10,15,21,48,72,-24,45,20
919,Oxford United,11,11,24,46,60,-14,44,21
919,Burton Albion,10,11,25,58,97,-39,41,22
919,Cambridge Utd,10,7,29,35,80,-45,37,23
919,FG Rovers,7,11,28,33,84,-51,32,24
920,Plymouth Argyle,31,10,5,88,48,40,103,1
920,Sheffield Weds,29,10,7,82,35,47,97,2
920,Ipswich Town,24,16,6,93,43,50,88,3
920,Wycombe,26,7,13,75,42,33,85,4
920,Bolton,23,10,13,68,43,25,79,5
920,Barnsley,23,9,14,67,43,24,78,6
920,Derby County,21,13,12,69,48,21,76,7
920,P'borough Utd,24,4,18,72,56,16,76,8
920,Lincoln City,16,21,9,52,45,7,69,9
920,Portsmouth,18,13,15,69,58,11,67,10
920,Shrewsbury,19,6,21,60,59,1,63,11
920,Bristol Rovers,17,10,19,68,73,-5,61,12
920,Charlton Ath,15,15,16,69,59,10,60,13
920,Fleetwood Town,14,16,16,51,51,0,58,14
920,Acc'ton Stanley,13,13,20,41,66,-25,52,15
920,Exeter City,13,12,21,53,68,-15,51,16
920,Oxford United,12,12,22,47,58,-11,48,17
920,Burton Albion,12,11,23,54,87,-33,47,18
920,Cheltenham,12,10,24,35,63,-28,46,19
920,Port Vale,12,10,24,44,75,-31,46,20
920,MK Dons,12,9,25,45,70,-25,45,21
920,Morecambe,10,13,23,46,84,-38,43,22
920,Cambridge Utd,11,9,26,35,70,-35,42,23
920,FG Rovers,11,9,26,41,80,-39,42,24
921,Sheffield Weds,31,11,4,87,30,57,104,1
921,Ipswich Town,28,12,6,93,39,54,96,2
921,Plymouth Argyle,29,9,8,85,48,37,96,3
921,Barnsley,27,6,13,71,41,30,87,4
921,Wycombe,26,7,13,70,37,33,85,5
921,Derby County,23,11,12,72,45,27,80,6
921,Bolton,23,11,12,61,37,24,80,7
921,Portsmouth,20,14,12,63,47,16,74,8
921,P'borough Utd,21,8,17,69,57,12,71,9
921,Shrewsbury,18,10,18,53,50,3,64,10
921,Charlton Ath,15,16,15,68,60,8,61,11
921,Fleetwood Town,15,15,16,52,49,3,60,12
921,Port Vale,17,9,20,50,62,-12,60,13
921,Exeter City,15,12,19,59,66,-7,57,14
921,Lincoln City,11,23,12,42,46,-4,56,15
921,Burton Albion,15,9,22,60,87,-27,54,16
921,Bristol Rovers,13,11,22,57,80,-23,50,17
921,Oxford United,11,14,21,42,60,-18,47,18
921,Morecambe,10,16,20,46,69,-23,46,19
921,Acc'ton Stanley,10,14,22,36,69,-33,44,20
921,Cheltenham,11,8,27,31,67,-36,41,21
921,Cambridge Utd,10,10,26,37,77,-40,40,22
921,MK Dons,9,8,29,37,69,-32,35,23
921,FG Rovers,8,8,30,39,88,-49,32,24
922,Sheffield Weds,32,11,3,90,30,60,107,1
922,Barnsley,30,5,11,80,39,41,95,2
922,Ipswich Town,27,13,6,85,39,46,94,3
922,Plymouth Argyle,27,12,7,85,50,35,93,4
922,Derby County,22,14,10,74,42,32,80,5
922,Wycombe,23,8,15,66,44,22,77,6
922,Bolton,21,13,12,64,35,29,76,7
922,P'borough Utd,21,9,16,76,61,15,72,8
922,Portsmouth,19,14,13,67,57,10,71,9
922,Fleetwood Town,18,16,12,55,43,12,70,10
922,Shrewsbury,19,10,17,60,60,0,67,11
922,Lincoln City,12,22,12,42,46,-4,58,12
922,Charlton Ath,14,15,17,61,62,-1,57,13
922,Oxford United,13,13,20,46,54,-8,52,14
922,Exeter City,14,10,22,57,67,-10,52,15
922,Bristol Rovers,13,13,20,59,79,-20,52,16
922,Port Vale,13,10,23,47,70,-23,49,17
922,Burton Albion,12,13,21,52,79,-27,49,18
922,Morecambe,11,13,22,43,67,-24,46,19
922,Acc'ton Stanley,10,13,23,44,80,-36,43,20
922,Cheltenham,11,9,26,35,66,-31,42,21
922,Cambridge Utd,12,6,28,38,75,-37,42,22
922,MK Dons,11,8,27,46,73,-27,41,23
922,FG Rovers,6,12,28,36,90,-54,30,24
923,Sheffield Weds,31,11,4,76,28,48,104,1
923,Plymouth Argyle,27,11,8,83,47,36,92,2
923,Ipswich Town,25,14,7,81,45,36,89,3
923,Derby County,25,12,9,75,40,35,87,4
923,Bolton,25,9,12,69,32,37,84,5
923,Barnsley,25,9,12,68,41,27,84,6
923,Portsmouth,20,15,11,70,52,18,75,7
923,Fleetwood Town,18,15,13,53,44,9,69,8
923,Wycombe,19,11,16,67,50,17,68,9
923,P'borough Utd,20,8,18,70,57,13,68,10
923,Shrewsbury,19,10,17,57,51,6,67,11
923,Lincoln City,13,22,11,46,47,-1,61,12
923,Charlton Ath,15,14,17,66,57,9,59,13
923,Port Vale,16,9,21,51,64,-13,57,14
923,Exeter City,13,12,21,53,64,-11,51,15
923,Bristol Rovers,13,12,21,63,81,-18,51,16
923,Burton Albion,13,11,22,56,90,-34,50,17
923,Cheltenham,13,10,23,37,59,-22,49,18
923,Oxford United,12,11,23,45,58,-13,47,19
923,MK Dons,12,10,24,45,68,-23,46,20
923,Morecambe,10,11,25,46,81,-35,41,21
923,Acc'ton Stanley,9,14,23,37,72,-35,41,22
923,Cambridge Utd,10,10,26,38,77,-39,40,23
923,FG Rovers,8,11,27,40,87,-47,35,24
924,Sheffield Weds,30,13,3,90,33,57,103,1
924,Ipswich Town,27,13,6,89,42,47,94,2
924,Plymouth Argyle,28,10,8,88,54,34,94,3
924,Derby County,26,10,10,82,39,43,88,4
924,Barnsley,27,7,12,75,42,33,88,5
924,Bolton,25,10,11,70,38,32,85,6
924,P'borough Utd,25,7,14,83,51,32,82,7
924,Wycombe,20,12,14,58,42,16,72,8
924,Shrewsbury,20,11,15,52,47,5,71,9
924,Charlton Ath,17,15,14,64,51,13,66,10
924,Portsmouth,16,16,14,57,54,3,64,11
924,Lincoln City,15,19,12,46,45,1,64,12
924,Exeter City,16,10,20,58,64,-6,58,13
924,Fleetwood Town,13,15,18,53,51,2,54,14
924,Bristol Rovers,14,11,21,57,76,-19,53,15
924,Port Vale,14,11,21,45,71,-26,53,16
924,Oxford United,12,11,23,44,58,-14,47,17
924,MK Dons,12,10,24,42,66,-24,46,18
924,Morecambe,9,16,21,44,68,-24,43,19
924,Cheltenham,11,9,26,34,66,-32,42,20
924,Acc'ton Stanley,9,13,24,40,78,-38,40,21
924,Burton Albion,9,12,25,48,91,-43,39,22
924,Cambridge Utd,10,8,28,37,78,-41,38,23
924,FG Rovers,7,11,28,35,86,-51,32,24
925,Sheffield Weds,28,14,4,81,29,52,98,1
925,Plymouth Argyle,29,11,6,95,48,47,98,2
925,Derby County,26,11,9,76,38,38,89,3
925,Ipswich Town,24,16,6,80,45,35,88,4
925,Bolton,23,12,11,63,37,26,81,5
925,Barnsley,24,8,14,66,43,23,80,6
925,Wycombe,22,10,14,60,43,17,76,7
925,Shrewsbury,19,12,15,61,52,9,69,8
925,Lincoln City,16,20,10,49,45,4,68,9
925,Charlton Ath,18,13,15,72,58,14,67,10
925,Portsmouth,17,15,14,56,50,6,66,11
925,P'borough Utd,19,8,19,72,63,9,65,12
925,Fleetwood Town,14,17,15,50,48,2,59,13
925,Port Vale,16,10,20,47,61,-14,58,14
925,Exeter City,13,14,19,55,65,-10,53,15
925,Oxford United,13,11,22,47,59,-12,50,16
925,Burton Albion,13,11,22,55,81,-26,50,17
925,Morecambe,11,14,21,42,67,-25,47,18
925,Bristol Rovers,13,8,25,57,88,-31,47,19
925,MK Dons,12,10,24,44,63,-19,46,20
925,Acc'ton Stanley,9,14,23,36,69,-33,41,21
925,Cambridge Utd,11,8,27,37,74,-37,41,22
925,Cheltenham,10,10,26,33,65,-32,40,23
925,FG Rovers,8,11,27,36,79,-43,35,24
926,Sheffield Weds,31,10,5,81,30,51,103,1
926,Derby County,27,9,10,78,38,40,90,2
926,Plymouth Argyle,26,12,8,87,53,34,90,3
926,Bolton,25,10,11,73,36,37,85,4
926,Ipswich Town,23,16,7,79,45,34,85,5
926,Barnsley,25,10,11,79,51,28,85,6
926,Wycombe,25,8,13,70,43,27,83,7
926,Portsmouth,19,16,11,69,48,21,73,8
926,Charlton Ath,18,14,14,76,61,15,68,9
926,P'borough Utd,21,4,21,71,64,7,67,10
926,Exeter City,18,12,16,60,55,5,66,11
926,Shrewsbury,17,9,20,56,56,0,60,12
926,Fleetwood Town,15,15,16,52,55,-3,60,13
926,Lincoln City,13,21,12,48,53,-5,60,14
926,Bristol Rovers,15,12,19,63,81,-18,57,15
926,Oxford United,14,12,20,50,58,-8,54,16
926,MK Dons,15,6,25,51,74,-23,51,17
926,Acc'ton Stanley,11,12,23,45,69,-24,45,18
926,Burton Albion,12,9,25,57,93,-36,45,19
926,Port Vale,12,8,26,46,70,-24,44,20
926,Cheltenham,12,8,26,36,67,-31,44,21
926,Cambridge Utd,10,10,26,37,75,-38,40,22
926,Morecambe,9,12,25,44,73,-29,39,23
926,FG Rovers,5,13,28,38,98,-60,28,24
927,Sheffield Weds,31,9,6,90,33,57,102,1
927,Ipswich Town,25,15,6,84,40,44,90,2
927,Bolton,27,9,10,70,34,36,90,3
927,Plymouth Argyle,25,12,9,81,51,30,87,4
927,Barnsley,25,11,10,74,42,32,86,5
927,Derby County,25,10,11,71,47,24,85,6
927,Wycombe,21,12,13,56,40,16,75,7
927,P'borough Utd,23,4,19,74,59,15,73,8
927,Shrewsbury,20,10,16,57,52,5,70,9
927,Portsmouth,17,17,12,60,49,11,68,10
927,Fleetwood Town,17,14,15,50,44,6,65,11
927,Lincoln City,12,25,9,42,42,0,61,12
927,Charlton Ath,15,13,18,64,67,-3,58,13
927,Port Vale,14,14,18,50,64,-14,56,14
927,Bristol Rovers,14,10,22,65,79,-14,52,15
927,Burton Albion,13,13,20,59,78,-19,52,16
927,Exeter City,13,12,21,53,63,-10,51,17
927,Acc'ton Stanley,11,13,22,42,73,-31,46,18
927,Oxford United,11,12,23,43,59,-16,45,19
927,MK Dons,12,9,25,47,71,-24,45,20
927,Morecambe,10,13,23,43,69,-26,43,21
927,Cambridge Utd,12,7,27,38,72,-34,43,22
927,Cheltenham,10,11,25,36,64,-28,41,23
927,FG Rovers,7,9,30,36,93,-57,30,24
928,Sheffield Weds,34,9,3,106,32,74,111,1
928,Plymouth Argyle,26,14,6,79,47,32,92,2
928,Ipswich Town,23,18,5,81,40,41,87,3
928,Barnsley,26,9,11,68,40,28,87,4
928,Wycombe,25,8,13,74,47,27,83,5
928,Derby County,23,13,10,73,42,31,82,6
928,Bolton,22,10,14,65,40,25,76,7
928,Charlton Ath,18,13,15,66,54,12,67,8
928,Lincoln City,15,22,9,49,45,4,67,9
928,Portsmouth,16,17,13,66,56,10,65,10
928,P'borough Utd,19,8,19,72,67,5,65,11
928,Shrewsbury,18,11,17,56,51,5,65,12
928,Exeter City,16,11,19,63,70,-7,59,13
928,Fleetwood Town,13,19,14,45,41,4,58,14
928,Port Vale,14,11,21,48,67,-19,53,15
928,Cheltenham,13,11,22,37,56,-19,50,16
928,MK Dons,14,8,24,48,70,-22,50,17
928,Bristol Rovers,14,8,24,67,92,-25,50,18
928,Oxford United,10,17,19,42,54,-12,47,19
928,Acc'ton Stanley,9,16,21,41,69,-28,43,20
928,Cambridge Utd,10,12,24,37,67,-30,42,21
928,Burton Albion,9,12,25,50,90,-40,39,22
928,Morecambe,8,12,26,45,87,-42,36,23
928,FG Rovers,7,11,28,32,86,-54,32,24
929,Sheffield Weds,29,10,7,87,41,46,97,1
929,Plymouth Argyle,29,10,7,87,54,33,97,2
929,Bolton,25,9,12,67,38,29,84,3
929,Wycombe,25,8,13,70,43,27,83,4
929,Ipswich Town,23,13,10,80,46,34,82,5
929,Barnsley,24,9,13,65,43,22,81,6
929,Derby County,23,11,12,76,44,32,80,7
929,P'borough Utd,25,4,17,81,59,22,79,8
929,Charlton Ath,19,13,14,70,54,16,70,9
929,Fleetwood Town,17,15,14,53,45,8,66,10
929,Shrewsbury,18,9,19,55,54,1,63,11
929,Port Vale,17,9,20,51,65,-14,60,12
929,Lincoln City,12,23,11,46,47,-1,59,13
929,Oxford United,15,11,20,48,54,-6,56,14
929,Portsmouth,13,16,17,58,59,-1,55,15
929,Bristol Rovers,15,10,21,66,80,-14,55,16
929,Exeter City,15,9,22,59,72,-13,54,17
929,Burton Albion,13,11,22,60,90,-30,50,18
929,Acc'ton Stanley,11,16,19,40,62,-22,49,19
929,Cheltenham,14,7,25,39,62,-23,49,20
929,MK Dons,13,7,26,42,71,-29,46,21
929,Cambridge Utd,10,8,28,36,74,-38,38,22
929,FG Rovers,9,10,27,41,84,-43,37,23
929,Morecambe,8,12,26,39,75,-36,36,24
930,Sheffield Weds,28,14,4,89,32,57,98,1
930,Ipswich Town,26,14,6,87,43,44,92,2
930,Plymouth Argyle,27,11,8,83,53,30,92,3
930,Bolton,24,12,10,68,35,33,84,4
930,Wycombe,25,7,14,70,44,26,82,5
930,Derby County,23,12,11,76,51,25,81,6
930,Barnsley,24,9,13,67,43,24,81,7
930,Shrewsbury,21,11,14,57,44,13,74,8
930,Portsmouth,17,17,12,59,52,7,68,9
930,P'borough Utd,20,3,23,73,68,5,63,10
930,Charlton Ath,16,14,16,65,65,0,62,11
930,Port Vale,17,11,18,48,57,-9,62,12
930,Lincoln City,14,19,13,45,49,-4,61,13
930,Fleetwood Town,13,20,13,44,40,4,59,14
930,Exeter City,15,11,20,61,67,-6,56,15
930,Bristol Rovers,14,12,20,61,73,-12,54,16
930,Acc'ton Stanley,13,12,21,44,69,-25,51,17
930,Cambridge Utd,13,9,24,39,64,-25,48,18
930,Oxford United,11,14,21,44,59,-15,47,19
930,Cheltenham,12,10,24,36,61,-25,46,20
930,Morecambe,9,15,22,43,71,-28,42,21
930,Burton Albion,11,9,26,52,89,-37,42,22
930,MK Dons,9,8,29,37,70,-33,35,23
930,FG Rovers,7,12,27,33,82,-49,33,24
931,Sheffield Weds,29,13,4,86,33,53,100,1
931,Plymouth Argyle,27,11,8,82,54,28,92,2
931,Derby County,25,12,9,72,37,35,87,3
931,Ipswich Town,23,15,8,74,41,33,84,4
931,Barnsley,24,11,11,69,42,27,83,5
931,Bolton,23,12,11,68,34,34,81,6
931,Wycombe,24,7,15,62,45,17,79,7
931,P'borough Utd,22,4,20,76,62,14,70,8
931,Shrewsbury,20,10,16,60,52,8,70,9
931,Charlton Ath,18,15,13,70,54,16,69,10
931,Portsmouth,17,16,13,59,51,8,67,11
931,Lincoln City,15,19,12,54,51,3,64,12
931,Port Vale,18,9,19,51,61,-10,63,13
931,Exeter City,16,12,18,57,60,-3,60,14
931,Fleetwood Town,13,17,16,44,48,-4,56,15
931,Burton Albion,14,11,21,58,77,-19,53,16
931,Oxford United,13,13,20,47,60,-13,52,17
931,Bristol Rovers,14,8,24,60,85,-25,50,18
931,Cheltenham,11,11,24,41,68,-27,44,19
931,MK Dons,11,10,25,46,71,-25,43,20
931,Morecambe,9,14,23,47,74,-27,41,21
931,Cambridge Utd,11,8,27,40,76,-36,41,22
931,Acc'ton Stanley,9,13,24,35,68,-33,40,23
931,FG Rovers,6,9,31,34,88,-54,27,24
932,Sheffield Weds,33,9,4,88,25,63,108,1
932,Plymouth Argyle,30,10,6,94,51,43,100,2
932,Ipswich Town,26,15,5,88,40,48,93,3
932,Barnsley,26,8,12,71,43,28,86,4
932,Wycombe,26,7,13,69,40,29,85,5
932,Derby County,23,11,12,68,45,23,80,6
932,Bolton,21,13,12,60,38,22,76,7
932,Portsmouth,20,14,12,64,48,16,74,8
932,P'borough Utd,21,9,16,76,59,17,72,9
932,Charlton Ath,18,11,17,73,65,8,65,10
932,Shrewsbury,18,10,18,52,50,2,64,11
932,Lincoln City,14,19,13,46,47,-1,61,12
932,Fleetwood Town,14,15,17,46,48,-2,57,13
932,Exeter City,14,15,17,57,60,-3,57,14
932,Port Vale,16,9,21,52,61,-9,57,15
932,Bristol Rovers,13,12,21,63,84,-21,51,16
932,MK Dons,14,8,24,45,65,-20,50,17
932,Oxford United,13,9,24,48,64,-16,48,18
932,Burton Albion,11,10,25,54,85,-31,43,19
932,Acc'ton Stanley,10,13,23,46,81,-35,43,20
932,Morecambe,10,12,24,43,76,-33,42,21
932,Cheltenham,10,11,25,31,64,-33,41,22
932,Cambridge Utd,10,9,27,32,72,-40,39,23
932,FG Rovers,7,9,30,34,89,-55,30,24
933,Sheffield Weds,28,12,6,84,31,53,96,1
933,Plymouth Argyle,28,12,6,95,50,45,96,2
933,Barnsley,28,10,8,78,35,43,94,3
933,Ipswich Town,27,12,7,90,44,46,93,4
933,Bolton,25,8,13,65,41,24,83,5
933,Derby County,22,12,12,75,48,27,78,6
933,P'borough Utd,23,7,16,75,56,19,76,7
933,Wycombe,21,9,16,60,45,15,72,8
933,Lincoln City,15,21,10,45,40,5,66,9
933,Shrewsbury,19,9,18,56,54,2,66,10
933,Fleetwood Town,16,16,14,53,43,10,64,11
933,Portsmouth,15,19,12,57,49,8,64,12
933,Charlton Ath,16,13,17,62,65,-3,61,13
933,Exeter City,14,11,21,54,65,-11,53,14
933,Bristol Rovers,14,11,21,63,82,-19,53,15
933,Port Vale,14,10,22,40,61,-21,52,16
933,Cambridge Utd,14,8,24,44,72,-28,50,17
933,Cheltenham,12,11,23,34,58,-24,47,18
933,MK Dons,12,10,24,49,71,-22,46,19
933,Burton Albion,11,13,22,59,88,-29,46,20
933,Oxford United,11,12,23,50,63,-13,45,21
933,Acc'ton Stanley,10,14,22,36,67,-31,44,22
933,Morecambe,10,11,25,48,84,-36,41,23
933,FG Rovers,6,11,29,32,92,-60,29,24
934,Sheffield Weds,33,8,5,88,30,58,107,1
934,Plymouth Argyle,28,9,9,86,56,30,93,2
934,Bolton,25,10,11,65,33,32,85,3
934,Barnsley,25,10,11,70,39,31,85,4
934,Derby County,24,12,10,78,45,33,84,5
934,Wycombe,25,8,13,67,39,28,83,6
934,Ipswich Town,22,14,10,80,47,33,80,7
934,P'borough Utd,25,5,16,70,52,18,80,8
934,Portsmouth,20,14,12,63,48,15,74,9
934,Shrewsbury,19,8,19,56,50,6,65,10
934,Charlton Ath,17,12,17,66,62,4,63,11
934,Fleetwood Town,14,17,15,59,54,5,59,12
934,Lincoln City,13,20,13,39,47,-8,59,13
934,Oxford United,14,11,21,48,59,-11,53,14
934,Exeter City,14,11,21,55,67,-12,53,15
934,Burton Albion,14,11,21,53,80,-27,53,16
934,Bristol Rovers,13,13,20,66,83,-17,52,17
934,Cheltenham,13,9,24,39,60,-21,48,18
934,Port Vale,13,9,24,48,72,-24,48,19
934,Acc'ton Stanley,10,14,22,40,76,-36,44,20
934,MK Dons,11,10,25,40,64,-24,43,21
934,Morecambe,8,16,22,42,70,-28,40,22
934,Cambridge Utd,10,9,27,40,74,-34,39,23
934,FG Rovers,6,12,28,33,84,-51,30,24
935,Sheffield Weds,32,10,4,84,32,52,106,1
935,Plymouth Argyle,29,11,6,89,53,36,98,2
935,Ipswich Town,28,13,5,91,40,51,97,3
935,Barnsley,28,7,11,72,40,32,91,4
935,Bolton,26,9,11,69,34,35,87,5
935,Derby County,24,11,11,80,44,36,83,6
935,P'borough Utd,24,7,15,81,58,23,79,7
935,Wycombe,23,7,16,62,45,17,76,8
935,Portsmouth,20,14,12,64,49,15,74,9
935,Lincoln City,15,18,13,48,49,-1,63,10
935,Shrewsbury,18,7,21,54,62,-8,61,11
935,Charlton Ath,14,14,18,64,63,1,56,12
935,Fleetwood Town,14,13,19,54,50,4,55,13
935,Exeter City,14,13,19,61,68,-7,55,14
935,MK Dons,15,8,23,51,73,-22,53,15
935,Oxford United,13,12,21,44,55,-11,51,16
935,Port Vale,14,8,24,44,72,-28,50,17
935,Acc'ton Stanley,11,15,20,40,68,-28,48,18
935,Morecambe,11,12,23,43,71,-28,45,19
935,Bristol Rovers,11,11,24,59,88,-29,44,20
935,Cheltenham,12,7,27,41,71,-30,43,21
935,Burton Albion,10,11,25,57,86,-29,41,22
935,Cambridge Utd,10,9,27,35,71,-36,39,23
935,FG Rovers,7,11,28,34,79,-45,32,24
936,Sheffield Weds,30,13,3,85,28,57,103,1
936,Plymouth Argyle,29,11,6,90,47,43,98,2
936,Ipswich Town,26,15,5,94,46,48,93,3
936,Bolton,23,13,10,62,33,29,82,4
936,Barnsley,24,10,12,69,44,25,82,5
936,Wycombe,25,6,15,66,40,26,81,6
936,Derby County,22,10,14,68,42,26,76,7
936,P'borough Utd,23,7,16,72,54,18,76,8
936,Portsmouth,19,15,12,62,51,11,72,9
936,Shrewsbury,19,12,15,59,50,9,69,10
936,Lincoln City,13,23,10,42,44,-2,62,11
936,Charlton Ath,15,16,15,66,60,6,61,12
936,Fleetwood Town,15,15,16,53,51,2,60,13
936,Bristol Rovers,15,9,22,63,86,-23,54,14
936,Acc'ton Stanley,13,14,19,41,65,-24,53,15
936,Port Vale,13,13,20,49,70,-21,52,16
936,Exeter City,12,14,20,55,72,-17,50,17
936,Oxford United,11,15,20,46,56,-10,48,18
936,Burton Albion,12,11,23,53,80,-27,47,19
936,Morecambe,9,16,21,40,68,-28,43,20
936,Cheltenham,11,9,26,29,59,-30,42,21
936,Cambridge Utd,10,10,26,36,72,-36,40,22
936,MK Dons,9,9,28,41,71,-30,36,23
936,FG Rovers,7,8,31,31,83,-52,29,24
937,Sheffield Weds,31,12,3,87,27,60,105,1
937,Plymouth Argyle,29,10,7,86,47,39,97,2
937,Ipswich Town,25,15,6,86,39,47,90,3
937,Derby County,26,11,9,83,35,48,89,4
937,Barnsley,25,10,11,71,39,32,85,5
937,Wycombe,23,10,13,70,45,25,79,6
937,Bolton,22,12,12,65,40,25,78,7
937,P'borough Utd,23,5,18,73,59,14,74,8
937,Portsmouth,19,16,11,71,55,16,73,9
937,Shrewsbury,21,7,18,55,56,-1,70,10
937,Charlton Ath,18,15,13,68,56,12,69,11
937,Fleetwood Town,15,16,15,57,49,8,61,12
937,Lincoln City,12,23,11,41,45,-4,59,13
937,Exeter City,14,14,18,60,64,-4,56,14
937,Bristol Rovers,13,11,22,64,82,-18,50,15
937,Port Vale,12,12,22,42,71,-29,48,16
937,Cambridge Utd,13,8,25,37,69,-32,47,17
937,Burton Albion,11,10,25,48,85,-37,43,18
937,Oxford United,10,12,24,43,65,-22,42,19
937,Morecambe,9,14,23,48,76,-28,41,20
937,MK Dons,10,11,25,43,75,-32,41,21
937,Cheltenham,10,9,27,34,70,-36,39,22
937,FG Rovers,9,12,25,40,83,-43,39,23
937,Acc'ton Stanley,8,13,25,36,76,-40,37,24
938,Sheffield Weds,32,9,5,88,32,56,105,1
938,Barnsley,27,11,8,77,41,36,92,2
938,Plymouth Argyle,26,10,10,82,57,25,88,3
938,Ipswich Town,24,14,8,80,46,34,86,4
938,Derby County,24,11,11,70,43,27,83,5
938,Wycombe,24,9,13,68,44,24,81,6
938,Shrewsbury,23,8,15,57,47,10,77,7
938,Bolton,22,10,14,63,41,22,76,8
938,Portsmouth,19,18,9,63,47,16,75,9
938,P'borough Utd,19,7,20,71,62,9,64,10
938,Exeter City,17,11,18,66,60,6,62,11
938,Fleetwood Town,15,16,15,51,48,3,61,12
938,Charlton Ath,15,13,18,68,65,3,58,13
938,Bristol Rovers,14,13,19,62,72,-10,55,14
938,Port Vale,14,11,21,47,65,-18,53,15
938,Lincoln City,10,21,15,41,54,-13,51,16
938,Burton Albion,13,12,21,53,78,-25,51,17
938,Morecambe,12,12,22,50,71,-21,48,18
938,Acc'ton Stanley,10,17,19,41,67,-26,47,19
938,Cheltenham,12,10,24,40,66,-26,46,20
938,Oxford United,11,12,23,47,61,-14,45,21
938,Cambridge Utd,11,9,26,42,77,-35,42,22
938,MK Dons,11,8,27,41,68,-27,41,23
938,FG Rovers,6,10,30,33,89,-56,28,24
939,Plymouth Argyle,28,11,7,81,45,36,95,1
939,Sheffield Weds,27,11,8,80,36,44,92,2
939,Ipswich Town,25,16,5,87,43,44,91,3
939,Derby County,24,13,9,78,42,36,85,4
939,Barnsley,25,8,13,67,43,24,83,5
939,Bolton,23,11,12,64,38,26,80,6
939,Portsmouth,21,16,9,70,50,20,79,7
939,Wycombe,21,10,15,65,45,20,73,8
939,P'borough Utd,23,4,19,73,57,16,73,9
939,Shrewsbury,18,12,16,55,51,4,66,10
939,Charlton Ath,17,14,15,67,59,8,65,11
939,Fleetwood Town,14,17,15,50,49,1,59,12
939,Lincoln City,13,20,13,40,46,-6,59,13
939,Bristol Rovers,16,11,19,71,78,-7,59,14
939,Exeter City,15,9,22,59,66,-7,54,15
939,Port Vale,15,8,23,53,70,-17,53,16
939,Acc'ton Stanley,12,15,19,45,70,-25,51,17
939,Burton Albion,13,11,22,57,83,-26,50,18
939,Oxford United,12,13,21,46,60,-14,49,19
939,MK Dons,11,12,23,41,67,-26,45,20
939,Morecambe,8,16,22,40,71,-31,40,21
939,Cheltenham,10,10,26,30,62,-32,40,22
939,Cambridge Utd,10,7,29,33,75,-42,37,23
939,FG Rovers,8,11,27,34,80,-46,35,24
940,Sheffield Weds,31,11,4,86,30,56,104,1
940,Plymouth Argyle,29,11,6,95,53,42,98,2
940,Ipswich Town,25,15,6,82,45,37,90,3
940,Bolton,25,10,11,81,39,42,85,4
940,Wycombe,25,9,12,69,41,28,84,5
940,Barnsley,25,8,13,70,44,26,83,6
940,Derby County,23,11,12,76,43,33,80,7
940,Portsmouth,19,14,13,66,55,11,71,8
940,P'borough Utd,22,4,20,82,59,23,70,9
940,Lincoln City,16,18,12,50,48,2,66,10
940,Charlton Ath,16,16,14,66,59,7,64,11
940,Shrewsbury,18,6,22,50,59,-9,60,12
940,Fleetwood Town,14,17,15,45,40,5,59,13
940,Burton Albion,14,14,18,53,72,-19,56,14
940,Exeter City,14,13,19,54,63,-9,55,15
940,Port Vale,15,10,21,46,63,-17,55,16
940,Oxford United,13,11,22,51,67,-16,50,17
940,Acc'ton Stanley,13,11,22,41,69,-28,50,18
940,Bristol Rovers,13,10,23,63,87,-24,49,19
940,Cambridge Utd,12,8,26,37,73,-36,44,20
940,Morecambe,9,13,24,53,84,-31,40,21
940,Cheltenham,10,10,26,32,67,-35,40,22
940,MK Dons,10,6,30,39,75,-36,36,23
940,FG Rovers,8,10,28,32,84,-52,34,24
941,Sheffield Weds,30,8,8,86,35,51,98,1
941,Plymouth Argyle,28,10,8,92,51,41,94,2
941,Derby County,26,11,9,82,41,41,89,3
941,Bolton,25,9,12,64,34,30,84,4
941,Barnsley,25,9,12,73,47,26,84,5
941,Ipswich Town,22,14,10,77,49,28,80,6
941,Wycombe,24,8,14,69,42,27,80,7
941,P'borough Utd,24,7,15,75,50,25,79,8
941,Shrewsbury,23,6,17,61,48,13,75,9
941,Portsmouth,19,15,12,68,54,14,72,10
941,Charlton Ath,19,13,14,73,58,15,70,11
941,Fleetwood Town,15,16,15,50,45,5,61,12
941,Lincoln City,13,20,13,46,47,-1,59,13
941,Exeter City,16,11,19,56,62,-6,59,14
941,Cheltenham,15,10,21,40,56,-16,55,15
941,Port Vale,12,13,21,46,66,-20,49,16
941,Burton Albion,12,11,23,53,92,-39,47,17
941,Bristol Rovers,11,13,22,58,79,-21,46,18
941,Cambridge Utd,12,9,25,38,71,-33,45,19
941,Oxford United,10,12,24,47,67,-20,42,20
941,Morecambe,10,11,25,44,75,-31,41,21
941,MK Dons,11,8,27,42,74,-32,41,22
941,Acc'ton Stanley,9,13,24,40,77,-37,40,23
941,FG Rovers,7,11,28,34,94,-60,32,24
942,Sheffield Weds,29,11,6,86,36,50,98,1
942,Plymouth Argyle,29,10,7,92,52,40,97,2
942,Derby County,25,10,11,79,43,36,85,3
942,Bolton,25,10,11,66,37,29,85,4
942,Ipswich Town,23,15,8,79,46,33,84,5
942,Barnsley,24,8,14,62,42,20,80,6
942,Wycombe,23,8,15,64,43,21,77,7
942,P'borough Utd,21,9,16,78,55,23,72,8
942,Shrewsbury,20,9,17,54,49,5,69,9
942,Portsmouth,16,19,11,62,54,8,67,10
942,Charlton Ath,16,14,16,68,63,5,62,11
942,Lincoln City,13,22,11,44,46,-2,61,12
942,Bristol Rovers,17,10,19,65,73,-8,61,13
942,Exeter City,17,9,20,59,54,5,60,14
942,Fleetwood Town,14,16,16,43,44,-1,58,15
942,Burton Albion,16,10,20,63,78,-15,58,16
942,Port Vale,13,10,23,41,63,-22,49,17
942,Morecambe,11,14,21,46,68,-22,47,18
942,Oxford United,10,15,21,45,60,-15,45,19
942,Cambridge Utd,11,11,24,38,70,-32,44,20
942,Acc'ton Stanley,11,11,24,37,72,-35,44,21
942,Cheltenham,10,10,26,34,70,-36,40,22
942,MK Dons,11,7,28,43,84,-41,40,23
942,FG Rovers,6,14,26,32,78,-46,32,24
943,Sheffield Weds,33,9,4,87,33,54,108,1
943,Plymouth Argyle,28,9,9,79,48,31,93,2
943,Derby County,27,10,9,87,41,46,91,3
943,Barnsley,26,8,12,78,40,38,86,4
943,Ipswich Town,22,19,5,80,44,36,85,5
943,Bolton,23,11,12,67,35,32,80,6
943,Wycombe,22,11,13,70,49,21,77,7
943,P'borough Utd,23,7,16,75,57,18,76,8
943,Portsmouth,21,12,13,72,55,17,75,9
943,Lincoln City,13,23,10,42,42,0,62,10
943,Charlton Ath,16,13,17,69,62,7,61,11
943,Fleetwood Town,13,21,12,46,41,5,60,12
943,Shrewsbury,16,11,19,50,56,-6,59,13
943,Bristol Rovers,16,10,20,74,80,-6,58,14
943,Port Vale,15,9,22,51,66,-15,54,15
943,Exeter City,13,13,20,60,71,-11,52,16
943,Oxford United,13,12,21,49,62,-13,51,17
943,Cambridge Utd,13,6,27,42,71,-29,45,18
943,MK Dons,12,8,26,44,74,-30,44,19
943,Burton Albion,11,11,24,53,89,-36,44,20
943,Acc'ton Stanley,11,11,24,36,75,-39,44,21
943,Cheltenham,11,10,25,32,62,-30,43,22
943,Morecambe,8,16,22,45,78,-33,40,23
943,FG Rovers,5,12,29,36,93,-57,27,24
944,Sheffield Weds,32,9,5,86,31,55,105,1
944,Plymouth Argyle,28,12,6,84,46,38,96,2
944,Wycombe,27,6,13,68,44,24,87,3
944,Derby County,24,14,8,79,38,41,86,4
944,Barnsley,25,9,12,72,39,33,84,5
944,P'borough Utd,25,5,16,81,53,28,80,6
944,Ipswich Town,22,14,10,80,53,27,80,7
944,Bolton,23,10,13,65,38,27,79,8
944,Shrewsbury,19,11,16,56,57,-1,68,9
944,Charlton Ath,17,15,14,67,53,14,66,10
944,Portsmouth,17,14,15,65,60,5,65,11
944,Exeter City,15,14,17,59,57,2,59,12
944,Fleetwood Town,13,18,15,47,46,1,57,13
944,Oxford United,15,12,19,55,62,-7,57,14
944,Lincoln City,12,20,14,42,47,-5,56,15
944,Burton Albion,12,14,20,62,80,-18,50,16
944,Bristol Rovers,13,11,22,57,82,-25,50,17
944,Cheltenham,13,9,24,37,57,-20,48,18
944,Port Vale,13,9,24,41,70,-29,48,19
944,Acc'ton Stanley,11,12,23,39,70,-31,45,20
944,Morecambe,11,11,24,44,74,-30,44,21
944,MK Dons,12,7,27,42,76,-34,43,22
944,Cambridge Utd,10,9,27,33,72,-39,39,23
944,FG Rovers,6,9,31,35,91,-56,27,24
945,Sheffield Weds,29,10,7,81,31,50,97,1
945,Barnsley,27,10,9,81,41,40,91,2
945,Ipswich Town,24,16,6,79,43,36,88,3
945,Derby County,25,13,8,71,35,36,88,4
945,Plymouth Argyle,26,10,10,87,55,32,88,5
945,Bolton,23,10,13,65,39,26,79,6
945,Wycombe,21,12,13,60,44,16,75,7
945,P'borough Utd,22,6,18,74,56,18,72,8
945,Shrewsbury,21,8,17,54,48,6,71,9
945,Portsmouth,16,19,11,61,52,9,67,10
945,Charlton Ath,17,14,15,59,55,4,65,11
945,Port Vale,19,8,19,54,61,-7,65,12
945,Fleetwood Town,15,18,13,50,41,9,63,13
945,Lincoln City,11,23,12,42,43,-1,56,14
945,Exeter City,14,14,18,56,60,-4,56,15
945,Acc'ton Stanley,11,16,19,40,63,-23,49,16
945,Bristol Rovers,12,12,22,57,79,-22,48,17
945,Cheltenham,12,12,22,35,60,-25,48,18
945,Burton Albion,12,11,23,62,91,-29,47,19
945,Oxford United,10,16,20,41,56,-15,46,20
945,Morecambe,8,16,22,43,73,-30,40,21
945,Cambridge Utd,10,7,29,38,80,-42,37,22
945,FG Rovers,7,14,25,35,79,-44,35,23
945,MK Dons,8,9,29,36,76,-40,33,24
946,Sheffield Weds,31,10,5,80,29,51,103,1
946,Plymouth Argyle,30,9,7,92,51,41,99,2
946,Barnsley,28,7,11,74,39,35,91,3
946,Derby County,23,13,10,69,40,29,82,4
946,Ipswich Town,22,15,9,82,44,38,81,5
946,Wycombe,23,10,13,65,41,24,79,6
946,Bolton,21,14,11,61,36,25,77,7
946,Portsmouth,20,17,9,72,50,22,77,8
946,P'borough Utd,23,5,18,70,54,16,74,9
946,Charlton Ath,17,15,14,69,58,11,66,10
946,Fleetwood Town,16,17,13,56,44,12,65,11
946,Exeter City,17,14,15,61,55,6,65,12
946,Shrewsbury,18,10,18,58,53,5,64,13
946,Lincoln City,13,21,12,45,44,1,60,14
946,Port Vale,16,9,21,45,62,-17,57,15
946,Bristol Rovers,14,10,22,62,77,-15,52,16
946,Oxford United,12,10,24,48,61,-13,46,17
946,MK Dons,12,9,25,42,67,-25,45,18
946,Burton Albion,11,11,24,56,93,-37,44,19
946,Cheltenham,12,7,27,31,69,-38,43,20
946,Morecambe,9,14,23,45,77,-32,41,21
946,Cambridge Utd,10,9,27,34,75,-41,39,22
946,Acc'ton Stanley,8,14,24,36,77,-41,38,23
946,FG Rovers,7,8,31,37,94,-57,29,24
947,Sheffield Weds,30,12,4,87,30,57,102,1
947,Plymouth Argyle,27,11,8,88,51,37,92,2
947,Derby County,25,12,9,79,40,39,87,3
947,Barnsley,26,8,12,75,42,33,86,4
947,Ipswich Town,24,13,9,84,48,36,85,5
947,Wycombe,25,8,13,68,42,26,83,6
947,Bolton,23,11,12,64,37,27,80,7
947,Shrewsbury,22,10,14,58,46,12,76,8
947,P'borough Utd,21,8,17,72,58,14,71,9
947,Fleetwood Town,19,13,14,53,42,11,70,10
947,Portsmouth,18,15,13,63,55,8,69,11
947,Lincoln City,14,19,13,47,48,-1,61,12
947,Charlton Ath,14,15,17,64,67,-3,57,13
947,Exeter City,14,12,20,54,61,-7,54,14
947,Bristol Rovers,14,11,21,67,87,-20,53,15
947,Port Vale,14,11,21,47,67,-20,53,16
947,Acc'ton Stanley,13,13,20,44,61,-17,52,17
947,Oxford United,12,14,20,47,62,-15,50,18
947,Cheltenham,12,9,25,33,63,-30,45,19
947,MK Dons,12,7,27,45,71,-26,43,20
947,Burton Albion,11,9,26,55,89,-34,42,21
947,Cambridge Utd,11,8,27,39,74,-35,41,22
947,Morecambe,8,15,23,40,73,-33,39,23
947,FG Rovers,5,12,29,31,90,-59,27,24
948,Sheffield Weds,32,11,3,89,27,62,107,1
948,Plymouth Argyle,27,13,6,89,53,36,94,2
948,Barnsley,28,6,12,71,44,27,90,3
948,Derby County,26,11,9,80,38,42,89,4
948,Ipswich Town,22,17,7,79,45,34,83,5
948,Bolton,23,10,13,65,36,29,79,6
948,P'borough Utd,23,7,16,79,60,19,76,7
948,Wycombe,22,9,15,62,44,18,75,8
948,Portsmouth,18,16,12,70,51,19,70,9
948,Charlton Ath,16,16,14,66,61,5,64,10
948,Shrewsbury,17,12,17,55,50,5,63,11
948,Fleetwood Town,16,15,15,49,45,4,63,12
948,Lincoln City,14,19,13,45,46,-1,61,13
948,Bristol Rovers,14,14,18,65,75,-10,56,14
948,Port Vale,14,10,22,48,69,-21,52,15
948,Exeter City,13,12,21,52,62,-10,51,16
948,Oxford United,12,13,21,48,61,-13,49,17
948,Cheltenham,13,8,25,34,57,-23,47,18
948,Morecambe,9,19,18,50,69,-19,46,19
948,Cambridge Utd,11,12,23,39,72,-33,45,20
948,Acc'ton Stanley,9,15,22,36,71,-35,42,21
948,Burton Albion,10,10,26,48,96,-48,40,22
948,MK Dons,9,9,28,39,74,-35,36,23
948,FG Rovers,7,10,29,33,85,-52,31,24
949,Sheffield Weds,29,11,6,83,31,52,98,1
949,Plymouth Argyle,29,11,6,85,52,33,98,2
949,Derby County,27,12,7,86,41,45,93,3
949,Barnsley,27,8,11,74,41,33,89,4
949,Ipswich Town,24,14,8,85,45,40,86,5
949,Bolton,23,12,11,65,36,29,81,6
949,P'borough Utd,23,7,16,76,59,17,76,7
949,Wycombe,21,10,15,62,47,15,73,8
949,Shrewsbury,20,7,19,64,56,8,67,9
949,Portsmouth,16,18,12,59,50,9,66,10
949,Charlton Ath,18,12,16,67,62,5,66,11
949,Lincoln City,15,19,12,46,42,4,64,12
949,Fleetwood Town,16,13,17,55,50,5,61,13
949,Port Vale,15,12,19,50,61,-11,57,14
949,Exeter City,14,13,19,61,64,-3,55,15
949,Bristol Rovers,14,12,20,65,82,-17,54,16
949,Acc'ton Stanley,11,14,21,36,64,-28,47,17
949,MK Dons,12,9,25,40,67,-27,45,18
949,Cheltenham,12,8,26,33,65,-32,44,19
949,Oxford United,11,10,25,50,74,-24,43,20
949,Burton Albion,10,13,23,55,87,-32,43,21
949,Cambridge Utd,11,8,27,40,75,-35,41,22
949,Morecambe,8,12,26,41,81,-40,36,23
949,FG Rovers,7,13,26,37,83,-46,34,24
950,Sheffield Weds,31,10,5,83,29,54,103,1
950,Barnsley,27,10,9,71,40,31,91,2
950,Plymouth Argyle,24,11,11,76,52,24,83,3
950,Wycombe,25,7,14,71,44,27,82,4
950,Derby County,23,12,11,79,46,33,81,5
950,Bolton,23,12,11,66,35,31,81,6
950,Ipswich Town,20,18,8,79,48,31,78,7
950,Shrewsbury,22,10,14,55,42,13,76,8
950,Portsmouth,17,18,11,59,49,10,69,9
950,P'borough Utd,20,8,18,68,59,9,68,10
950,Port Vale,16,10,20,48,63,-15,58,11
950,Fleetwood Town,14,15,17,49,44,5,57,12
950,Charlton Ath,13,18,15,61,57,4,57,13
950,Lincoln City,12,20,14,45,48,-3,56,14
950,Exeter City,14,12,20,57,61,-4,54,15
950,Cheltenham,15,9,22,40,61,-21,54,16
950,Bristol Rovers,14,11,21,58,78,-20,53,17
950,Oxford United,14,10,22,51,57,-6,52,18
950,Acc'ton Stanley,12,15,19,37,61,-24,51,19
950,Burton Albion,13,11,22,56,84,-28,50,20
950,MK Dons,13,9,24,46,71,-25,48,21
950,Morecambe,9,12,25,43,78,-35,39,22
950,Cambridge Utd,10,9,27,36,75,-39,39,23
950,FG Rovers,7,11,28,34,86,-52,32,24
951,Sheffield Weds,28,13,5,76,29,47,97,1
951,Ipswich Town,26,15,5,91,42,49,93,2
951,Derby County,27,9,10,76,39,37,90,3
951,Barnsley,26,10,10,68,40,28,88,4
951,Plymouth Argyle,25,10,11,83,54,29,85,5
951,Bolton,24,12,10,66,33,33,84,6
951,P'borough Utd,26,4,16,86,54,32,82,7
951,Portsmouth,20,14,12,64,51,13,74,8
951,Wycombe,21,10,15,56,41,15,73,9
951,Fleetwood Town,20,12,14,58,43,15,72,10
951,Shrewsbury,21,8,17,61,52,9,71,11
951,Lincoln City,15,22,9,45,42,3,67,12
951,Charlton Ath,13,16,17,60,64,-4,55,13
951,Bristol Rovers,13,12,21,60,77,-17,51,14
951,Exeter City,13,11,22,55,65,-10,50,15
951,Morecambe,11,15,20,47,70,-23,48,16
951,Burton Albion,12,12,22,53,82,-29,48,17
951,Acc'ton Stanley,12,11,23,37,72,-35,47,18
951,Port Vale,12,10,24,39,65,-26,46,19
951,Oxford United,11,12,23,48,67,-19,45,20
951,Cheltenham,11,9,26,34,69,-35,42,21
951,Cambridge Utd,11,8,27,35,72,-37,41,22
951,MK Dons,10,8,28,39,69,-30,38,23
951,FG Rovers,7,11,28,33,78,-45,32,24
952,Sheffield Weds,30,11,5,82,28,54,101,1
952,Plymouth Argyle,29,11,6,90,48,42,98,2
952,Barnsley,27,8,11,74,43,31,89,3
952,Ipswich Town,23,15,8,82,42,40,84,4
952,Derby County,24,11,11,76,42,34,83,5
952,Bolton,23,12,11,67,40,27,81,6
952,Shrewsbury,23,9,14,57,43,14,78,7
952,P'borough Utd,24,5,17,83,56,27,77,8
952,Wycombe,23,8,15,63,43,20,77,9
952,Portsmouth,18,17,11,67,54,13,71,10
952,Fleetwood Town,17,15,14,52,44,8,66,11
952,Lincoln City,13,21,12,42,43,-1,60,12
952,Exeter City,15,12,19,58,59,-1,57,13
952,Port Vale,16,7,23,51,69,-18,55,14
952,Charlton Ath,14,12,20,57,69,-12,54,15
952,Bristol Rovers,14,9,23,64,87,-23,51,16
952,Oxford United,12,13,21,50,62,-12,49,17
952,Acc'ton Stanley,12,13,21,41,70,-29,49,18
952,Cheltenham,12,11,23,34,59,-25,47,19
952,MK Dons,12,7,27,40,68,-28,43,20
952,Morecambe,10,12,24,43,76,-33,42,21
952,Cambridge Utd,11,8,27,37,72,-35,41,22
952,Burton Albion,10,9,27,45,88,-43,39,23
952,FG Rovers,7,10,29,37,87,-50,31,24
953,Sheffield Weds,27,13,6,78,34,44,94,1
953,Ipswich Town,26,14,6,82,42,40,92,2
953,Barnsley,27,11,8,74,38,36,92,3
953,Derby County,24,13,9,73,41,32,85,4
953,Plymouth Argyle,24,12,10,77,54,23,84,5
953,Portsmouth,21,14,11,71,48,23,77,6
953,Wycombe,23,8,15,61,40,21,77,7
953,Bolton,22,10,14,65,39,26,76,8
953,Shrewsbury,21,10,15,63,48,15,73,9
953,P'borough Utd,21,7,18,68,57,11,70,10
953,Charlton Ath,16,15,15,63,57,6,63,11
953,Fleetwood Town,15,15,16,50,47,3,60,12
953,Lincoln City,12,24,10,50,50,0,60,13
953,Exeter City,14,16,16,62,57,5,58,14
953,Cheltenham,15,10,21,37,53,-16,55,15
953,Burton Albion,14,10,22,59,82,-23,52,16
953,Port Vale,14,9,23,46,75,-29,51,17
953,Bristol Rovers,13,10,23,62,81,-19,49,18
953,Oxford United,11,14,21,42,58,-16,47,19
953,Acc'ton Stanley,11,14,21,37,64,-27,47,20
953,MK Dons,11,7,28,37,68,-31,40,21
953,Cambridge Utd,10,10,26,37,76,-39,40,22
953,Morecambe,8,15,23,41,76,-35,39,23
953,FG Rovers,6,11,29,31,81,-50,29,24
954,Sheffield Weds,33,10,3,93,33,60,109,1
954,Plymouth Argyle,28,12,6,84,47,37,96,2
954,Barnsley,26,9,11,69,40,29,87,3
954,Ipswich Town,24,14,8,79,41,38,86,4
954,Derby County,24,12,10,76,42,34,84,5
954,Wycombe,24,9,13,64,43,21,81,6
954,Bolton,22,11,13,65,40,25,77,7
954,P'borough Utd,22,7,17,79,58,21,73,8
954,Portsmouth,16,18,12,69,52,17,66,9
954,Shrewsbury,17,12,17,54,53,1,63,10
954,Charlton Ath,15,17,14,65,58,7,62,11
954,Lincoln City,12,23,11,47,47,0,59,12
954,Exeter City,16,11,19,62,66,-4,59,13
954,Bristol Rovers,15,12,19,70,80,-10,57,14
954,Port Vale,16,9,21,52,68,-16,57,15
954,Fleetwood Town,12,19,15,44,48,-4,55,16
954,Cheltenham,14,9,23,34,59,-25,51,17
954,Oxford United,11,13,22,45,58,-13,46,18
954,Burton Albion,12,10,24,53,83,-30,46,19
954,Morecambe,10,13,23,42,75,-33,43,20
954,MK Dons,11,9,26,38,65,-27,42,21
954,Acc'ton Stanley,9,14,23,37,74,-37,41,22
954,Cambridge Utd,10,10,26,39,76,-37,40,23
954,FG Rovers,7,9,30,34,88,-54,30,24
955,Sheffield Weds,29,12,5,79,32,47,99,1
955,Derby County,29,9,8,79,33,46,96,2
955,Plymouth Argyle,26,12,8,82,51,31,90,3
955,Barnsley,25,9,12,71,45,26,84,4
955,Ipswich Town,23,14,9,79,42,37,83,5
955,Wycombe,23,8,15,63,41,22,77,6
955,Bolton,21,12,13,62,38,24,75,7
955,Portsmouth,19,16,11,63,51,12,73,8
955,P'borough Utd,22,6,18,74,57,17,72,9
955,Exeter City,17,12,17,58,53,5,63,10
955,Lincoln City,14,21,11,43,46,-3,63,11
955,Shrewsbury,17,11,18,51,51,0,62,12
955,Charlton Ath,16,13,17,68,63,5,61,13
955,Bristol Rovers,15,11,20,61,75,-14,56,14
955,Fleetwood Town,12,18,16,43,48,-5,54,15
955,Port Vale,13,14,19,44,62,-18,53,16
955,Oxford United,12,13,21,44,56,-12,49,17
955,Cheltenham,13,9,24,37,59,-22,48,18
955,Burton Albion,12,10,24,52,91,-39,46,19
955,MK Dons,12,9,25,47,70,-23,45,20
955,Cambridge Utd,13,6,27,36,70,-34,45,21
955,Morecambe,9,17,20,48,72,-24,44,22
955,Acc'ton Stanley,9,12,25,36,71,-35,39,23
955,FG Rovers,10,8,28,38,81,-43,38,24
956,Sheffield Weds,30,10,6,82,34,48,100,1
956,Plymouth Argyle,29,11,6,90,48,42,98,2
956,Ipswich Town,25,14,7,85,40,45,89,3
956,Derby County,25,10,11,75,37,38,85,4
956,Barnsley,24,12,10,64,38,26,84,5
956,Wycombe,25,9,12,64,39,25,84,6
956,Bolton,24,10,12,70,40,30,82,7
956,P'borough Utd,21,8,17,76,56,20,71,8
956,Shrewsbury,19,8,19,56,57,-1,65,9
956,Portsmouth,15,17,14,60,53,7,62,10
956,Fleetwood Town,14,17,15,47,45,2,59,11
956,Charlton Ath,15,14,17,60,61,-1,59,12
956,Exeter City,15,13,18,58,57,1,58,13
956,Lincoln City,12,22,12,44,48,-4,58,14
956,Bristol Rovers,15,12,19,67,81,-14,57,15
956,Port Vale,15,10,21,47,63,-16,55,16
956,Morecambe,14,12,20,47,62,-15,54,17
956,Cheltenham,14,9,23,43,68,-25,51,18
956,Burton Albion,13,10,23,54,89,-35,49,19
956,MK Dons,12,9,25,46,68,-22,45,20
956,Oxford United,10,12,24,42,63,-21,42,21
956,Acc'ton Stanley,9,15,22,32,68,-36,42,22
956,Cambridge Utd,9,9,28,33,74,-41,36,23
956,FG Rovers,5,13,28,32,85,-53,28,24
957,Sheffield Weds,31,10,5,90,28,62,103,1
957,Plymouth Argyle,28,10,8,82,45,37,94,2
957,Ipswich Town,26,15,5,97,47,50,93,3
957,Wycombe,26,7,13,69,43,26,85,4
957,Barnsley,25,8,13,70,41,29,83,5
957,Derby County,23,13,10,75,44,31,82,6
957,Bolton,23,9,14,71,40,31,78,7
957,Portsmouth,19,18,9,61,44,17,75,8
957,P'borough Utd,22,6,18,75,61,14,72,9
957,Charlton Ath,17,14,15,69,62,7,65,10
957,Lincoln City,13,24,9,43,41,2,63,11
957,Shrewsbury,18,8,20,52,56,-4,62,12
957,Oxford United,17,10,19,51,54,-3,61,13
957,Port Vale,15,10,21,46,68,-22,55,14
957,Fleetwood Town,13,15,18,48,51,-3,54,15
957,Bristol Rovers,14,10,22,60,88,-28,52,16
957,Exeter City,13,12,21,55,68,-13,51,17
957,Burton Albion,14,8,24,60,86,-26,50,18
957,Cheltenham,12,9,25,32,60,-28,45,19
957,Morecambe,10,13,23,41,68,-27,43,20
957,MK Dons,11,9,26,42,67,-25,42,21
957,Cambridge Utd,10,10,26,34,72,-38,40,22
957,Acc'ton Stanley,8,15,23,36,76,-40,39,23
957,FG Rovers,8,9,29,33,82,-49,33,24
958,Sheffield Weds,29,11,6,81,32,49,98,1
958,Plymouth Argyle,28,10,8,89,52,37,94,2
958,Ipswich Town,24,16,6,83,44,39,88,3
958,Derby County,25,12,9,76,38,38,87,4
958,Barnsley,25,10,11,69,37,32,85,5
958,Bolton,25,9,12,67,36,31,84,6
958,Wycombe,24,8,14,70,41,29,80,7
958,Portsmouth,19,15,12,65,55,10,72,8
958,Shrewsbury,19,11,16,57,49,8,68,9
958,P'borough Utd,20,6,20,74,68,6,66,10
958,Fleetwood Town,15,16,15,47,43,4,61,11
958,Charlton Ath,15,15,16,63,62,1,60,12
958,Exeter City,15,14,17,57,60,-3,59,13
958,Bristol Rovers,15,13,18,68,83,-15,58,14
958,Lincoln City,10,24,12,42,51,-9,54,15
958,Port Vale,14,10,22,48,70,-22,52,16
958,Cheltenham,14,10,22,37,60,-23,52,17
958,Oxford United,12,13,21,45,56,-11,49,18
958,Cambridge Utd,14,6,26,37,72,-35,48,19
958,Burton Albion,12,11,23,58,85,-27,47,20
958,MK Dons,11,11,24,46,68,-22,44,21
958,Morecambe,9,15,22,44,71,-27,42,22
958,Acc'ton Stanley,8,12,26,37,72,-35,36,23
958,FG Rovers,6,10,30,32,87,-55,28,24
959,Sheffield Weds,30,12,4,85,30,55,102,1
959,Barnsley,29,6,11,83,41,42,93,2
959,Plymouth Argyle,28,9,9,82,46,36,93,3
959,Ipswich Town,24,16,6,85,43,42,88,4
959,Derby County,25,11,10,76,42,34,86,5
959,P'borough Utd,26,6,14,85,55,30,84,6
959,Wycombe,23,7,16,67,48,19,76,7
959,Bolton,20,14,12,58,34,24,74,8
959,Portsmouth,20,13,13,70,58,12,73,9
959,Lincoln City,14,22,10,49,47,2,64,10
959,Fleetwood Town,16,15,15,51,47,4,63,11
959,Shrewsbury,17,10,19,47,52,-5,61,12
959,Charlton Ath,15,13,18,62,59,3,58,13
959,Exeter City,16,10,20,58,62,-4,58,14
959,Port Vale,16,10,20,50,61,-11,58,15
959,Bristol Rovers,14,13,19,63,78,-15,55,16
959,Oxford United,11,14,21,47,57,-10,47,17
959,Cambridge Utd,13,7,26,39,73,-34,46,18
959,Morecambe,11,12,23,50,75,-25,45,19
959,Burton Albion,12,9,25,55,94,-39,45,20
959,Cheltenham,11,11,24,37,64,-27,44,21
959,Acc'ton Stanley,10,12,24,33,75,-42,42,22
959,MK Dons,11,7,28,39,71,-32,40,23
959,FG Rovers,6,9,31,30,89,-59,27,24
960,Plymouth Argyle,32,9,5,92,43,49,105,1
960,Sheffield Weds,28,11,7,83,35,48,95,2
960,Barnsley,29,8,9,82,35,47,95,3
960,Ipswich Town,26,14,6,97,43,54,92,4
960,Derby County,23,14,9,73,38,35,83,5
960,Wycombe,25,8,13,64,38,26,83,6
960,P'borough Utd,23,7,16,77,54,23,76,7
960,Bolton,22,9,15,67,45,22,75,8
960,Fleetwood Town,19,14,13,55,42,13,71,9
960,Portsmouth,18,16,12,64,53,11,70,10
960,Shrewsbury,18,10,18,54,52,2,64,11
960,Charlton Ath,15,13,18,59,62,-3,58,12
960,Port Vale,15,13,18,55,69,-14,58,13
960,Lincoln City,12,20,14,42,49,-7,56,14
960,Exeter City,14,11,21,57,67,-10,53,15
960,Oxford United,13,12,21,48,60,-12,51,16
960,Bristol Rovers,13,11,22,59,89,-30,50,17
960,Cheltenham,12,11,23,36,64,-28,47,18
960,Acc'ton Stanley,11,12,23,35,69,-34,45,19
960,Morecambe,9,14,23,47,75,-28,41,20
960,Burton Albion,10,11,25,54,98,-44,41,21
960,Cambridge Utd,11,7,28,35,71,-36,40,22
960,MK Dons,10,9,27,42,72,-30,39,23
960,FG Rovers,7,10,29,35,89,-54,31,24
961,Plymouth Argyle,31,9,6,92,46,46,102,1
961,Sheffield Weds,30,10,6,88,31,57,100,2
961,Derby County,27,11,8,78,36,42,92,3
961,Ipswich Town,24,17,5,85,41,44,89,4
961,Barnsley,25,11,10,76,44,32,86,5
961,Bolton,25,10,11,70,35,35,85,6
961,Wycombe,25,8,13,71,39,32,83,7
961,P'borough Utd,23,9,14,81,50,31,78,8
961,Portsmouth,19,13,14,61,51,10,70,9
961,Shrewsbury,18,9,19,57,55,2,63,10
961,Fleetwood Town,14,16,16,49,51,-2,58,11
961,Exeter City,15,13,18,59,65,-6,58,12
961,Lincoln City,13,18,15,45,52,-7,57,13
961,Cheltenham,16,9,21,36,52,-16,57,14
961,Charlton Ath,13,16,17,61,65,-4,55,15
961,Bristol Rovers,14,9,23,61,87,-26,51,16
961,Port Vale,13,11,22,48,71,-23,50,17
961,Oxford United,11,14,21,47,58,-11,47,18
961,Acc'ton Stanley,10,15,21,37,67,-30,45,19
961,Morecambe,10,12,24,43,76,-33,42,20
961,MK Dons,10,11,25,39,67,-28,41,21
961,Burton Albion,10,11,25,53,97,-44,41,22
961,Cambridge Utd,9,8,29,31,78,-47,35,23
961,FG Rovers,7,10,29,36,90,-54,31,24
962,Sheffield Weds,34,9,3,92,28,64,111,1
962,Plymouth Argyle,27,11,8,85,52,33,92,2
962,Derby County,25,11,10,78,42,36,86,3
962,Ipswich Town,23,15,8,80,43,37,84,4
962,Bolton,22,13,11,61,35,26,79,5
962,Barnsley,22,11,13,67,52,15,77,6
962,Portsmouth,20,16,10,65,47,18,76,7
962,Wycombe,21,8,17,59,50,9,71,8
962,P'borough Utd,20,7,19,71,63,8,67,9
962,Charlton Ath,18,13,15,67,59,8,67,10
962,Exeter City,17,14,15,66,55,11,65,11
962,Shrewsbury,18,10,18,53,51,2,64,12
962,Fleetwood Town,15,18,13,48,41,7,63,13
962,Lincoln City,14,20,12,46,48,-2,62,14
962,Bristol Rovers,15,13,18,67,75,-8,58,15
962,Burton Albion,14,10,22,60,77,-17,52,16
962,Oxford United,12,13,21,52,59,-7,49,17
962,Acc'ton Stanley,12,13,21,42,69,-27,49,18
962,Cambridge Utd,13,8,25,38,71,-33,47,19
962,Port Vale,12,10,24,44,72,-28,46,20
962,Morecambe,11,12,23,49,73,-24,45,21
962,Cheltenham,9,13,24,31,60,-29,40,22
962,MK Dons,10,7,29,37,75,-38,37,23
962,FG Rovers,6,9,31,33,94,-61,27,24
963,Sheffield Weds,29,13,4,78,32,46,100,1
963,Ipswich Town,27,14,5,85,41,44,95,2
963,Barnsley,29,8,9,78,41,37,95,3
963,Plymouth Argyle,27,10,9,80,52,28,91,4
963,Derby County,22,14,10,73,44,29,80,5
963,Bolton,22,12,12,64,33,31,78,6
963,Wycombe,22,6,18,59,48,11,72,7
963,Portsmouth,17,15,14,63,55,8,66,8
963,Shrewsbury,19,9,18,56,55,1,66,9
963,P'borough Utd,19,8,19,72,66,6,65,10
963,Charlton Ath,17,11,18,67,61,6,62,11
963,Port Vale,17,8,21,47,62,-15,59,12
963,Exeter City,15,13,18,59,58,1,58,13
963,Bristol Rovers,16,10,20,65,81,-16,58,14
963,Fleetwood Town,13,17,16,48,50,-2,56,15
963,Lincoln City,11,23,12,41,44,-3,56,16
963,Burton Albion,14,10,22,58,83,-25,52,17
963,Oxford United,12,15,19,49,56,-7,51,18
963,MK Dons,14,8,24,50,66,-16,50,19
963,Cheltenham,11,10,25,33,61,-28,43,20
963,Acc'ton Stanley,9,15,22,37,69,-32,42,21
963,Morecambe,10,11,25,43,77,-34,41,22
963,Cambridge Utd,10,10,26,42,74,-32,40,23
963,FG Rovers,8,14,24,40,78,-38,38,24
964,Sheffield Weds,29,12,5,83,36,47,99,1
964,Plymouth Argyle,27,11,8,80,49,31,92,2
964,Barnsley,28,7,11,72,40,32,91,3
964,Ipswich Town,24,16,6,82,40,42,88,4
964,Derby County,22,16,8,73,42,31,82,5
964,Wycombe,22,11,13,69,46,23,77,6
964,P'borough Utd,23,8,15,76,54,22,77,7
964,Bolton,22,10,14,60,43,17,76,8
964,Portsmouth,18,16,12,69,51,18,70,9
964,Fleetwood Town,18,14,14,54,44,10,68,10
964,Charlton Ath,17,14,15,72,68,4,65,11
964,Shrewsbury,18,9,19,53,58,-5,63,12
964,Exeter City,17,11,18,65,62,3,62,13
964,Lincoln City,14,20,12,44,44,0,62,14
964,Oxford United,14,13,19,51,56,-5,55,15
964,Bristol Rovers,14,11,21,68,80,-12,53,16
964,Port Vale,14,8,24,45,74,-29,50,17
964,Cheltenham,13,8,25,33,60,-27,47,18
964,MK Dons,11,10,25,46,68,-22,43,19
964,Acc'ton Stanley,10,13,23,41,74,-33,43,20
964,Cambridge Utd,12,7,27,42,77,-35,43,21
964,Morecambe,9,14,23,49,76,-27,41,22
964,Burton Albion,10,10,26,53,84,-31,40,23
964,FG Rovers,6,11,29,33,87,-54,29,24
965,Sheffield Weds,32,10,4,91,31,60,106,1
965,Plymouth Argyle,29,11,6,90,48,42,98,2
965,Ipswich Town,25,15,6,85,45,40,90,3
965,Bolton,26,10,10,73,31,42,88,4
965,Wycombe,27,5,14,71,42,29,86,5
965,Barnsley,24,8,14,61,41,20,80,6
965,P'borough Utd,21,9,16,78,60,18,72,7
965,Derby County,19,14,13,62,45,17,71,8
965,Shrewsbury,21,8,17,54,51,3,71,9
965,Portsmouth,18,15,13,62,48,14,69,10
965,Fleetwood Town,18,12,16,55,49,6,66,11
965,Exeter City,17,11,18,66,61,5,62,12
965,Charlton Ath,15,13,18,67,64,3,58,13
965,Lincoln City,11,21,14,38,48,-10,54,14
965,Port Vale,14,9,23,50,70,-20,51,15
965,Bristol Rovers,14,9,23,63,86,-23,51,16
965,Burton Albion,13,10,23,58,87,-29,49,17
965,Morecambe,11,13,22,46,70,-24,46,18
965,MK Dons,12,9,25,41,68,-27,45,19
965,Cheltenham,12,9,25,36,69,-33,45,20
965,Oxford United,10,14,22,43,58,-15,44,21
965,Acc'ton Stanley,11,11,24,39,74,-35,44,22
965,Cambridge Utd,12,6,28,41,76,-35,42,23
965,FG Rovers,8,12,26,31,79,-48,36,24
966,Sheffield Weds,30,11,5,89,34,55,101,1
966,Ipswich Town,29,12,5,92,43,49,99,2
966,Plymouth Argyle,28,9,9,89,48,41,93,3
966,Barnsley,27,8,11,68,38,30,89,4
966,Derby County,23,12,11,72,46,26,81,5
966,Bolton,22,14,10,75,41,34,80,6
966,P'borough Utd,23,6,17,79,55,24,75,7
966,Portsmouth,18,16,12,65,56,9,70,8
966,Shrewsbury,19,10,17,57,53,4,67,9
966,Wycombe,19,9,18,60,52,8,66,10
966,Lincoln City,15,20,11,46,44,2,65,11
966,Fleetwood Town,16,15,15,50,45,5,63,12
966,Charlton Ath,17,12,17,63,60,3,63,13
966,Exeter City,16,11,19,66,65,1,59,14
966,Bristol Rovers,14,14,18,67,80,-13,56,15
966,Port Vale,13,10,23,41,63,-22,49,16
966,Burton Albion,12,13,21,55,84,-29,49,17
966,Cheltenham,13,8,25,35,60,-25,47,18
966,Acc'ton Stanley,11,14,21,40,69,-29,47,19
966,Oxford United,10,15,21,44,62,-18,45,20
966,MK Dons,11,10,25,42,65,-23,43,21
966,Morecambe,10,13,23,45,84,-39,43,22
966,Cambridge Utd,10,6,30,34,80,-46,36,23
966,FG Rovers,7,10,29,37,84,-47,31,24
967,Sheffield Weds,31,9,6,85,31,54,102,1
967,Plymouth Argyle,29,12,5,94,52,42,99,2
967,Wycombe,27,8,11,77,40,37,89,3
967,Barnsley,26,11,9,72,36,36,89,4
967,Ipswich Town,23,16,7,81,46,35,85,5
967,Derby County,23,12,11,72,43,29,81,6
967,Bolton,23,11,12,66,40,26,80,7
967,P'borough Utd,24,7,15,76,48,28,79,8
967,Portsmouth,17,15,14,60,50,10,66,9
967,Fleetwood Town,16,17,13,49,42,7,65,10
967,Shrewsbury,19,8,19,54,52,2,65,11
967,Charlton Ath,14,18,14,66,60,6,60,12
967,Lincoln City,13,20,13,43,46,-3,59,13
967,Exeter City,15,13,18,56,60,-4,58,14
967,Bristol Rovers,14,11,21,57,72,-15,53,15
967,Port Vale,14,9,23,40,63,-23,51,16
967,Oxford United,12,13,21,43,56,-13,49,17
967,Acc'ton Stanley,10,16,20,43,69,-26,46,18
967,MK Dons,12,9,25,46,66,-20,45,19
967,Burton Albion,11,10,25,55,95,-40,43,20
967,Cambridge Utd,10,9,27,36,75,-39,39,21
967,Cheltenham,10,9,27,31,74,-43,39,22
967,Morecambe,8,13,25,40,76,-36,37,23
967,FG Rovers,8,10,28,38,88,-50,34,24
968,Sheffield Weds,32,11,3,87,28,59,107,1
968,Ipswich Town,27,14,5,86,39,47,95,2
968,Plymouth Argyle,25,12,9,85,48,37,87,3
968,Barnsley,26,8,12,70,44,26,86,4
968,Derby County,24,11,11,73,40,33,83,5
968,Bolton,23,11,12,69,37,32,80,6
968,Wycombe,24,7,15,64,43,21,79,7
968,Shrewsbury,21,9,16,56,50,6,72,8
968,Charlton Ath,18,14,14,64,56,8,68,9
968,Portsmouth,17,15,14,56,52,4,66,10
968,P'borough Utd,20,5,21,70,67,3,65,11
968,Fleetwood Town,16,15,15,53,49,4,63,12
968,Lincoln City,13,21,12,48,49,-1,60,13
968,Exeter City,16,11,19,68,69,-1,59,14
968,Port Vale,17,7,22,54,70,-16,58,15
968,Bristol Rovers,13,10,23,62,78,-16,49,16
968,Burton Albion,13,10,23,53,82,-29,49,17
968,Cheltenham,13,9,24,37,64,-27,48,18
968,Acc'ton Stanley,11,14,21,37,66,-29,47,19
968,Oxford United,10,14,22,47,65,-18,44,20
968,Morecambe,11,11,24,44,75,-31,44,21
968,MK Dons,11,8,27,41,69,-28,41,22
968,Cambridge Utd,10,9,27,35,68,-33,39,23
968,FG Rovers,9,8,29,39,90,-51,35,24
969,Plymouth Argyle,31,8,7,105,48,57,101,1
969,Sheffield Weds,28,13,5,76,33,43,97,2
969,Barnsley,28,9,9,77,37,40,93,3
969,Derby County,26,11,9,76,39,37,89,4
969,Ipswich Town,23,16,7,84,46,38,85,5
969,Bolton,23,10,13,66,44,22,79,6
969,P'borough Utd,22,5,19,77,61,16,71,7
969,Portsmouth,17,19,10,67,53,14,70,8
969,Wycombe,19,12,15,61,42,19,69,9
969,Exeter City,18,13,15,68,58,10,67,10
969,Charlton Ath,17,12,17,73,63,10,63,11
969,Shrewsbury,18,8,20,60,60,0,62,12
969,Fleetwood Town,14,17,15,54,48,6,59,13
969,Bristol Rovers,15,12,19,66,78,-12,57,14
969,Oxford United,15,10,21,56,60,-4,55,15
969,Port Vale,15,9,22,47,65,-18,54,16
969,Burton Albion,12,13,21,54,75,-21,49,17
969,Cheltenham,12,11,23,35,64,-29,47,18
969,Morecambe,12,11,23,48,82,-34,47,19
969,Acc'ton Stanley,11,14,21,39,73,-34,47,20
969,Lincoln City,8,21,17,35,57,-22,45,21
969,MK Dons,9,12,25,37,67,-30,39,22
969,Cambridge Utd,10,8,28,38,86,-48,38,23
969,FG Rovers,7,10,29,32,92,-60,31,24
970,Plymouth Argyle,30,10,6,89,47,42,100,1
970,Sheffield Weds,28,11,7,77,33,44,95,2
970,Ipswich Town,24,16,6,81,38,43,88,3
970,Derby County,26,10,10,82,41,41,88,4
970,Barnsley,26,9,11,73,41,32,87,5
970,Bolton,24,11,11,64,35,29,83,6
970,Wycombe,24,7,15,69,43,26,79,7
970,P'borough Utd,22,7,17,75,59,16,73,8
970,Portsmouth,19,14,13,66,59,7,71,9
970,Shrewsbury,20,8,18,55,50,5,68,10
970,Fleetwood Town,16,16,14,47,49,-2,64,11
970,Charlton Ath,16,13,17,68,60,8,61,12
970,Exeter City,16,12,18,58,51,7,60,13
970,Lincoln City,14,18,14,48,57,-9,60,14
970,Port Vale,17,7,22,48,65,-17,58,15
970,Bristol Rovers,16,9,21,67,83,-16,57,16
970,Burton Albion,14,11,21,58,79,-21,53,17
970,Oxford United,12,12,22,44,55,-11,48,18
970,Acc'ton Stanley,10,14,22,39,71,-32,44,19
970,MK Dons,10,13,23,47,72,-25,43,20
970,Cheltenham,11,8,27,34,67,-33,41,21
970,Morecambe,8,15,23,42,75,-33,39,22
970,Cambridge Utd,9,10,27,33,76,-43,37,23
970,FG Rovers,5,9,32,28,86,-58,24,24
971,Sheffield Weds,32,10,4,87,32,55,106,1
971,Plymouth Argyle,28,10,8,84,49,35,94,2
971,Ipswich Town,25,16,5,87,41,46,91,3
971,Derby County,26,11,9,76,39,37,89,4
971,Barnsley,25,10,11,73,49,24,85,5
971,Wycombe,25,7,14,72,44,28,82,6
971,Bolton,23,12,11,64,34,30,81,7
971,P'borough Utd,25,4,17,85,64,21,79,8
971,Charlton Ath,18,14,14,72,58,14,68,9
971,Portsmouth,16,18,12,61,52,9,66,10
971,Shrewsbury,17,8,21,51,61,-10,59,11
971,Port Vale,17,8,21,48,60,-12,59,12
971,Fleetwood Town,13,19,14,44,42,2,58,13
971,Oxford United,15,10,21,60,59,1,55,14
971,Exeter City,14,11,21,52,62,-10,53,15
971,Lincoln City,10,23,13,37,48,-11,53,16
971,Cheltenham,14,9,23,34,58,-24,51,17
971,Bristol Rovers,12,13,21,61,82,-21,49,18
971,Acc'ton Stanley,9,18,19,39,65,-26,45,19
971,MK Dons,11,9,26,50,74,-24,42,20
971,Morecambe,9,14,23,45,76,-31,41,21
971,Burton Albion,9,11,26,47,90,-43,38,22
971,Cambridge Utd,9,10,27,34,73,-39,37,23
971,FG Rovers,6,13,27,32,83,-51,31,24
972,Sheffield Weds,28,12,6,78,34,44,96,1
972,Plymouth Argyle,28,10,8,88,51,37,94,2
972,Barnsley,29,7,10,75,41,34,94,3
972,Ipswich Town,25,15,6,84,47,37,90,4
972,Derby County,26,11,9,77,41,36,89,5
972,Wycombe,24,9,13,70,41,29,81,6
972,Bolton,22,12,12,68,40,28,78,7
972,Portsmouth,18,15,13,65,56,9,69,8
972,P'borough Utd,19,8,19,75,68,7,65,9
972,Shrewsbury,19,7,20,53,52,1,64,10
972,Lincoln City,13,23,10,47,43,4,62,11
972,Charlton Ath,16,12,18,61,59,2,60,12
972,Bristol Rovers,16,10,20,65,74,-9,58,13
972,Port Vale,15,11,20,52,65,-13,56,14
972,Fleetwood Town,13,16,17,45,49,-4,55,15
972,Burton Albion,14,12,20,58,80,-22,54,16
972,Exeter City,12,16,18,59,65,-6,52,17
972,Oxford United,12,15,19,47,54,-7,51,18
972,Morecambe,10,15,21,45,66,-21,45,19
972,Cambridge Utd,11,11,24,41,74,-33,44,20
972,Cheltenham,11,9,26,31,66,-35,42,21
972,Acc'ton Stanley,9,13,24,38,77,-39,40,22
972,MK Dons,10,9,27,40,75,-35,39,23
972,FG Rovers,7,12,27,36,80,-44,33,24
973,Sheffield Weds,29,13,4,79,28,51,100,1
973,Plymouth Argyle,29,11,6,86,46,40,98,2
973,Bolton,26,10,10,70,33,37,88,3
973,Barnsley,24,11,11,62,39,23,83,4
973,Ipswich Town,21,16,9,79,48,31,79,5
973,Derby County,22,12,12,69,44,25,78,6
973,P'borough Utd,24,4,18,80,57,23,76,7
973,Wycombe,22,10,14,59,42,17,76,8
973,Portsmouth,21,13,12,66,50,16,76,9
973,Charlton Ath,19,12,15,69,56,13,69,10
973,Shrewsbury,18,10,18,57,54,3,64,11
973,Fleetwood Town,16,15,15,54,46,8,63,12
973,Bristol Rovers,15,10,21,58,76,-18,55,13
973,Port Vale,14,12,20,51,62,-11,54,14
973,Lincoln City,10,22,14,42,54,-12,52,15
973,Exeter City,12,14,20,52,58,-6,50,16
973,Morecambe,13,11,22,47,69,-22,50,17
973,Burton Albion,12,13,21,60,80,-20,49,18
973,Acc'ton Stanley,12,13,21,35,67,-32,49,19
973,Cheltenham,12,11,23,38,70,-32,47,20
973,Oxford United,10,13,23,43,61,-18,43,21
973,FG Rovers,10,12,24,42,79,-37,42,22
973,MK Dons,10,8,28,41,74,-33,38,23
973,Cambridge Utd,9,8,29,33,79,-46,35,24
974,Sheffield Weds,29,11,6,80,33,47,98,1
974,Ipswich Town,26,16,4,95,42,53,94,2
974,Plymouth Argyle,26,11,9,90,54,36,89,3
974,Derby County,25,12,9,84,45,39,87,4
974,Barnsley,25,7,14,70,44,26,82,5
974,Bolton,23,12,11,69,41,28,81,6
974,P'borough Utd,22,8,16,79,58,21,74,7
974,Portsmouth,19,16,11,64,47,17,73,8
974,Wycombe,22,7,17,57,44,13,73,9
974,Fleetwood Town,17,17,12,49,41,8,68,10
974,Charlton Ath,16,16,14,68,65,3,64,11
974,Shrewsbury,16,13,17,53,54,-1,61,12
974,Lincoln City,12,21,13,44,49,-5,57,13
974,Port Vale,16,8,22,49,63,-14,56,14
974,Exeter City,13,14,19,59,61,-2,53,15
974,Bristol Rovers,13,12,21,64,88,-24,51,16
974,Morecambe,12,13,21,46,68,-22,49,17
974,Oxford United,12,12,22,44,59,-15,48,18
974,Acc'ton Stanley,12,12,22,36,62,-26,48,19
974,Cheltenham,12,11,23,33,62,-29,47,20
974,Burton Albion,12,11,23,57,88,-31,47,21
974,MK Dons,11,12,23,42,64,-22,45,22
974,Cambridge Utd,9,7,30,34,82,-48,34,23
974,FG Rovers,7,11,28,35,87,-52,32,24
975,Sheffield Weds,29,11,6,78,30,48,98,1
975,Plymouth Argyle,30,8,8,88,47,41,98,2
975,Barnsley,28,8,10,80,39,41,92,3
975,Derby County,25,13,8,75,37,38,88,4
975,Ipswich Town,24,14,8,90,49,41,86,5
975,Bolton,24,12,10,64,32,32,84,6
975,Wycombe,26,6,14,68,44,24,84,7
975,P'borough Utd,23,6,17,79,59,20,75,8
975,Portsmouth,19,16,11,63,46,17,73,9
975,Shrewsbury,19,11,16,56,48,8,68,10
975,Charlton Ath,17,15,14,68,54,14,66,11
975,Fleetwood Town,15,16,15,49,47,2,61,12
975,Lincoln City,11,24,11,40,47,-7,57,13
975,Exeter City,13,13,20,60,64,-4,52,14
975,Bristol Rovers,14,10,22,61,84,-23,52,15
975,Cheltenham,13,12,21,35,63,-28,51,16
975,Port Vale,13,10,23,48,69,-21,49,17
975,Acc'ton Stanley,11,12,23,43,76,-33,45,18
975,Morecambe,11,12,23,43,77,-34,45,19
975,Burton Albion,11,11,24,52,85,-33,44,20
975,Cambridge Utd,12,6,28,38,75,-37,42,21
975,Oxford United,9,14,23,42,61,-19,41,22
975,MK Dons,11,8,27,41,68,-27,41,23
975,FG Rovers,5,10,31,29,89,-60,25,24
976,Sheffield Weds,30,12,4,86,30,56,102,1
976,Plymouth Argyle,27,9,10,88,57,31,90,2
976,Ipswich Town,22,18,6,79,42,37,84,3
976,Wycombe,25,8,13,73,44,29,83,4
976,Bolton,24,10,12,64,36,28,82,5
976,Barnsley,23,10,13,68,50,18,79,6
976,Derby County,22,12,12,71,44,27,78,7
976,P'borough Utd,23,7,16,78,53,25,76,8
976,Portsmouth,18,17,11,67,55,12,71,9
976,Charlton Ath,19,13,14,70,53,17,70,10
976,Fleetwood Town,19,12,15,54,42,12,69,11
976,Shrewsbury,18,13,15,56,50,6,67,12
976,Port Vale,17,11,18,51,60,-9,62,13
976,Lincoln City,11,22,13,39,54,-15,55,14
976,Bristol Rovers,15,9,22,59,75,-16,54,15
976,Exeter City,13,14,19,66,70,-4,53,16
976,Oxford United,12,16,18,49,57,-8,52,17
976,MK Dons,13,9,24,44,64,-20,48,18
976,Burton Albion,12,10,24,57,88,-31,46,19
976,Cheltenham,11,8,27,29,66,-37,41,20
976,Morecambe,9,13,24,47,75,-28,40,21
976,Acc'ton Stanley,9,12,25,42,79,-37,39,22
976,Cambridge Utd,10,7,29,34,82,-48,37,23
976,FG Rovers,8,12,26,33,78,-45,36,24
977,Sheffield Weds,31,9,6,83,33,50,102,1
977,Derby County,27,11,8,75,33,42,92,2
977,Plymouth Argyle,27,11,8,87,47,40,92,3
977,Ipswich Town,24,15,7,84,44,40,87,4
977,Barnsley,26,6,14,70,37,33,84,5
977,Bolton,22,13,11,65,39,26,79,6
977,Wycombe,22,12,12,58,38,20,78,7
977,Portsmouth,18,16,12,62,53,9,70,8
977,P'borough Utd,20,9,17,76,58,18,69,9
977,Charlton Ath,18,14,14,71,58,13,68,10
977,Shrewsbury,19,11,16,53,47,6,68,11
977,Lincoln City,12,24,10,46,49,-3,60,12
977,Fleetwood Town,13,16,17,44,42,2,55,13
977,Oxford United,13,13,20,49,57,-8,52,14
977,Bristol Rovers,14,10,22,59,78,-19,52,15
977,Port Vale,14,10,22,45,68,-23,52,16
977,Exeter City,12,14,20,53,68,-15,50,17
977,MK Dons,13,9,24,45,66,-21,48,18
977,Cambridge Utd,12,9,25,39,76,-37,45,19
977,Acc'ton Stanley,9,16,21,42,77,-35,43,20
977,Morecambe,10,12,24,42,71,-29,42,21
977,Burton Albion,10,12,24,50,87,-37,42,22
977,Cheltenham,9,14,23,29,57,-28,41,23
977,FG Rovers,9,10,27,36,80,-44,37,24
978,Sheffield Weds,30,10,6,88,33,55,100,1
978,Plymouth Argyle,29,9,8,87,50,37,96,2
978,Barnsley,28,7,11,74,39,35,91,3
978,Ipswich Town,25,14,7,81,39,42,89,4
978,Bolton,24,12,10,68,35,33,84,5
978,Wycombe,25,7,14,73,41,32,82,6
978,Derby County,23,13,10,72,40,32,82,7
978,Portsmouth,21,13,12,61,49,12,76,8
978,P'borough Utd,22,7,17,80,57,23,73,9
978,Shrewsbury,18,13,15,56,53,3,67,10
978,Charlton Ath,16,16,14,67,55,12,64,11
978,Fleetwood Town,16,14,16,53,50,3,62,12
978,Lincoln City,12,23,11,40,43,-3,59,13
978,Port Vale,14,12,20,47,67,-20,54,14
978,Exeter City,14,11,21,53,66,-13,53,15
978,Bristol Rovers,13,13,20,59,77,-18,52,16
978,Oxford United,12,14,20,48,58,-10,50,17
978,MK Dons,12,9,25,46,69,-23,45,18
978,Morecambe,10,13,23,40,72,-32,43,19
978,Cheltenham,10,10,26,32,64,-32,40,20
978,Cambridge Utd,10,10,26,38,76,-38,40,21
978,Burton Albion,9,12,25,49,88,-39,39,22
978,Acc'ton Stanley,8,13,25,38,79,-41,37,23
978,FG Rovers,8,11,27,35,85,-50,35,24
979,Sheffield Weds,30,10,6,78,31,47,100,1
979,Plymouth Argyle,26,11,9,85,59,26,89,2
979,Derby County,25,12,9,75,35,40,87,3
979,Ipswich Town,23,18,5,78,41,37,87,4
979,Barnsley,26,9,11,74,40,34,87,5
979,Portsmouth,24,13,9,73,46,27,85,6
979,Wycombe,25,8,13,69,42,27,83,7
979,Bolton,24,10,12,66,37,29,82,8
979,P'borough Utd,23,5,18,77,54,23,74,9
979,Shrewsbury,20,10,16,57,47,10,70,10
979,Lincoln City,13,22,11,50,49,1,61,11
979,Fleetwood Town,13,16,17,48,55,-7,55,12
979,Exeter City,14,13,19,51,62,-11,55,13
979,Bristol Rovers,15,10,21,61,78,-17,55,14
979,Charlton Ath,12,17,17,60,59,1,53,15
979,Oxford United,13,13,20,46,58,-12,52,16
979,Port Vale,14,9,23,45,66,-21,51,17
979,Cheltenham,14,7,25,39,66,-27,49,18
979,Burton Albion,11,14,21,56,83,-27,47,19
979,Acc'ton Stanley,11,14,21,41,71,-30,47,20
979,Cambridge Utd,11,8,27,40,75,-35,41,21
979,Morecambe,9,13,24,46,77,-31,40,22
979,MK Dons,10,9,27,38,68,-30,39,23
979,FG Rovers,5,11,30,31,85,-54,26,24
980,Plymouth Argyle,29,12,5,88,45,43,99,1
980,Sheffield Weds,27,13,6,72,30,42,94,2
980,Ipswich Town,26,14,6,80,37,43,92,3
980,Derby County,25,11,10,74,37,37,86,4
980,Wycombe,26,7,13,64,42,22,85,5
980,Bolton,23,13,10,66,34,32,82,6
980,Barnsley,24,9,13,79,50,29,81,7
980,P'borough Utd,22,5,19,80,62,18,71,8
980,Portsmouth,18,13,15,60,55,5,67,9
980,Charlton Ath,17,13,16,61,57,4,64,10
980,Port Vale,18,9,19,53,57,-4,63,11
980,Lincoln City,14,21,11,47,51,-4,63,12
980,Shrewsbury,19,6,21,54,63,-9,63,13
980,Exeter City,16,13,17,63,60,3,61,14
980,Fleetwood Town,14,16,16,46,43,3,58,15
980,Oxford United,15,10,21,55,59,-4,55,16
980,Bristol Rovers,13,14,19,59,70,-11,53,17
980,Burton Albion,14,9,23,53,86,-33,51,18
980,Cheltenham,11,10,25,32,60,-28,43,19
980,Acc'ton Stanley,9,14,23,32,66,-34,41,20
980,MK Dons,10,10,26,43,69,-26,40,21
980,Morecambe,9,13,24,49,81,-32,40,22
980,Cambridge Utd,10,8,28,34,73,-39,38,23
980,FG Rovers,7,9,30,35,92,-57,30,24
981,Plymouth Argyle,29,11,6,88,47,41,98,1
981,Sheffield Weds,27,14,5,79,34,45,95,2
981,Bolton,26,11,9,69,31,38,89,3
981,Ipswich Town,25,13,8,83,43,40,88,4
981,Wycombe,26,8,12,63,38,25,86,5
981,Derby County,24,12,10,68,40,28,84,6
981,Barnsley,24,8,14,74,53,21,80,7
981,P'borough Utd,23,7,16,80,58,22,76,8
981,Portsmouth,19,15,12,67,55,12,72,9
981,Shrewsbury,18,10,18,58,55,3,64,10
981,Fleetwood Town,16,15,15,49,44,5,63,11
981,Lincoln City,13,22,11,46,47,-1,61,12
981,Charlton Ath,16,12,18,68,63,5,60,13
981,Exeter City,15,11,20,58,62,-4,56,14
981,Port Vale,15,10,21,46,64,-18,55,15
981,Acc'ton Stanley,12,15,19,44,65,-21,51,16
981,Bristol Rovers,13,11,22,62,82,-20,50,17
981,Burton Albion,12,12,22,53,78,-25,48,18
981,Morecambe,11,13,22,51,78,-27,46,19
981,Oxford United,11,12,23,49,63,-14,45,20
981,MK Dons,12,8,26,46,69,-23,44,21
981,Cheltenham,11,10,25,34,66,-32,43,22
981,Cambridge Utd,9,10,27,38,81,-43,37,23
981,FG Rovers,5,10,31,33,90,-57,25,24
982,Plymouth Argyle,31,9,6,99,48,51,102,1
982,Sheffield Weds,30,11,5,84,35,49,101,2
982,Barnsley,28,6,12,81,51,30,90,3
982,Ipswich Town,23,16,7,84,44,40,85,4
982,Derby County,24,11,11,76,42,34,83,5
982,Bolton,24,11,11,73,39,34,83,6
982,Wycombe,25,7,14,67,44,23,82,7
982,P'borough Utd,22,5,19,75,63,12,71,8
982,Portsmouth,19,14,13,63,56,7,71,9
982,Fleetwood Town,17,16,13,53,44,9,67,10
982,Charlton Ath,17,15,14,74,61,13,66,11
982,Shrewsbury,19,8,19,58,54,4,65,12
982,Exeter City,17,12,17,64,64,0,63,13
982,Oxford United,14,13,19,50,57,-7,55,14
982,Lincoln City,10,24,12,44,51,-7,54,15
982,Bristol Rovers,13,13,20,56,75,-19,52,16
982,Port Vale,12,11,23,41,69,-28,47,17
982,MK Dons,12,8,26,44,72,-28,44,18
982,Cheltenham,11,11,24,34,63,-29,44,19
982,Burton Albion,11,11,24,56,90,-34,44,20
982,Acc'ton Stanley,10,12,24,36,71,-35,42,21
982,Morecambe,9,12,25,48,80,-32,39,22
982,Cambridge Utd,9,9,28,32,74,-42,36,23
982,FG Rovers,8,9,29,39,84,-45,33,24
983,Sheffield Weds,29,12,5,91,34,57,99,1
983,Plymouth Argyle,28,12,6,83,47,36,96,2
983,Barnsley,26,9,11,82,44,38,87,3
983,Ipswich Town,22,18,6,81,41,40,84,4
983,Derby County,23,13,10,74,48,26,82,5
983,Wycombe,25,7,14,70,44,26,82,6
983,Bolton,23,11,12,68,41,27,80,7
983,P'borough Utd,22,9,15,70,50,20,75,8
983,Charlton Ath,18,13,15,66,57,9,67,9
983,Exeter City,19,9,18,68,60,8,66,10
983,Shrewsbury,18,12,16,54,50,4,66,11
983,Portsmouth,16,15,15,65,63,2,63,12
983,Fleetwood Town,16,14,16,54,44,10,62,13
983,Lincoln City,12,22,12,46,48,-2,58,14
983,Port Vale,15,11,20,49,62,-13,56,15
983,Bristol Rovers,13,10,23,59,86,-27,49,16
983,Oxford United,11,15,20,47,58,-11,48,17
983,Cheltenham,12,10,24,32,65,-33,46,18
983,Burton Albion,11,12,23,59,90,-31,45,19
983,Acc'ton Stanley,10,15,21,40,71,-31,45,20
983,Morecambe,10,14,22,43,76,-33,44,21
983,MK Dons,12,7,27,44,73,-29,43,22
983,Cambridge Utd,9,9,28,33,77,-44,36,23
983,FG Rovers,8,9,29,35,84,-49,33,24
984,Plymouth Argyle,29,11,6,96,52,44,98,1
984,Sheffield Weds,25,15,6,73,34,39,90,2
984,Barnsley,27,8,11,72,42,30,89,3
984,Derby County,25,11,10,75,45,30,86,4
984,Bolton,25,10,11,74,40,34,85,5
984,Ipswich Town,23,15,8,88,44,44,84,6
984,Wycombe,22,9,15,57,40,17,75,7
984,Portsmouth,18,17,11,62,50,12,71,8
984,Shrewsbury,20,8,18,54,47,7,68,9
984,P'borough Utd,19,9,18,72,60,12,66,10
984,Exeter City,18,12,16,61,54,7,66,11
984,Lincoln City,12,23,11,39,40,-1,59,12
984,Charlton Ath,15,13,18,66,70,-4,58,13
984,Port Vale,16,10,20,48,62,-14,58,14
984,Bristol Rovers,14,14,18,65,75,-10,56,15
984,Fleetwood Town,13,16,17,48,56,-8,55,16
984,Acc'ton Stanley,12,14,20,42,64,-22,50,17
984,Oxford United,12,12,22,52,59,-7,48,18
984,Burton Albion,12,11,23,54,88,-34,47,19
984,Morecambe,11,13,22,45,70,-25,46,20
984,Cheltenham,12,10,24,34,61,-27,46,21
984,Cambridge Utd,11,8,27,35,75,-40,41,22
984,MK Dons,9,10,27,41,75,-34,37,23
984,FG Rovers,7,11,28,36,86,-50,32,24
985,Sheffield Weds,30,13,3,89,29,60,103,1
985,Plymouth Argyle,28,11,7,95,51,44,95,2
985,Ipswich Town,26,14,6,94,40,54,92,3
985,Derby County,23,12,11,72,46,26,81,4
985,Barnsley,24,9,13,70,44,26,81,5
985,Bolton,22,12,12,67,39,28,78,6
985,P'borough Utd,24,5,17,83,59,24,77,7
985,Wycombe,22,10,14,68,43,25,76,8
985,Portsmouth,19,15,12,67,56,11,72,9
985,Charlton Ath,17,15,14,67,56,11,66,10
985,Fleetwood Town,16,16,14,56,49,7,64,11
985,Shrewsbury,18,9,19,52,54,-2,63,12
985,Exeter City,16,11,19,64,68,-4,59,13
985,Port Vale,16,9,21,49,66,-17,57,14
985,Lincoln City,11,23,12,38,44,-6,56,15
985,Oxford United,14,13,19,47,54,-7,55,16
985,Bristol Rovers,13,12,21,63,84,-21,51,17
985,Burton Albion,12,11,23,54,85,-31,47,18
985,Acc'ton Stanley,11,13,22,42,77,-35,46,19
985,Morecambe,11,11,24,39,72,-33,44,20
985,MK Dons,11,9,26,40,71,-31,42,21
985,Cheltenham,11,9,26,32,69,-37,42,22
985,Cambridge Utd,8,11,27,33,78,-45,35,23
985,FG Rovers,7,11,28,41,88,-47,32,24
986,Sheffield Weds,27,13,6,78,34,44,94,1
986,Plymouth Argyle,28,10,8,85,59,26,94,2
986,Barnsley,27,10,9,75,42,33,91,3
986,Ipswich Town,24,15,7,83,47,36,87,4
986,Bolton,24,12,10,69,34,35,84,5
986,Derby County,24,12,10,72,41,31,84,6
986,Portsmouth,20,18,8,68,46,22,78,7
986,P'borough Utd,22,8,16,77,60,17,74,8
986,Wycombe,20,11,15,60,45,15,71,9
986,Charlton Ath,17,15,14,74,62,12,66,10
986,Shrewsbury,17,11,18,60,55,5,62,11
986,Fleetwood Town,14,17,15,52,47,5,59,12
986,Port Vale,17,8,21,50,64,-14,59,13
986,Burton Albion,15,8,23,64,87,-23,53,14
986,Exeter City,12,16,18,51,56,-5,52,15
986,Oxford United,13,12,21,48,57,-9,51,16
986,Lincoln City,9,23,14,37,52,-15,50,17
986,Bristol Rovers,13,11,22,62,86,-24,50,18
986,Cheltenham,13,11,22,37,62,-25,50,19
986,Morecambe,10,15,21,50,70,-20,45,20
986,Cambridge Utd,11,9,26,41,77,-36,42,21
986,Acc'ton Stanley,8,16,22,41,71,-30,40,22
986,MK Dons,10,9,27,40,75,-35,39,23
986,FG Rovers,7,10,29,33,78,-45,31,24
987,Sheffield Weds,32,11,3,95,27,68,107,1
987,Plymouth Argyle,30,9,7,87,51,36,99,2
987,Ipswich Town,23,18,5,84,38,46,87,3
987,Barnsley,26,9,11,77,40,37,87,4
987,Derby County,24,12,10,70,37,33,84,5
987,Bolton,24,12,10,65,34,31,84,6
987,P'borough Utd,25,3,18,76,59,17,78,7
987,Wycombe,22,10,14,62,41,21,76,8
987,Portsmouth,16,19,11,60,52,8,67,9
987,Charlton Ath,16,15,15,68,61,7,63,10
987,Shrewsbury,16,11,19,48,51,-3,59,11
987,Exeter City,15,12,19,59,61,-2,57,12
987,Fleetwood Town,13,17,16,49,46,3,56,13
987,Lincoln City,10,25,11,41,46,-5,55,14
987,Port Vale,15,9,22,45,64,-19,54,15
987,Bristol Rovers,13,13,20,64,81,-17,52,16
987,MK Dons,14,9,23,49,64,-15,51,17
987,Oxford United,13,11,22,44,56,-12,50,18
987,Cheltenham,14,8,24,40,63,-23,50,19
987,Acc'ton Stanley,11,14,21,43,65,-22,47,20
987,Morecambe,10,13,23,48,75,-27,43,21
987,Burton Albion,10,9,27,55,103,-48,39,22
987,Cambridge Utd,10,7,29,31,79,-48,37,23
987,FG Rovers,7,10,29,34,100,-66,31,24
988,Sheffield Weds,31,10,5,84,32,52,103,1
988,Plymouth Argyle,28,12,6,82,46,36,96,2
988,Barnsley,27,9,10,76,39,37,90,3
988,Ipswich Town,23,15,8,82,45,37,84,4
988,Bolton,25,9,12,67,36,31,84,5
988,Wycombe,25,9,12,66,41,25,84,6
988,Derby County,22,15,9,79,46,33,81,7
988,Portsmouth,20,16,10,66,50,16,76,8
988,P'borough Utd,23,6,17,80,58,22,75,9
988,Shrewsbury,17,11,18,56,57,-1,62,10
988,Fleetwood Town,14,17,15,51,47,4,59,11
988,Lincoln City,12,23,11,48,46,2,59,12
988,Charlton Ath,15,13,18,62,60,2,58,13
988,Exeter City,15,11,20,58,66,-8,56,14
988,Oxford United,15,11,20,48,59,-11,56,15
988,Port Vale,15,10,21,50,71,-21,55,16
988,Bristol Rovers,14,10,22,58,77,-19,52,17
988,Cambridge Utd,14,5,27,44,76,-32,47,18
988,Morecambe,10,13,23,46,73,-27,43,19
988,Burton Albion,11,10,25,51,89,-38,43,20
988,Acc'ton Stanley,10,11,25,40,70,-30,41,21
988,MK Dons,10,10,26,39,70,-31,40,22
988,Cheltenham,9,11,26,30,63,-33,38,23
988,FG Rovers,8,11,27,34,80,-46,35,24
989,Sheffield Weds,32,9,5,86,31,55,105,1
989,Plymouth Argyle,28,11,7,83,49,34,95,2
989,Ipswich Town,26,15,5,87,41,46,93,3
989,Barnsley,28,7,11,73,40,33,91,4
989,Derby County,24,13,9,73,39,34,85,5
989,Bolton,24,12,10,67,33,34,84,6
989,P'borough Utd,23,8,15,76,57,19,77,7
989,Wycombe,22,9,15,66,48,18,75,8
989,Fleetwood Town,17,14,15,54,44,10,65,9
989,Portsmouth,16,17,13,62,55,7,65,10
989,Shrewsbury,17,10,19,52,52,0,61,11
989,Charlton Ath,16,12,18,64,58,6,60,12
989,Exeter City,15,11,20,58,58,0,56,13
989,Lincoln City,11,22,13,41,50,-9,55,14
989,Port Vale,15,10,21,42,70,-28,55,15
989,Oxford United,14,11,21,52,60,-8,53,16
989,Bristol Rovers,13,13,20,63,74,-11,52,17
989,Burton Albion,14,10,22,61,83,-22,52,18
989,Morecambe,10,15,21,51,78,-27,45,19
989,Acc'ton Stanley,9,15,22,36,68,-32,42,20
989,MK Dons,10,9,27,39,67,-28,39,21
989,FG Rovers,9,12,25,31,75,-44,39,22
989,Cambridge Utd,10,7,29,35,73,-38,37,23
989,Cheltenham,9,8,29,28,77,-49,35,24
990,Sheffield Weds,27,15,4,78,29,49,96,1
990,Plymouth Argyle,28,12,6,86,51,35,96,2
990,Barnsley,28,8,10,74,36,38,92,3
990,Bolton,25,12,9,74,35,39,87,4
990,Ipswich Town,24,14,8,84,48,36,86,5
990,Derby County,24,12,10,78,43,35,84,6
990,Wycombe,24,8,14,64,43,21,80,7
990,P'borough Utd,24,4,18,78,55,23,76,8
990,Portsmouth,18,16,12,66,52,14,70,9
990,Shrewsbury,20,10,16,55,49,6,70,10
990,Charlton Ath,16,13,17,68,64,4,61,11
990,Exeter City,16,12,18,62,61,1,60,12
990,Fleetwood Town,14,17,15,52,48,4,59,13
990,Port Vale,16,9,21,44,64,-20,57,14
990,Lincoln City,11,21,14,42,47,-5,54,15
990,Bristol Rovers,12,14,20,61,76,-15,50,16
990,Cheltenham,13,10,23,38,62,-24,49,17
990,Oxford United,11,14,21,46,60,-14,47,18
990,Burton Albion,11,12,23,55,84,-29,45,19
990,Cambridge Utd,12,7,27,38,80,-42,43,20
990,MK Dons,11,9,26,39,70,-31,42,21
990,Acc'ton Stanley,8,15,23,37,74,-37,39,22
990,Morecambe,8,13,25,43,77,-34,37,23
990,FG Rovers,8,9,29,40,94,-54,33,24
991,Sheffield Weds,28,13,5,87,38,49,97,1
991,Derby County,28,10,8,76,39,37,94,2
991,Plymouth Argyle,27,10,9,83,52,31,91,3
991,Barnsley,26,8,12,72,37,35,86,4
991,Ipswich Town,23,15,8,83,44,39,84,5
991,Bolton,24,10,12,66,41,25,82,6
991,Wycombe,23,8,15,62,43,19,77,7
991,P'borough Utd,23,4,19,72,55,17,73,8
991,Shrewsbury,21,7,18,52,48,4,70,9
991,Exeter City,18,12,16,63,57,6,66,10
991,Fleetwood Town,16,15,15,53,47,6,63,11
991,Portsmouth,16,14,16,63,59,4,62,12
991,Charlton Ath,16,12,18,68,63,5,60,13
991,Oxford United,13,14,19,49,55,-6,53,14
991,Lincoln City,11,20,15,38,51,-13,53,15
991,Port Vale,14,11,21,47,61,-14,53,16
991,Bristol Rovers,13,11,22,61,80,-19,50,17
991,Cheltenham,13,10,23,36,55,-19,49,18
991,Morecambe,12,12,22,50,76,-26,48,19
991,Acc'ton Stanley,11,14,21,46,75,-29,47,20
991,MK Dons,12,10,24,43,66,-23,46,21
991,Burton Albion,11,11,24,58,93,-35,44,22
991,Cambridge Utd,12,7,27,37,78,-41,43,23
991,FG Rovers,7,10,29,34,86,-52,31,24
992,Sheffield Weds,29,12,5,88,32,56,99,1
992,Plymouth Argyle,29,11,6,96,50,46,98,2
992,Ipswich Town,25,15,6,83,39,44,90,3
992,Barnsley,24,10,12,69,42,27,82,4
992,Bolton,23,11,12,66,37,29,80,5
992,Derby County,20,16,10,71,41,30,76,6
992,Wycombe,23,6,17,65,46,19,75,7
992,P'borough Utd,21,7,18,69,57,12,70,8
992,Portsmouth,17,18,11,66,52,14,69,9
992,Fleetwood Town,16,18,12,47,39,8,66,10
992,Lincoln City,15,20,11,50,46,4,65,11
992,Shrewsbury,18,11,17,53,51,2,65,12
992,Charlton Ath,15,15,16,65,60,5,60,13
992,Exeter City,15,12,19,57,61,-4,57,14
992,Port Vale,15,10,21,45,65,-20,55,15
992,Burton Albion,14,12,20,58,83,-25,54,16
992,Bristol Rovers,13,12,21,64,78,-14,51,17
992,Oxford United,12,14,20,48,59,-11,50,18
992,Cambridge Utd,11,11,24,36,67,-31,44,19
992,Cheltenham,12,8,26,38,73,-35,44,20
992,Acc'ton Stanley,9,16,21,38,70,-32,43,21
992,Morecambe,10,13,23,45,80,-35,43,22
992,MK Dons,12,6,28,39,70,-31,42,23
992,FG Rovers,6,12,28,31,89,-58,30,24
993,Sheffield Weds,29,10,7,82,33,49,97,1
993,Barnsley,29,7,10,77,42,35,94,2
993,Plymouth Argyle,27,10,9,80,50,30,91,3
993,Ipswich Town,25,15,6,87,46,41,90,4
993,Bolton,27,9,10,78,38,40,90,5
993,Derby County,24,13,9,79,43,36,85,6
993,Wycombe,24,8,14,69,47,22,80,7
993,P'borough Utd,22,6,18,73,60,13,72,8
993,Portsmouth,19,15,12,61,48,13,72,9
993,Shrewsbury,19,10,17,54,50,4,67,10
993,Lincoln City,14,20,12,44,45,-1,62,11
993,Fleetwood Town,14,18,14,51,48,3,60,12
993,Port Vale,15,12,19,46,61,-15,57,13
993,Exeter City,14,13,19,59,65,-6,55,14
993,Charlton Ath,13,15,18,56,60,-4,54,15
993,Oxford United,14,12,20,47,56,-9,54,16
993,Bristol Rovers,13,13,20,66,78,-12,52,17
993,Burton Albion,13,10,23,60,91,-31,49,18
993,Morecambe,11,13,22,46,71,-25,46,19
993,MK Dons,11,9,26,45,70,-25,42,20
993,Acc'ton Stanley,9,14,23,36,66,-30,41,21
993,Cambridge Utd,11,7,28,41,76,-35,40,22
993,Cheltenham,11,7,28,35,72,-37,40,23
993,FG Rovers,6,10,30,38,94,-56,28,24
994,Sheffield Weds,31,10,5,86,32,54,103,1
994,Plymouth Argyle,28,11,7,84,48,36,95,2
994,Barnsley,26,8,12,70,40,30,86,3
994,Wycombe,26,7,13,79,43,36,85,4
994,Bolton,24,11,11,69,40,29,83,5
994,Ipswich Town,23,13,10,79,46,33,82,6
994,Derby County,23,10,13,74,45,29,79,7
994,P'borough Utd,24,5,17,79,53,26,77,8
994,Portsmouth,18,18,10,59,50,9,72,9
994,Shrewsbury,21,7,18,53,50,3,70,10
994,Charlton Ath,16,14,16,68,61,7,62,11
994,Lincoln City,13,22,11,46,45,1,61,12
994,Fleetwood Town,14,16,16,55,56,-1,58,13
994,Bristol Rovers,14,14,18,61,70,-9,56,14
994,Exeter City,14,12,20,62,69,-7,54,15
994,Port Vale,14,12,20,49,67,-18,54,16
994,Oxford United,14,11,21,49,63,-14,53,17
994,MK Dons,14,7,25,47,70,-23,49,18
994,Cheltenham,12,12,22,36,62,-26,48,19
994,Burton Albion,13,9,24,53,90,-37,48,20
994,Acc'ton Stanley,9,14,23,34,69,-35,41,21
994,Morecambe,8,15,23,47,72,-25,39,22
994,Cambridge Utd,10,6,30,34,81,-47,36,23
994,FG Rovers,6,10,30,33,84,-51,28,24
995,Sheffield Weds,29,11,6,79,32,47,98,1
995,Plymouth Argyle,28,10,8,89,54,35,94,2
995,Ipswich Town,24,15,7,88,52,36,87,3
995,Derby County,23,14,9,76,42,34,83,4
995,Barnsley,24,9,13,71,47,24,81,5
995,Bolton,22,14,10,70,40,30,80,6
995,P'borough Utd,25,4,17,82,56,26,79,7
995,Wycombe,22,8,16,60,45,15,74,8
995,Portsmouth,19,16,11,65,46,19,73,9
995,Lincoln City,16,21,9,51,45,6,69,10
995,Shrewsbury,19,10,17,57,55,2,67,11
995,Charlton Ath,16,14,16,62,60,2,62,12
995,Fleetwood Town,13,19,14,49,46,3,58,13
995,Port Vale,16,8,22,54,69,-15,56,14
995,Exeter City,14,12,20,55,64,-9,54,15
995,Oxford United,13,13,20,49,57,-8,52,16
995,Bristol Rovers,13,10,23,64,85,-21,49,17
995,MK Dons,13,9,24,43,65,-22,48,18
995,Acc'ton Stanley,11,15,20,42,65,-23,48,19
995,Cheltenham,13,9,24,34,60,-26,48,20
995,Burton Albion,13,9,24,62,91,-29,48,21
995,Morecambe,9,14,23,47,73,-26,41,22
995,Cambridge Utd,10,8,28,35,84,-49,38,23
995,FG Rovers,5,12,29,32,83,-51,27,24
996,Sheffield Weds,29,13,4,81,27,54,100,1
996,Plymouth Argyle,30,10,6,86,48,38,100,2
996,Derby County,26,11,9,75,40,35,89,3
996,Barnsley,26,10,10,68,36,32,88,4
996,Bolton,25,11,10,65,34,31,86,5
996,Ipswich Town,23,16,7,86,42,44,85,6
996,Wycombe,26,7,13,68,38,30,85,7
996,P'borough Utd,23,3,20,68,56,12,72,8
996,Shrewsbury,19,12,15,55,44,11,69,9
996,Lincoln City,16,19,11,45,43,2,67,10
996,Charlton Ath,16,16,14,65,56,9,64,11
996,Portsmouth,15,16,15,59,54,5,61,12
996,Fleetwood Town,14,18,14,48,44,4,60,13
996,Bristol Rovers,16,10,20,65,79,-14,58,14
996,Exeter City,14,12,20,58,65,-7,54,15
996,Port Vale,15,8,23,45,63,-18,53,16
996,Cheltenham,14,8,24,36,60,-24,50,17
996,Acc'ton Stanley,11,15,20,41,71,-30,48,18
996,Oxford United,10,15,21,43,57,-14,45,19
996,MK Dons,11,9,26,42,68,-26,42,20
996,Morecambe,9,15,22,40,67,-27,42,21
996,Burton Albion,9,9,28,48,91,-43,36,22
996,Cambridge Utd,9,8,29,33,78,-45,35,23
996,FG Rovers,5,11,30,35,94,-59,26,24
997,Sheffield Weds,30,12,4,85,34,51,102,1
997,Plymouth Argyle,27,11,8,84,52,32,92,2
997,Bolton,26,8,12,75,39,36,86,3
997,Ipswich Town,23,14,9,81,45,36,83,4
997,Wycombe,25,6,15,66,40,26,81,5
997,Barnsley,24,8,14,67,44,23,80,6
997,Derby County,21,14,11,79,50,29,77,7
997,P'borough Utd,23,8,15,80,55,25,77,8
997,Shrewsbury,22,7,17,60,47,13,73,9
997,Portsmouth,16,18,12,60,51,9,66,10
997,Exeter City,17,14,15,61,52,9,65,11
997,Fleetwood Town,16,16,14,51,47,4,64,12
997,Charlton Ath,16,15,15,72,63,9,63,13
997,Lincoln City,12,22,12,44,49,-5,58,14
997,Burton Albion,14,11,21,66,93,-27,53,15
997,Bristol Rovers,14,10,22,61,82,-21,52,16
997,Morecambe,12,14,20,46,67,-21,50,17
997,Oxford United,13,10,23,52,62,-10,49,18
997,Port Vale,12,12,22,44,67,-23,48,19
997,Cheltenham,13,9,24,37,62,-25,48,20
997,MK Dons,13,8,25,44,77,-33,47,21
997,Acc'ton Stanley,9,13,24,38,74,-36,40,22
997,Cambridge Utd,9,8,29,33,76,-43,35,23
997,FG Rovers,7,8,31,31,89,-58,29,24
998,Sheffield Weds,29,12,5,80,29,51,99,1
998,Plymouth Argyle,28,11,7,91,51,40,95,2
998,Barnsley,27,9,10,75,42,33,90,3
998,Ipswich Town,24,17,5,80,41,39,89,4
998,Derby County,24,14,8,88,44,44,86,5
998,Bolton,23,12,11,68,36,32,81,6
998,P'borough Utd,24,6,16,80,56,24,78,7
998,Portsmouth,19,15,12,70,54,16,72,8
998,Wycombe,20,7,19,65,52,13,67,9
998,Charlton Ath,17,14,15,64,63,1,65,10
998,Fleetwood Town,14,18,14,49,43,6,60,11
998,Shrewsbury,17,8,21,54,65,-11,59,12
998,Lincoln City,12,22,12,44,45,-1,58,13
998,Bristol Rovers,16,10,20,69,82,-13,58,14
998,Exeter City,14,13,19,59,63,-4,55,15
998,Oxford United,13,15,18,44,53,-9,54,16
998,Port Vale,15,9,22,47,72,-25,54,17
998,Cheltenham,14,10,22,35,58,-23,52,18
998,MK Dons,14,8,24,46,65,-19,50,19
998,Morecambe,10,12,24,43,73,-30,42,20
998,Cambridge Utd,12,6,28,40,79,-39,42,21
998,Burton Albion,9,14,23,54,89,-35,41,22
998,Acc'ton Stanley,9,12,25,42,76,-34,39,23
998,FG Rovers,6,10,30,39,95,-56,28,24
999,Sheffield Weds,30,13,3,85,28,57,103,1
999,Barnsley,27,8,11,76,37,39,89,2
999,Plymouth Argyle,25,14,7,80,51,29,89,3
999,Ipswich Town,24,15,7,79,45,34,87,4
999,Derby County,24,12,10,71,38,33,84,5
999,Bolton,23,11,12,68,36,32,80,6
999,Wycombe,24,7,15,70,45,25,79,7
999,P'borough Utd,22,6,18,77,58,19,72,8
999,Portsmouth,17,16,13,59,52,7,67,9
999,Fleetwood Town,17,14,15,50,43,7,65,10
999,Shrewsbury,18,11,17,50,49,1,65,11
999,Charlton Ath,16,13,17,65,59,6,61,12
999,Bristol Rovers,17,10,19,64,75,-11,61,13
999,Port Vale,16,9,21,46,65,-19,57,14
999,Exeter City,13,15,18,55,60,-5,54,15
999,Lincoln City,12,18,16,41,53,-12,54,16
999,Morecambe,12,14,20,43,64,-21,50,17
999,Burton Albion,13,11,22,56,82,-26,50,18
999,Oxford United,12,13,21,47,56,-9,49,19
999,MK Dons,13,8,25,39,63,-24,47,20
999,Cambridge Utd,12,9,25,36,72,-36,45,21
999,Cheltenham,10,11,25,31,61,-30,41,22
999,Acc'ton Stanley,9,13,24,31,66,-35,40,23
999,FG Rovers,6,9,31,30,91,-61,27,24
1000,Sheffield Weds,31,11,4,81,28,53,104,1
1000,Plymouth Argyle,29,11,6,83,46,37,98,2
1000,Ipswich Town,27,13,6,86,42,44,94,3
1000,Barnsley,26,10,10,73,39,34,88,4
1000,Wycombe,26,7,13,73,42,31,85,5
1000,Bolton,24,12,10,64,36,28,84,6
1000,Derby County,22,15,9,69,40,29,81,7
1000,P'borough Utd,22,6,18,83,62,21,72,8
1000,Portsmouth,19,15,12,57,52,5,72,9
1000,Charlton Ath,17,14,15,70,55,15,65,10
1000,Bristol Rovers,17,10,19,68,70,-2,61,11
1000,Shrewsbury,16,11,19,50,51,-1,59,12
1000,Lincoln City,13,20,13,44,48,-4,59,13
1000,Fleetwood Town,15,13,18,48,45,3,58,14
1000,MK Dons,13,10,23,43,63,-20,49,15
1000,Port Vale,12,13,21,41,68,-27,49,16
1000,Exeter City,11,14,21,56,68,-12,47,17
1000,Acc'ton Stanley,10,17,19,33,56,-23,47,18
1000,Oxford United,11,12,23,42,59,-17,45,19
1000,Morecambe,10,13,23,46,73,-27,43,20
1000,Cheltenham,10,11,25,33,67,-34,41,21
1000,Burton Albion,10,10,26,55,98,-43,40,22
1000,Cambridge Utd,10,9,27,34,75,-41,39,23
1000,FG Rovers,7,11,28,34,83,-49,32,24
